concept_personmexico_ncaa	concept:agentcontrols	concept_sportsteam_western_kentucky_hilltoppers
concept_university_stanford	concept:subpartoforganization	concept_sportsteam_ncaa_mens_midwest_regionals
concept_politician_jobs	concept:agentcontrols	concept_videogamesystem_ipod
concept_sportsteam_red_sox_this_season	concept:teamplayssport	concept_sport_baseball
concept_company_enron	concept:subpartoforganization	concept_bank_ge
concept_tradeunion_web_site	concept:subpartoforganization	concept_terroristorganization_state
concept_academicfield_business_administration	concept:academicprogramatuniversity	concept_university_institute
concept_newspaper_the_international_herald_tribune	concept:competeswith	concept_newspaper_journal
concept_website_san_jose_mercury_news	concept:competeswith	concept_website_daily_news
concept_academicfield_chemical_engineering	concept:academicprogramatuniversity	concept_university_institute
concept_politicsissue_education	concept:academicprogramatuniversity	concept_university_harvard
concept_sportsteam_east_carolina	concept:teamplayssport	concept_sport_basketball
concept_stadiumoreventvenue_toyota_center	concept:stadiumlocatedincity	concept_city_houston
concept_person_david	concept:hassibling	concept_person_lord
concept_coach_al_wilson	concept:coachwontrophy	concept_awardtrophytournament_super_bowl_xlii
concept_politicsblog_tribune	concept:agentcontrols	concept_building_times
concept_university_microsoft	concept:agentcontrols	concept_company_yahoo001
concept_sportsteam_boston_celtics	concept:teamhomestadium	concept_stadiumoreventvenue_td_garden
concept_automobilemaker_nissan	concept:automobilemakercardealersinstateorprovince	concept_stateorprovince_texas
concept_automobilemaker_bmw	concept:competeswith	concept_automobilemaker_cadillac
concept_personnorthamerica_jeffrey_kindler	concept:agentcontrols	concept_retailstore_pfizer
concept_bank_express_mail	concept:competeswith	concept_bank_fedex
concept_animal_federal_government	concept:agentcontrols	concept_transportation_money
concept_sportsteam_marlins	concept:teamhomestadium	concept_stadiumoreventvenue_dolphin_stadium
concept_insect_borers	concept:animalthatfeedoninsect	concept_insect_insects
concept_sportsteam_chelsea	concept:teamalsoknownas	concept_sportsteam_liverpool
concept_automobilemaker_kia	concept:automobilemakercardealersinstateorprovince	concept_stateorprovince_south_dakota
concept_coach_new_york_jets	concept:agentbelongstoorganization	concept_sportsleague_nfl
concept_insect_insects	concept:animalthatfeedoninsect	concept_insect_beetle
concept_mammal_dogs	concept:animaleatfood	concept_food_yogurt
concept_sportsteam_michigan_state	concept:teamalsoknownas	concept_sportsteam_state_university
concept_academicfield_science	concept:academicprogramatuniversity	concept_university_yale_university
concept_person_christian	concept:hassibling	concept_male_constantine
concept_sportsteam_huskers	concept:teamalsoknownas	concept_sportsteam_state_university
concept_automobilemaker_bmw	concept:competeswith	concept_automobilemaker_ford
concept_sportsteam_trail_blazers	concept:teamhomestadium	concept_stadiumoreventvenue_rose_garden
concept_politicianus_wilson	concept:politicianusholdsoffice	concept_politicaloffice_assistant_secretary
concept_company_dc	concept:competeswith	concept_company_reuters
concept_automobilemaker_chevrolet	concept:automobilemakercardealersinstateorprovince	concept_stateorprovince_arizona
concept_insect_insects	concept:animalthatfeedoninsect	concept_insect_cockroaches
concept_academicfield_law	concept:academicprogramatuniversity	concept_university_ohio_state
concept_person_chris	concept:agentcontrols	concept_charactertrait_world
concept_person_senator	concept:agentbelongstoorganization	concept_politicalparty_house
concept_insect_insects	concept:animalthatfeedoninsect	concept_insect_honeybees
concept_academicfield_engineering	concept:academicprogramatuniversity	concept_university_stanford_university
concept_city_texas	concept:agentcontrols	concept_website_jobs
concept_agriculturalproduct_chocolate	concept:agriculturalproductcutintogeometricshape	concept_geometricshape_piece
concept_automobilemaker_lexus	concept:automobilemakercardealersinstateorprovince	concept_stateorprovince_texas
concept_company_nbc	concept:competeswith	concept_politicsblog_journal
concept_stadiumoreventvenue_american_airlines_center	concept:stadiumlocatedincity	concept_city_dallas
concept_automobilemaker_honda	concept:automobilemakercardealersinstateorprovince	concept_stateorprovince_minnesota
concept_politicianus_harry_truman	concept:politicianusholdsoffice	concept_politicaloffice_president
concept_creditunion_wisconsin	concept:subpartoforganization	concept_sportsteam_ncaa_youth_kids
concept_sportsteam_georgia_tech	concept:subpartoforganization	concept_sportsteam_ncaa_mens_midwest_regionals
concept_athlete_roddy_white	concept:athleteinjuredhisbodypart	concept_braintissue_eyes
concept_sportsteam_kansas_state	concept:teamalsoknownas	concept_sportsteam_state_university
concept_city_costa_rica	concept:agentbelongstoorganization	concept_sportsleague_mls
concept_sportsteam_new_york_giants	concept:teamhomestadium	concept_stadiumoreventvenue_giants_stadium
concept_academicfield_marketing	concept:academicprogramatuniversity	concept_university_college
concept_stadiumoreventvenue_network_associates_coliseum	concept:stadiumlocatedincity	concept_city_oakland
concept_university_google	concept:agentcontrols	concept_city_number
concept_company_dc	concept:competeswith	concept_blog_time_magazine
concept_academicfield_computer_engineering	concept:academicprogramatuniversity	concept_university_state_university
concept_personaustralia_smith	concept:athleteinjuredhisbodypart	concept_bone_knee
concept_coach_seneca_wallace	concept:coachwontrophy	concept_awardtrophytournament_super_bowl_xlii
concept_governmentorganization_regulations	concept:subpartoforganization	concept_city_united_kingdom
concept_musicartist_abbas	concept:agentcontrols	concept_programminglanguage_pa
concept_coach_peter_moylan	concept:athleteinjuredhisbodypart	concept_bodypart_hands
concept_insect_insects	concept:animalthatfeedoninsect	concept_arthropod_roaches
concept_animal_scavengers	concept:animalthatfeedoninsect	concept_insect_insects
concept_politicianus_president_george_w__bush	concept:politicianusholdsoffice	concept_politicaloffice_president
concept_athlete_jeremy_bates	concept:coachwontrophy	concept_awardtrophytournament_super_bowl_xlii
concept_chemical_nitrogen	concept:chemicalistypeofchemical	concept_chemical_chemicals
concept_company_sun	concept:competeswith	concept_company_ibm
concept_person_mark001	concept:agentcontrols	concept_charactertrait_world
concept_company_eds	concept:subpartoforganization	concept_company_hp
concept_academicfield_systems	concept:academicprogramatuniversity	concept_university_institute
concept_academicfield_engineering	concept:academicprogramatuniversity	concept_university_rutgers
concept_sportsteam_carolina_hurricanes	concept:teamplayssport	concept_sport_hockey
concept_bank_ups	concept:competeswith	concept_company_priority
concept_politicianus_john	concept:politicianusholdsoffice	concept_politicaloffice_u_s__president
concept_bank_viacom	concept:agentcontrols	concept_website_cbs
concept_insect_insects	concept:animalthatfeedoninsect	concept_insect_butterflies
concept_academicfield_engineering	concept:academicprogramatuniversity	concept_university_graduate_school
concept_city_download	concept:agentbelongstoorganization	concept_blog_site
concept_newspaper_journal	concept:competeswith	concept_website_dallas_morning_news
concept_stadiumoreventvenue_wrigley_field	concept:stadiumlocatedincity	concept_city_chicago
concept_sportsteam_western_kentucky_hilltoppers	concept:subpartoforganization	concept_sportsteam_ncaa_youth_kids
concept_coach_tom_coughlin	concept:coachwontrophy	concept_awardtrophytournament_super_bowl
concept_nongovorganization_democrat	concept:subpartoforganization	concept_governmentorganization_house
concept_politician_jobs	concept:agentcontrols	concept_wallitem_beginning
concept_sportsleague_nfl	concept:agentcontrols	concept_sportsteam_florida_international
concept_politicianus_president_george_bush	concept:politicianusholdsoffice	concept_politicaloffice_secretary
