concept_stateorprovince_california	concept:mutualproxyfor	concept_city_carmel_by_the_sea
concept_personeurope_liquidation	concept:atdate	concept_dateliteral_n2007
concept_sociopolitical_war	concept:atdate	concept_year_n1946
concept_coach_carlos_marmol	concept:athleteflyouttosportsteamposition	concept_sportsteamposition_center
concept_charactertrait_church	concept:atdate	concept_dateliteral_n2008
concept_bathroomitem_tubs	concept:itemfoundinroom	concept_officebuildingroom_private_bathrooms
concept_plant_spruce	concept:plantincludeplant	concept_plant_saplings
concept_stateorprovince_alabama	concept:statelocatedingeopoliticallocation	concept_country_u_s_a
concept_person_taylor	concept:personbornincity	concept_city_york
concept_governmentorganization_governors	concept:atdate	concept_dateliteral_n2007
concept_medicalprocedure_cancer	concept:atdate	concept_date_n2000
concept_website_chicago_tribune	concept:hasofficeincity	concept_city_la
concept_person_richard002	concept:personborninlocation	concept_city_york
concept_stateorprovince_oregon	concept:mutualproxyfor	concept_city_corvallis
concept_company_post	concept:agentinvolvedwithitem	concept_buildingfeature_window
concept_academicfield_delhi	concept:atdate	concept_date_n2001
concept_automobilemaker_jeep	concept:automobilemakerdealersincountry	concept_country_canada_canada
concept_politicianus_palin	concept:politicianusendorsedbypoliticianus	concept_politicianus_senator_mccain
concept_mammal_predators	concept:animalsuchasfish	concept_fish_pike
concept_bedroomitem_bath	concept:itemfoundinroom	concept_visualizablething_cabins
concept_city_moscow	concept:atdate	concept_dateliteral_n2007
concept_weapon_arms	concept:weaponmadeincountry	concept_country_britain
concept_sportsteam_los_angeles_angels_of_anaheim	concept:teamplaysagainstteam	concept_sportsteam_white_sox
concept_building_first_time	concept:atdate	concept_year_n1960
concept_profession_health_care_professionals	concept:professionistypeofprofession	concept_profession_staff
concept_city_montreal	concept:atdate	concept_dateliteral_n2007
concept_room_east	concept:atlocation	concept_continent_africa
concept_sportsteam_new_york_giants	concept:teamwontrophy	concept_awardtrophytournament_nfl_championship_game
concept_musicalbum_death	concept:atdate	concept_date_n1972
concept_nongovorganization_u_s_	concept:atdate	concept_date_n1941
concept_crimeorcharge_parole	concept:atdate	concept_dateliteral_n2007
concept_island_grants	concept:atdate	concept_dateliteral_n2005
concept_automobilemaker_honda_motor	concept:agentinvolvedwithitem	concept_automobilemodel_passport
concept_academicfield_technology	concept:academicfieldsuchasacademicfield	concept_academicfield_business_administration
concept_sportsteam_kansas_city_chiefs	concept:teamwontrophy	concept_awardtrophytournament_division
concept_company_daily_news001	concept:agentactsinlocation	concept_lake_new
concept_sportsgame_games	concept:sportsgameteam	concept_sportsteam_new_jersey_nets
concept_bird_condor	concept:agentactsinlocation	concept_city_hanover
concept_buildingfeature_american	concept:atlocation	concept_city_irvington
concept_musicsong_sunday	concept:atdate	concept_date_n2003
concept_sportsteam_red_wings	concept:teamplaysagainstteam	concept_sportsteam_hawks
concept_sport_hockey	concept:sportusesstadium	concept_stadiumoreventvenue_wachovia_center
concept_sportsteam_kansas_city_royals	concept:teamplaysincity	concept_city_boston
concept_vegetable_pepper	concept:agriculturalproductcookedwithagriculturalproduct	concept_food_artichokes
concept_transportation_board_meeting	concept:atdate	concept_date_n1999
concept_person_scott001	concept:personmovedtostateorprovince	concept_stateorprovince_new_york
concept_country_vietnam	concept:countrylocatedingeopoliticallocation	concept_politicalparty_other_countries
concept_nondiseasecondition_birth	concept:atdate	concept_year_n1991
concept_furniture_sofa_bed	concept:furniturefoundinroom	concept_visualizablething_seating_area
concept_person_prime_minister	concept:atdate	concept_date_n1996
concept_eventoutcome_report	concept:atdate	concept_year_n1995
concept_politicianus_president_bill_clinton	concept:politicianusendorsedbypoliticianus	concept_politicianus_al_gore
concept_geopoliticalorganization_web_site	concept:atdate	concept_year_n1994
concept_buildingfeature_american	concept:atlocation	concept_city_garden_grove
concept_agriculturalproduct_dairy	concept:agriculturalproductcomingfromvertebrate	concept_vertebrate_herds
concept_hallwayitem_refrigerator	concept:itemfoundinroom	concept_visualizablething_kitchen_area
concept_sportsteam_louisville_cardinals	concept:teamplaysagainstteam	concept_sportsteam_arizona_diamond_backs
concept_building_first_time	concept:atdate	concept_year_n1989
concept_stateorprovince_states	concept:statelocatedingeopoliticallocation	concept_country_estonia
concept_sportsgame_finals	concept:sportsgameteam	concept_sportsteam_sixers
concept_sportsteam_los_angeles_angels_of_anaheim	concept:organizationheadquarteredinstateorprovince	concept_stateorprovince_new_york
concept_arthropod_pollinators	concept:arthropodandotherarthropod	concept_insect_beneficial_insects
concept_company_national	concept:agentactsinlocation	concept_county_philadelphia
concept_furniture_sofa_bed	concept:furniturefoundinroom	concept_room_den
concept_company_easyjet	concept:hasofficeincity	concept_city_paris
concept_animal_students	concept:agentparticipatedinevent	concept_eventoutcome_result
concept_fish_shad	concept:animalsuchasfish	concept_fish_blue_catfish
concept_governmentorganization_cabinet	concept:atdate	concept_year_n1997
concept_sportsteam_mariners	concept:teamplaysagainstteam	concept_sportsteam_rangers
concept_stateorprovince_states	concept:statelocatedingeopoliticallocation	concept_city_moscow
concept_language_latin	concept:languageofuniversity	concept_university_stanford
concept_musicalbum_vietnam	concept:atdate	concept_dateliteral_n2007
concept_governmentorganization_health	concept:atdate	concept_date_n2004
concept_profession_faculty	concept:professionistypeofprofession	concept_profession_scientists
concept_sportsteam_kentucky_wildcats	concept:teamplaysinleague	concept_sportsleague_ncaa
concept_plant_cedar	concept:plantincludeplant	concept_plant_conifers
concept_person_president	concept:agentcollaborateswithagent	concept_city_bush
concept_personnorthamerica_john_mccain	concept:agentcollaborateswithagent	concept_politician_obama
concept_city_construction	concept:atdate	concept_date_n2000
concept_protein_medicine	concept:atdate	concept_year_n1997
concept_bathroomitem_tub	concept:itemfoundinroom	concept_visualizablething_junior_suite
concept_sportsgame_games	concept:sportsgameteam	concept_sportsteam_tar_heels
concept_musicsong_night	concept:atdate	concept_dateliteral_n1912
concept_sport_hockey	concept:sportusesstadium	concept_stadiumoreventvenue_air_canada_center
concept_journalist_staff	concept:journalistwritesforpublication	concept_company_post
concept_journalist_bob_herbert	concept:journalistwritesforpublication	concept_newspaper_times
concept_city_home	concept:agentparticipatedinevent	concept_eventoutcome_result
concept_stateorprovince_states	concept:statelocatedingeopoliticallocation	concept_geopoliticallocation_holland
concept_country_france_france	concept:countrylocatedingeopoliticallocation	concept_country_eu_countries
concept_mediatype_books	concept:atdate	concept_dateliteral_n1987
concept_island_head	concept:atdate	concept_date_n2004
concept_city_york	concept:citylocatedingeopoliticallocation	concept_city_columbia
concept_sportsteam_cleveland_browns	concept:teamplaysagainstteam	concept_sportsteam_packers
concept_animal_babies	concept:animalistypeofanimal	concept_animal_creatures
concept_musicsong_birthday	concept:atdate	concept_date_n2000
concept_profession_specialists	concept:professionistypeofprofession	concept_profession_scientists
concept_sportsgame_games	concept:sportsgameteam	concept_sportsteam_dallas_cowboys
concept_jobposition_premises	concept:atdate	concept_date_n2000
concept_chemical_coo	concept:atdate	concept_dateliteral_n2005
concept_animal_animals001	concept:animalpreyson	concept_fish_parrots
concept_weapon_weapons	concept:weaponmadeincountry	concept_country_liberia
concept_sportsteam_los_angeles_dodgers	concept:teamplaysincity	concept_city_philadelphia
concept_election_national_elections	concept:atdate	concept_dateliteral_n2007
concept_weapon_national	concept:atlocation	concept_city_whiskeytown
concept_personaustralia_more_information	concept:agentcreated	concept_movie_contact
concept_hobby_hobbies	concept:hobbiessuchashobbies	concept_sport_tennis
concept_stateorprovince_illinois	concept:mutualproxyfor	concept_city_arlington_heights
concept_profession_physician_assistants	concept:professionistypeofprofession	concept_profession_providers
concept_charactertrait_church	concept:atdate	concept_dateliteral_n2005
concept_hobby_activities	concept:hobbiessuchashobbies	concept_hobby_biking
concept_sportsteam_tar_heels	concept:teamplaysagainstteam	concept_sportsteam_terps
concept_sportsgame_food_and_drug_administration	concept:atdate	concept_dateliteral_n2006
concept_bedroomitem_bed	concept:itemfoundinroom	concept_visualizablething_bedroom_cottage
concept_politicianus_george_w_	concept:politicianusendorsedbypoliticianus	concept_politicianus_bush
concept_programminglanguage_record	concept:atdate	concept_year_n1995
concept_bathroomitem_shower_stall	concept:itemfoundinroom	concept_officebuildingroom_private_bathroom
concept_mammal_dogs	concept:specializationof	concept_mammal_animals
concept_country_greece	concept:atdate	concept_year_n1995
concept_male_history	concept:agentparticipatedinevent	concept_sportsgame_series
concept_website_trip	concept:atdate	concept_dayofweek_tuesday
concept_city_home	concept:organizationhiredperson	concept_personmexico_ryan_whitney
concept_ceo_mark_v__hurd	concept:personleadsorganization	concept_university_hewlett_packard
concept_sportsequipment_board	concept:mutualproxyfor	concept_county_chamber
concept_profession_instructors	concept:professionistypeofprofession	concept_profession_experts
concept_stateorprovince_maryland	concept:stateorprovinceisborderedbystateorprovince	concept_stateorprovince_delaware
concept_bank_ing	concept:companyeconomicsector	concept_economicsector_investment
concept_creditunion_michigan	concept:mutualproxyfor	concept_county_detroit
concept_mammal_squirrels	concept:specializationof	concept_mammal_wild_animals
concept_country_soviet_union	concept:countrylocatedingeopoliticallocation	concept_stateorprovince_states
concept_terroristorganization_lebanon	concept:mutualproxyfor	concept_emotion_new
concept_sportsteam_red_sox_this_season	concept:teamplaysagainstteam	concept_sportsteam_houston_astros
concept_celebrity_screen	concept:agentinvolvedwithitem	concept_software_microsoft_windows
concept_city_windhoek	concept:citylocatedincountry	concept_country_namibia
concept_buildingfeature_american	concept:atlocation	concept_politicsblog_raleigh
concept_country_thailand	concept:countrylocatedingeopoliticallocation	concept_continent_asia
concept_musician_eric	concept:musicianplaysinstrument	concept_musicinstrument_drums
concept_charactertrait_survey	concept:atdate	concept_date_n2000
concept_politicianus_president_kennedy	concept:politicianholdsoffice	concept_politicaloffice_president
concept_sportsteam_pistons	concept:teamplaysagainstteam	concept_sportsteam_pacers
concept_bedroomitem_bath	concept:itemfoundinroom	concept_officebuildingroom_family_bathroom
concept_personcanada_search	concept:agentcompeteswithagent	concept_tradeunion_web_site
concept_lake_new	concept:mutualproxyfor	concept_transportation_airports
concept_actor_poll	concept:atdate	concept_dateliteral_n2006
concept_weapon_weaponry	concept:weaponmadeincountry	concept_country_west_indies
concept_visualizableobject_head001	concept:thinghascolor	concept_color_purple
concept_drug_zyprexa	concept:drughassideeffect	concept_disease_side_effects
concept_personmexico_daisuke_matsuzaka	concept:athleteflyouttosportsteamposition	concept_sportsteamposition_center
concept_stateorprovince_west_virginia	concept:statelocatedincountry	concept_country_usa
concept_profession_medical_doctors	concept:professionistypeofprofession	concept_profession_specialists
concept_ceo_john_chambers	concept:worksfor	concept_biotechcompany_cisco_systems_inc_
concept_county_florence	concept:atlocation	concept_stateorprovince_south_carolina
concept_stateorprovince_indiana	concept:mutualproxyfor	concept_city_fort_wayne
concept_tradeunion_congress	concept:atdate	concept_dateliteral_n1987
concept_automobilemaker_nissan	concept:companyeconomicsector	concept_economicsector_auto
concept_profession_directors	concept:professionistypeofprofession	concept_profession_experts
concept_profession_nurses	concept:professionistypeofprofession	concept_profession_experts
concept_island_paul	concept:atdate	concept_dateliteral_n2008
concept_agriculturalproduct_northern	concept:mutualproxyfor	concept_newspaper_idaho
concept_sportsteam_philadelphia_phillies	concept:teamplaysagainstteam	concept_sportsteam_chicago_cubs
concept_person_brett	concept:persongraduatedschool	concept_university_college
concept_country_denmark	concept:atdate	concept_dateliteral_n2008
concept_country_france_france	concept:atdate	concept_year_n1975
concept_ceo_james_mcnerney	concept:worksfor	concept_biotechcompany_boeing
concept_biotechcompany_apple	concept:organizationterminatedperson	concept_person_wozniak
concept_person_lee001	concept:persongraduatedschool	concept_university_state_university
concept_automobilemaker_diagnosis	concept:atdate	concept_date_n2003
concept_politicianus_president_george_h_w__bush	concept:politicianusendorsedbypoliticianus	concept_politician_clinton
concept_sportsteam_toronto_blue_jays	concept:teamplaysagainstteam	concept_sportsteam_royals
concept_governmentorganization_bureau	concept:agentcreated	concept_programminglanguage_contact
concept_profession_engineers	concept:professionistypeofprofession	concept_profession_network
concept_sportsgame_series	concept:sportsgameteam	concept_sportsteam_expos
concept_country_armenia	concept:countrylocatedingeopoliticallocation	concept_stateorprovince_states
concept_musicartist_questions	concept:agentcreated	concept_transportation_fax
concept_sportsteam_chicago_bulls	concept:teamplaysagainstteam	concept_sportsteam_magic
concept_city_pittsfield	concept:mutualproxyfor	concept_beach_massachusetts
concept_coach_daunte_culpepper	concept:athleteledsportsteam	concept_sportsteam_minnesota_vikings
concept_celltype_incorporation	concept:atdate	concept_dateliteral_n2005
concept_sportsteam_los_angeles_lakers	concept:teamplaysagainstteam	concept_sportsteam_new_orleans_hornets
concept_furniture_sofa_sleeper	concept:furniturefoundinroom	concept_room_area
concept_country_vietnam	concept:countrylocatedingeopoliticallocation	concept_country_countries
concept_company_chrysler	concept:organizationterminatedperson	concept_person_lee_iacocca
concept_date_daughter	concept:atdate	concept_dayofweek_monday
concept_airport_north_america	concept:atdate	concept_date_n2004
concept_sportsteam_packers	concept:teamplaysagainstteam	concept_sportsteam_sd_chargers
concept_bird_falcons	concept:animalpreyson	concept_animal_birds002
concept_person_clark	concept:personbornincity	concept_city_orleans
concept_monument_supreme_court	concept:atdate	concept_dateliteral_n2007
concept_sportsteam_baylor_bears	concept:teamplaysinleague	concept_sportsleague_ncaa
concept_insect_aphids	concept:invertebratefeedonfood	concept_food_leaf
concept_charactertrait_institutions	concept:atdate	concept_date_n2003
concept_person_michael002	concept:personhasjobposition	concept_jobposition_king
concept_company_post	concept:hasofficeincity	concept_city_l_a_
concept_charactertrait_survey	concept:atdate	concept_dateliteral_n2005
concept_invertebrate_worms	concept:animalistypeofanimal	concept_animal_invertebrates
concept_sportsteam_kansas_state	concept:teamplaysagainstteam	concept_sportsteam_usc
concept_sportsgame_playoffs	concept:sportsgameteam	concept_sportsteam_yankees
concept_sportsteam_minnesota_vikings	concept:teamwontrophy	concept_awardtrophytournament_division
concept_city_london_city	concept:atdate	concept_dateliteral_n1918
concept_country_england	concept:atdate	concept_dateliteral_n1945
concept_animal_children	concept:animaldevelopdisease	concept_disease_diabetes
concept_furniture_sleigh_bed	concept:furniturefoundinroom	concept_officebuildingroom_large_bedroom
concept_book_years	concept:atlocation	concept_landscapefeatures_gulf
concept_musicalbum_child	concept:atdate	concept_dateliteral_n2006
concept_website_cent	concept:atdate	concept_dateliteral_n2002
concept_arthropod_crustaceans	concept:arthropodcalledarthropod	concept_crustacean_crab
concept_male_russia	concept:atdate	concept_year_n1997
concept_person_aaron_brooks	concept:personhasjobposition	concept_jobposition_king
concept_website_bangladesh	concept:atdate	concept_year_n1997
concept_city_taipei	concept:atdate	concept_dateliteral_n2007
concept_invertebrate_crustaceans	concept:animalistypeofanimal	concept_animal_invertebrates
concept_city_parents	concept:atdate	concept_date_n2004
concept_city_communities	concept:atdate	concept_dateliteral_n2007
concept_visualizablething_album	concept:atdate	concept_date_n2004
concept_city_parents	concept:mutualproxyfor	concept_beverage_new
concept_profession_practitioners	concept:professionistypeofprofession	concept_jobposition_physician
concept_musician_john	concept:musicianplaysinstrument	concept_musicinstrument_flute
concept_politicianus_presidential_elections	concept:atdate	concept_date_n2003
concept_athlete_pete_sampras	concept:athletebeatathlete	concept_athlete_stefan_edberg
concept_coach_jon_gruden	concept:coachesteam	concept_sportsteam_bucs
concept_biotechcompany_cisco_systems_inc_	concept:organizationhiredperson	concept_ceo_john_chambers
concept_automobilemaker_buick	concept:automobilemakerdealersincountry	concept_country_canada_canada
concept_agriculturalproduct_grains	concept:agriculturalproductincludingagriculturalproduct	concept_grain_oatmeal
concept_person_mugabe	concept:personleadsgeopoliticalorganization	concept_city_official
concept_mammal_bears	concept:animalistypeofanimal	concept_animal_beasts
concept_company_msn	concept:agentcompeteswithagent	concept_university_search
concept_website_partnership	concept:atdate	concept_date_n2004
concept_county_paris	concept:atdate	concept_date_n2000
concept_website_partnership	concept:atdate	concept_date_n2001
concept_automobilemaker_honda_motor_co_	concept:mutualproxyfor	concept_musicartist_takeo_fukui
concept_sportsteam_carolina_panthers	concept:agentparticipatedinevent	concept_convention_games
concept_crimeorcharge_prison	concept:atdate	concept_dateliteral_n2008
concept_governmentorganization_government	concept:atdate	concept_dateliteral_n1945
concept_governmentorganization_launch	concept:atdate	concept_dateliteral_n2007
concept_book_america	concept:atdate	concept_date_n2004
concept_city_brisbane	concept:atdate	concept_dateliteral_n2005
concept_sportsteam_esu_hornets	concept:teamplaysagainstteam	concept_sportsteam_golden_state_warriors
concept_island_staff	concept:atdate	concept_date_n2003
concept_company_press	concept:organizationhiredperson	concept_personmexico_ryan_whitney
concept_physicalaction_paper	concept:atdate	concept_date_n2004
concept_mammal_dog	concept:animalpreyson	concept_animal_puppy
concept_academicfield_engineering	concept:academicfieldsuchasacademicfield	concept_academicfield_engineering_technology
concept_city_place	concept:atdate	concept_date_n1958
concept_celebrity_season	concept:atdate	concept_dateliteral_n2008
concept_sport_squash	concept:sportusesequipment	concept_sportsequipment_ball
concept_comedian_wild_animals	concept:agentcompeteswithagent	concept_animal_animals001
concept_company_national	concept:hasofficeincity	concept_city_center
concept_person_andrew001	concept:personhasjobposition	concept_jobposition_king
concept_company_new_york	concept:mutualproxyfor	concept_island_new_york_city_metropolitan_area
concept_sportsteam_minnesota_vikings	concept:teamplaysagainstteam	concept_sportsteam_seahawks
concept_sportsgame_championship	concept:sportsgameteam	concept_sportsteam_royals
concept_automobilemaker_chevrolet	concept:automobilemakerdealersincity	concept_city_denver
concept_televisionshow_mission	concept:atdate	concept_dateliteral_n2008
concept_nondiseasecondition_period	concept:atdate	concept_dateliteral_n2002
concept_automobilemaker_bmw	concept:automobilemakerdealersincity	concept_city_san_diego
concept_governmentorganization_legislation	concept:atdate	concept_date_n2003
concept_book_new	concept:mutualproxyfor	concept_book_leader
concept_cognitiveactions_launching	concept:atdate	concept_date_n2000
concept_sportsteam_golden_state_warriors	concept:teamplaysagainstteam	concept_sportsteam_trail_blazers
concept_medicalprocedure_cancer	concept:atdate	concept_date_n1999
concept_website_shop	concept:atdate	concept_date_n2003
concept_mammal_foxes	concept:animalpreyson	concept_mammal_predators
concept_musicgenre_progressive_metal	concept:musicgenressuchasmusicgenres	concept_musicgenre_progressive_rock
concept_furniture_beds	concept:furniturefoundinroom	concept_visualizablescene_bedroom
concept_insect_scale	concept:arthropodandotherarthropod	concept_insect_insects
concept_sportsteam_raptors	concept:teamplaysagainstteam	concept_sportsteam_timberwolves
concept_sportsteam_red_sox_this_season	concept:teamplaysagainstteam	concept_sportsteam_oakland_athletics
concept_jobposition_meeting	concept:atdate	concept_year_n1963
concept_visualizablething_baths	concept:itemfoundinroom	concept_officebuildingroom_private_bathroom
concept_bathroomitem_shower	concept:itemfoundinroom	concept_officebuildingroom_suites
concept_company_air_india	concept:hasofficeincity	concept_city_new_york
concept_city_islamabad	concept:atdate	concept_year_n1994
concept_sportsteam_chicago_cubs	concept:teamplaysincity	concept_city_chicago
concept_animal_herbivores	concept:animalpreyson	concept_mammal_horses
concept_vegetable_onion	concept:agriculturalproductcookedwithagriculturalproduct	concept_food_tomatoes
concept_building_first_time	concept:atdate	concept_year_n1982
concept_invertebrate_teens	concept:animaldevelopdisease	concept_disease_disorders
concept_musicalbum_run	concept:atdate	concept_date_n2001
concept_sportsgame_finals	concept:sportsgameteam	concept_sportsteam_rangers
concept_crimeorcharge_appeals	concept:atdate	concept_dateliteral_n2007
concept_agriculturalproduct_crops	concept:agriculturalproductincludingagriculturalproduct	concept_agriculturalproduct_cloves
concept_website_tour	concept:atdate	concept_year_n1978
concept_physicalaction_development	concept:atdate	concept_date_n2001
concept_visualizablething_employment	concept:atdate	concept_date_n2003
concept_academicfield_computer_science	concept:atdate	concept_year_n1997
concept_jobposition_meeting	concept:atdate	concept_year_n1995
concept_county_las_vegas	concept:atdate	concept_date_n2003
concept_city_glendale	concept:atlocation	concept_stateorprovince_arizona
concept_sportsteam_minnesota_twins	concept:teamplaysagainstteam	concept_sportsteam_yankees
concept_mammal_rodents	concept:animalpreyson	concept_animal_moles
concept_musicartist_american	concept:agentactsinlocation	concept_website_orange
concept_book_new	concept:mutualproxyfor	concept_year_n1970
concept_vertebrate_search	concept:agentcompeteswithagent	concept_agriculturalproduct_option
concept_politician_jobs	concept:agentcollaborateswithagent	concept_personus_jobs
concept_sportsgame_finals	concept:sportsgameteam	concept_sportsteam_heat
concept_person_abraham_lincoln	concept:personbelongstoorganization	concept_politicalparty_college
concept_company_microsoft	concept:companyeconomicsector	concept_academicfield_information_technology
concept_island_mother	concept:istallerthan	concept_publication_people_
concept_mammal_squirrels	concept:animalpreyson	concept_animal_creatures
concept_book_attention	concept:atdate	concept_date_n2004
concept_buildingfeature_frames	concept:buildingfeaturemadefrombuildingmaterial	concept_buildingmaterial_glass
concept_sportsequipment_board	concept:mutualproxyfor	concept_island_staff
concept_stateorprovince_states	concept:statelocatedingeopoliticallocation	concept_county_chicago
concept_sportsteam_steelers	concept:teamplaysagainstteam	concept_sportsteam_carolina
concept_city_article	concept:atdate	concept_dateliteral_n1990
concept_city_title	concept:atdate	concept_year_n1989
concept_sportsteam_bobcats	concept:teamplaysagainstteam	concept_sportsteam_florida_international
concept_bedroomitem_bed	concept:itemfoundinroom	concept_room_guest_stateroom
concept_profession_workers	concept:professionistypeofprofession	concept_profession_clinicians
concept_beverage_raspberry	concept:beveragemadefrombeverage	concept_beverage_sauce
concept_city_washington_d_c	concept:atdate	concept_dateliteral_n2006
concept_televisionnetwork_cbs	concept:hasofficeincity	concept_city_philadelphia
concept_person_joseph003	concept:persongraduatedschool	concept_university_college
concept_sportsteam_spurs	concept:teamplaysagainstteam	concept_sportsteam_kings_college
concept_sportsteam_cleveland_browns	concept:teamplaysagainstteam	concept_sportsteam_bengals
concept_sportsteam_chicago_white_sox	concept:teamplaysagainstteam	concept_sportsteam_minnesota_twins
concept_city_communities	concept:agentparticipatedinevent	concept_eventoutcome_result
concept_country_united_states	concept:atdate	concept_year_n1995
concept_sportsteam_red_wings	concept:teamplaysagainstteam	concept_sportsteam_pittsburgh_penguins
concept_coach_sparano	concept:worksfor	concept_sportsleague_new
concept_musicgenre_guidelines	concept:atdate	concept_date_n2004
concept_stateorprovince_california	concept:mutualproxyfor	concept_city_lafayette
concept_country_malaysia	concept:countrylocatedingeopoliticallocation	concept_country_southeast_asian_countries
concept_personaustralia_guardian	concept:atdate	concept_dateliteral_n2007
concept_stateorprovince_states	concept:statelocatedingeopoliticallocation	concept_city_parents
concept_country_namibia	concept:countrylocatedingeopoliticallocation	concept_country_countries
concept_sportsteam_stanford	concept:teamplaysagainstteam	concept_sportsteam_harvard_divinity_school
concept_company_union_carbide	concept:organizationheadquarteredincity	concept_city_danbury
concept_geopoliticallocation_national	concept:atlocation	concept_stateorprovince_new_york
concept_airport_north_america	concept:atdate	concept_date_n2003
concept_coach_san_antonio_spurs	concept:agentparticipatedinevent	concept_sportsgame_championship
concept_city_prague	concept:cityliesonriver	concept_river_elbe
concept_jobposition_nursing	concept:professionistypeofprofession	concept_profession_support
concept_animal_organisms	concept:animalpreyson	concept_mammal_rats
concept_nongovorganization_u_s_	concept:atdate	concept_dateliteral_n2010
concept_jobposition_last_week	concept:atdate	concept_dateliteral_n2008
concept_bird_trip	concept:agentparticipatedinevent	concept_sportsgame_playoffs
concept_programminglanguage_command	concept:atdate	concept_dateliteral_n2007
concept_mammal_coyotes	concept:animalistypeofanimal	concept_mammal_dogs
concept_city_rio	concept:atdate	concept_dateliteral_n2008
concept_website_tour	concept:atdate	concept_month_september
concept_politicsissue_experience	concept:atdate	concept_year_n1991
concept_sportsteam_cavs	concept:teamplaysinleague	concept_sportsleague_nba
concept_sportsteam_seahawks	concept:teamplaysagainstteam	concept_sportsteam_kansas_city_chiefs
concept_company_los_angeles	concept:mutualproxyfor	concept_sportsteam_knicks
concept_beverage_new	concept:atlocation	concept_website_license
concept_blog_mtv	concept:companyeconomicsector	concept_politicsissue_entertainment
concept_comedian_day	concept:atdate	concept_year_n1983
concept_vegetable_potatoes	concept:agriculturalproductcookedwithagriculturalproduct	concept_vegetable_beans
concept_website_chicago_tribune	concept:companyeconomicsector	concept_academicfield_media
concept_room_south	concept:atlocation	concept_continent_africa
concept_journalist_frank_rich	concept:worksfor	concept_website_new_york_times
concept_sportsteam_seminoles	concept:teamplaysagainstteam	concept_sportsteam_maryland
concept_mammal_rats	concept:animalistypeofanimal	concept_animal_small_mammals
concept_politicianus_condoleezza_rice	concept:politicianusendorsedbypoliticianus	concept_politician_clinton
concept_personmexico_ryan_whitney	concept:worksfor	concept_musicartist_policy
concept_blog_abc_news	concept:organizationheadquarteredincity	concept_city_new_york
concept_musician_eric	concept:musicianplaysinstrument	concept_musicinstrument_vocals
concept_weapon_weapons	concept:weaponmadeincountry	concept_country_sudan
concept_drug_cialis	concept:drughassideeffect	concept_disease_side_effects
concept_island_post	concept:atdate	concept_date_n2001
concept_ceo_fritz_henderson	concept:personleadsorganization	concept_company_general_motors001
concept_automobilemaker_toyota	concept:producesproduct	concept_automobilemodel_toyota_prius
concept_automobilemaker_porsche	concept:automobilemakerdealersincountry	concept_country_uk
concept_musicartist_times	concept:agentactsinlocation	concept_website_financial
concept_musicartist_american	concept:agentactsinlocation	concept_county_clark
concept_sportsteam_hawks	concept:teamplaysagainstteam	concept_sportsteam_magic
concept_year_new	concept:mutualproxyfor	concept_geopoliticalorganization_customers
concept_reptile_alligators	concept:animalpreyson	concept_mammal_reptiles
concept_sportsteam_falcons	concept:teamplaysagainstteam	concept_sportsteam_bills
concept_profession_authors	concept:professionistypeofprofession	concept_profession_professionals
concept_sportsequipment_balls	concept:thinghasshape	concept_ceo_online_application_form
concept_sportsteam_los_angeles_dodgers	concept:teamplaysinleague	concept_sportsleague_mlb
concept_agriculturalproduct_products	concept:agriculturalproductincludingagriculturalproduct	concept_food_meats
concept_plant_hardwoods	concept:plantincludeplant	concept_plant_oak
concept_website_washington_post	concept:hasofficeincity	concept_city_new_york
concept_stateorprovince_states	concept:statelocatedingeopoliticallocation	concept_organization_host
concept_politicianus_president_bush	concept:agentcollaborateswithagent	concept_person_house
concept_county_miami	concept:organizationhiredperson	concept_person_don_shula
concept_coach_marco_sturm	concept:athleteflyouttosportsteamposition	concept_sportsteamposition_center
concept_city_vienna	concept:atdate	concept_dateliteral_n2005
concept_country_puerto_rico	concept:countrylocatedingeopoliticallocation	concept_country_countries
concept_geometricshape_piece	concept:atdate	concept_date_n2000
concept_geopoliticallocation_agencies	concept:organizationhiredperson	concept_personmexico_ryan_whitney
concept_mammal_predators	concept:animalistypeofanimal	concept_mammal_foxes
concept_profession_network	concept:professionistypeofprofession	concept_profession_providers
concept_personafrica_mike_davis	concept:personbelongstoorganization	concept_university_iu
concept_mammal_companion_animals	concept:animalpreyson	concept_animal_pet
concept_person_carter	concept:personbelongstoorganization	concept_politicalparty_college
concept_sportsteam_mavericks	concept:teamplaysagainstteam	concept_sportsteam_new_jersey_nets
concept_athlete_gary	concept:personmovedtostateorprovince	concept_stateorprovince_texas
concept_stateorprovince_idaho	concept:stateorprovinceisborderedbystateorprovince	concept_stateorprovince_south_dakota
concept_sportsteam_los_angeles_dodgers	concept:teamplaysagainstteam	concept_sportsteam_padres
concept_jobposition_share	concept:atdate	concept_date_n2003
concept_date_wife	concept:atdate	concept_date_n2000
concept_city_external_links	concept:agentinvolvedwithitem	concept_buildingfeature_home
concept_sportsteam_liverpool	concept:teamplaysagainstteam	concept_sportsteam_barcelona_dragons
concept_country_britain	concept:countrylocatedingeopoliticallocation	concept_geopoliticallocation_european_nations
concept_blog_google	concept:companyeconomicsector	concept_economicsector_internet
concept_visualizablething_adoption	concept:atdate	concept_dateliteral_n2002
concept_person_republican	concept:agentcollaborateswithagent	concept_politicianus_governor_sarah_palin
concept_furniture_size_bed	concept:itemfoundinroom	concept_officebuildingroom_main_room
concept_geopoliticallocation_franchise	concept:atdate	concept_dateliteral_n2006
concept_coach_sarah_palin	concept:personleadsorganization	concept_city_alaska
concept_sportsteam_white_sox	concept:teamplaysagainstteam	concept_sportsteam_yankees
concept_building_first_time	concept:atdate	concept_year_n1983
concept_country_republic_of_austria	concept:atdate	concept_dateliteral_n2005
concept_plant_shrubs	concept:plantincludeplant	concept_plant_azaleas
concept_airport_europe	concept:atdate	concept_dateliteral_n2005
concept_city_athens	concept:citylocatedingeopoliticallocation	concept_country_greece
concept_city_carrollton	concept:atlocation	concept_stateorprovince_missouri
concept_company_fda	concept:atdate	concept_dateliteral_n2008
concept_weapon_national	concept:atlocation	concept_county_austin
concept_sportsteam_red_wings	concept:teamplaysagainstteam	concept_sportsteam_columbus_blue_jackets
concept_sportsteam_miami_hurricanes	concept:agentcollaborateswithagent	concept_personmexico_ncaa
concept_book_terms	concept:atdate	concept_dateliteral_n2007
concept_politicsissue_meetings	concept:atdate	concept_date_n2001
concept_profession_designers	concept:professionistypeofprofession	concept_profession_engineers
concept_coach_tom_cable	concept:worksfor	concept_university_raiders
concept_city_geneva	concept:atdate	concept_dateliteral_n2006
concept_year_new	concept:mutualproxyfor	concept_city_capital
concept_profession_members	concept:professionistypeofprofession	concept_profession_experts
concept_bedroomitem_bed	concept:itemfoundinroom	concept_officebuildingroom_accommodations
concept_fish_goldfish	concept:animalpreyson	concept_mammal_pets
concept_sportsteam_illini	concept:organizationhiredperson	concept_coach_bruce_weber
concept_coach_eric_mangini	concept:worksfor	concept_sportsteam_cleveland_browns
concept_governmentorganization_investigation	concept:atdate	concept_year_n1995
concept_politicianus_john_mccain	concept:politicianusendorsedbypoliticianus	concept_politicianus_senator_obama
concept_jobposition_owners	concept:atdate	concept_dateliteral_n2007
concept_beverage_lemon_juice	concept:beveragemadefrombeverage	concept_agriculturalproduct_syrup
concept_company_air_france	concept:hasofficeincity	concept_city_new_york
concept_automobilemaker_information	concept:agentcreated	concept_automobilemaker_contact
concept_city_london_city	concept:agentparticipatedinevent	concept_eventoutcome_result
concept_profession_practitioners	concept:professionistypeofprofession	concept_jobposition_nurse
concept_stateorprovince_states	concept:statelocatedingeopoliticallocation	concept_country_ethiopia
concept_physicalaction_programme	concept:atdate	concept_date_n1999
concept_sportsteam_chicago_bulls	concept:organizationhiredperson	concept_person_jackson001
concept_emotion_part	concept:istallerthan	concept_publication_people_
concept_stateorprovince_states	concept:statelocatedingeopoliticallocation	concept_stateorprovince_south_carolina
concept_musicartist_times	concept:organizationdissolvedatdate	concept_month_june
concept_profession_dieticians	concept:professionistypeofprofession	concept_profession_workers
concept_mammal_pets	concept:animalistypeofanimal	concept_mammal_small_dogs
concept_profession_authors	concept:professionistypeofprofession	concept_profession_experts
concept_sport_hockey	concept:sportfansincountry	concept_country_canada_canada
concept_city_home	concept:mutualproxyfor	concept_female_seven
concept_physicalaction_ceremony	concept:atdate	concept_date_n1996
concept_arthropod_arthropods	concept:animalpreyson	concept_arthropod_spiders
concept_personus_j__k__rowling	concept:agentcreated	concept_book_harry_potter_and_the_goblet_of_fire
concept_city_home	concept:atdate	concept_dateliteral_n1918
concept_personaustralia_guardian	concept:atdate	concept_date_n2004
concept_bedroomitem_bed	concept:itemfoundinroom	concept_room_lounge
concept_city_melbourne	concept:atdate	concept_dateliteral_n2008
concept_weatherphenomenon_two	concept:mutualproxyfor	concept_city_home
concept_drug_bextra	concept:drughassideeffect	concept_disease_heart_attack
concept_automobilemaker_bmw	concept:automobilemakerdealersincity	concept_city_raleigh
concept_jobposition_court	concept:atdate	concept_date_n1977
concept_city_burlington	concept:atlocation	concept_stateorprovince_north_carolina
concept_weatherphenomenon_two	concept:mutualproxyfor	concept_visualizablething_residence
concept_weatherphenomenon_pacific	concept:atdate	concept_date_n1942
concept_person_king	concept:personhascitizenship	concept_country_democratic_republic_of_congo
concept_company_national	concept:hasofficeincity	concept_city_belleville
concept_buildingfeature_american	concept:atlocation	concept_visualizablescene_demarest
concept_mammal_small_dogs	concept:animalistypeofanimal	concept_mammal_pets
concept_musicalbum_wedding	concept:atdate	concept_dateliteral_n2006
concept_perceptionaction_premiere	concept:atdate	concept_dateliteral_n2006
concept_country_romania	concept:countrylocatedingeopoliticallocation	concept_country_countries
concept_beverage_new	concept:atlocation	concept_building_america
concept_professor_david_pogue	concept:personbelongstoorganization	concept_politicsblog_ny_times
concept_sportsteam_boston_celtics	concept:teamplaysagainstteam	concept_sportsteam_knicks
concept_mammal_hares	concept:animalistypeofanimal	concept_mammal_small_animals
concept_academicfield_science	concept:academicfieldsuchasacademicfield	concept_politicsissue_education
concept_sportsteam_indiana_pacers	concept:teamplaysagainstteam	concept_sportsteam_nuggets
concept_stateorprovince_states	concept:statelocatedingeopoliticallocation	concept_country_united_states
concept_profession_professionals	concept:professionistypeofprofession	concept_profession_lawyers
concept_city_jakarta	concept:atdate	concept_dateliteral_n2006
concept_sport_bowling	concept:sportusesequipment	concept_tool_accessories
concept_bathroomitem_shower	concept:itemfoundinroom	concept_officebuildingroom_guestrooms
concept_stateorprovince_california	concept:mutualproxyfor	concept_city_auburn
concept_language_english	concept:languageofuniversity	concept_university_michigan_state_university
concept_sportsteam_utah_jazz	concept:teamplaysagainstteam	concept_sportsteam_la_clippers
concept_sportsteam_montreal_canadiens	concept:teamplaysagainstteam	concept_sportsteam_kings_college
concept_city_hudson	concept:cityliesonriver	concept_river_peace
concept_beverage_coffee	concept:agriculturalproductcookedwithagriculturalproduct	concept_vegetable_pepper
concept_sportsteam_pacers	concept:teamplaysagainstteam	concept_sportsteam_hawks
concept_geopoliticallocation_franchise	concept:atdate	concept_dateliteral_n2007
concept_visualartmovement_britain	concept:atdate	concept_dateliteral_n2008
concept_perceptionaction_hearing	concept:atdate	concept_year_n1995
concept_eventoutcome_practice	concept:atdate	concept_date_n2004
concept_book_recommendations	concept:atdate	concept_date_n2000
concept_mammal_domestic_pets	concept:animalpreyson	concept_mammal_dogs
concept_geometricshape_percent	concept:atdate	concept_year_n1982
concept_emotion_founding	concept:atdate	concept_dateliteral_n1990
concept_charactertrait_heart_attack	concept:atdate	concept_date_n2003
concept_geopoliticallocation_national	concept:agentactsinlocation	concept_aquarium_louis
concept_agriculturalproduct_flowers	concept:agriculturalproductgrowinginstateorprovince	concept_stateorprovince_west_virginia
concept_eventoutcome_report	concept:atdate	concept_year_n1998
concept_academicfield_exercise	concept:atdate	concept_dateliteral_n2007
concept_coach_n8	concept:mutualproxyfor	concept_governmentorganization_house
concept_politicianus_senator_obama	concept:politicianusendorsedbypoliticianus	concept_politician_clinton
concept_sport_golf	concept:sportusesequipment	concept_sportsequipment_bat
concept_governmentorganization_health	concept:atdate	concept_year_n1995
concept_jobposition_physician	concept:professionistypeofprofession	concept_profession_staff
concept_governmentorganization_standards	concept:atdate	concept_dateliteral_n2006
concept_sportsteam_yanks	concept:teamplaysagainstteam	concept_sportsteam_red_sox
concept_sportsteam_jacksonville_jaguars	concept:teamplaysagainstteam	concept_sportsteam_colts
concept_vegetable_garlic	concept:agriculturalproductcookedwithagriculturalproduct	concept_agriculturalproduct_red_pepper
concept_coach_mike_montgomery	concept:worksfor	concept_professionalorganization_cal
concept_stateorprovince_california	concept:mutualproxyfor	concept_city_santa_cruz_das_flores
concept_academicfield_control	concept:atdate	concept_date_n1999
concept_musicfestival_annual_meeting	concept:atdate	concept_date_n2001
concept_country_republic_of_india	concept:atdate	concept_year_n1991
concept_stadiumoreventvenue_georgia_dome	concept:atlocation	concept_city_atlanta
concept_geometricshape_procedure	concept:atdate	concept_dateliteral_n2006
concept_ceo_gerard_arpey	concept:personleadsorganization	concept_musicartist_american
concept_city_fox_valley	concept:atlocation	concept_stateorprovince_illinois
concept_musicalbum_line	concept:atdate	concept_date_n2004
concept_geopoliticallocation_hamilton	concept:mutualproxyfor	concept_radiostation_new_jersey
concept_beverage_wines	concept:beveragemadefrombeverage	concept_wine_chenin_blanc
concept_stateorprovince_west_virginia	concept:stateorprovinceisborderedbystateorprovince	concept_stateorprovince_pennsylvania
concept_city_army	concept:atdate	concept_year_n1997
concept_politicsissue_activity	concept:atdate	concept_dateliteral_n2008
concept_food_oil	concept:agriculturalproductcookedwithagriculturalproduct	concept_food_peppers
concept_person_mike	concept:personmovedtostateorprovince	concept_stateorprovince_colorado
concept_weapon_bomb	concept:weaponmadeincountry	concept_country_scandinavian_countries
concept_sportsgame_alcs	concept:sportsgameteam	concept_sportsteam_red_sox_this_season
concept_animal_girl	concept:agentparticipatedinevent	concept_eventoutcome_result
concept_sportsgame_series	concept:sportsgameteam	concept_sportsteam_heat
concept_bathroomitem_tub	concept:itemfoundinroom	concept_officebuildingroom_suite_bathrooms
concept_profession_physicians	concept:professionistypeofprofession	concept_profession_staff
concept_beverage_blends	concept:beveragemadefrombeverage	concept_wine_zinfandel
concept_televisionshow_cooperation	concept:atdate	concept_date_n2004
concept_furniture_size_bed	concept:itemfoundinroom	concept_officebuildingroom_single_rooms
concept_coach_frank_beamer	concept:worksfor	concept_sportsteam_hokies
concept_musician_john	concept:musicianplaysinstrument	concept_musicinstrument_bass
concept_sportsteam_charlotte_bobcats	concept:teamplaysinleague	concept_sportsleague_nba
concept_magazine_content	concept:agentcompeteswithagent	concept_personcanada_search
concept_country_haiti	concept:atdate	concept_year_n1995
concept_country_ukraine	concept:atdate	concept_dateliteral_n2006
concept_politicianus_nominee_john_mccain	concept:politicianusendorsedbypoliticianus	concept_politicianus_barack_obama
concept_stateorprovince_presentation	concept:agentinvolvedwithitem	concept_buildingfeature_window
concept_city_plymouth	concept:atlocation	concept_stateorprovince_michigan
concept_mammal_coyotes	concept:animalistypeofanimal	concept_mammal_predators
concept_furniture_bed	concept:furniturefoundinroom	concept_visualizablething_terrace
concept_weapon_arms	concept:weaponmadeincountry	concept_country_argentina
concept_mammal_large_mammals	concept:animalistypeofanimal	concept_animal_humans
concept_country_ukraine	concept:countrylocatedingeopoliticallocation	concept_country_countries
concept_bathroomitem_shower	concept:itemfoundinroom	concept_officebuildingroom_family_bathroom
concept_country_party	concept:atdate	concept_date_n1999
concept_agriculturalproduct_dairy_products	concept:agriculturalproductcomingfromvertebrate	concept_mammal_sheep
concept_county_athens	concept:atdate	concept_date_n2003
concept_jobposition_group	concept:atdate	concept_dateliteral_n2002
concept_city_home	concept:agentcompeteswithagent	concept_website_google_search
concept_celebrity_season	concept:atdate	concept_dayofweek_sunday
concept_musicalbum_cd	concept:atdate	concept_dateliteral_n2007
concept_furniture_bed	concept:furniturefoundinroom	concept_visualizablescene_areas
concept_crustacean_shrimp	concept:arthropodcalledarthropod	concept_arthropod_mussels
concept_sportsteam_dallas_cowboys	concept:teamplaysagainstteam	concept_sportsteam_oakland_raiders
concept_personcanada_search	concept:agentcompeteswithagent	concept_city_link
concept_governmentorganization_cabinet	concept:atdate	concept_dateliteral_n2005
concept_politicsblog_ipo	concept:atdate	concept_date_n2000
concept_medicalprocedure_cancer	concept:atdate	concept_date_n1993
concept_food_oil	concept:agriculturalproductcookedwithagriculturalproduct	concept_food_tofu
concept_musicartist_american	concept:agentactsinlocation	concept_city_milwaukee
concept_country_orleans	concept:atlocation	concept_lake_new
concept_fish_predatory_fish	concept:animalsuchasfish	concept_fish_swordfish
concept_insect_aphids	concept:arthropodcalledarthropod	concept_insect_beetles
concept_mammal_wolves	concept:specializationof	concept_mammal_wild_animals
concept_sportsgame_championship	concept:sportsgameteam	concept_sportsteam_white_sox
concept_profession_lawyers	concept:professionistypeofprofession	concept_profession_professionals
concept_county_harvard_university	concept:atdate	concept_dateliteral_n2005
concept_country_brazil	concept:countrylocatedingeopoliticallocation	concept_country_countries
concept_musicalbum_life	concept:atdate	concept_date_n1996
concept_male_richard_jefferson	concept:athleteplaysforteam	concept_sportsteam_kansas_city_chiefs
concept_country_poland	concept:atdate	concept_dateliteral_n1990
concept_agriculturalproduct_products	concept:agriculturalproductincludingagriculturalproduct	concept_visualizablething_vegetable_oils
concept_city_houston	concept:cityliesonriver	concept_river_brazos
concept_bedroomitem_bath	concept:itemfoundinroom	concept_officebuildingroom_master_bathroom
concept_bedroomitem_bed	concept:itemfoundinroom	concept_room_floor_master
concept_sportsteam_knicks	concept:teamplaysagainstteam	concept_sportsteam_bucks
concept_magazine_women	concept:agentparticipatedinevent	concept_crimeorcharge_offences
concept_jobposition_group	concept:atdate	concept_date_n1996
concept_mammal_pets	concept:animalpreyson	concept_animal_children
concept_sportsteam_red_sox	concept:teamplaysagainstteam	concept_sportsteam_texas_rangers
concept_hobby_music	concept:atdate	concept_dateliteral_n2006
concept_bedroomitem_bed	concept:itemfoundinroom	concept_room_family
concept_city_florida	concept:organizationhiredperson	concept_coach_urban_meyer
concept_furniture_chairs	concept:furniturefoundinroom	concept_room_kitchenette
concept_geopoliticalorganization_address	concept:agentcreated	concept_scientificterm_more_information_contact
concept_vegetable_garlic	concept:agriculturalproductcookedwithagriculturalproduct	concept_agriculturalproduct_black_pepper
concept_bathroomitem_tub	concept:itemfoundinroom	concept_officebuildingroom_accommodations
concept_celltype_incorporation	concept:atdate	concept_dateliteral_n2002
concept_sportsteam_seahawks	concept:teamplaysagainstteam	concept_sportsteam_bears_29_17
concept_athlete_peyton_manning	concept:athletehomestadium	concept_stadiumoreventvenue_lucas_oil_stadium
concept_eventoutcome_report	concept:atdate	concept_date_n1976
concept_invertebrate_crows	concept:agentcompeteswithagent	concept_animal_birds003
concept_profession_guides	concept:professionistypeofprofession	concept_profession_experts
concept_food_antioxidants	concept:fooddecreasestheriskofdisease	concept_disease_diseases
concept_person_mccain	concept:agentcollaborateswithagent	concept_personafrica_george_bush
concept_eventoutcome_retreat	concept:atdate	concept_dateliteral_n2002
concept_hobby_outdoor_activities	concept:hobbiessuchashobbies	concept_sport_mountain_biking
concept_sportsteam_magic	concept:teamplaysincity	concept_city_orlando
concept_profession_support	concept:professionistypeofprofession	concept_profession_care_professionals
concept_island_question	concept:atdate	concept_dateliteral_n2007
concept_agriculturalproduct_olive_oil	concept:agriculturalproductcookedwithagriculturalproduct	concept_vegetable_garlic
concept_terroristorganization_wet_season	concept:organizationdissolvedatdate	concept_month_may
concept_physicalaction_injury	concept:atdate	concept_date_n2004
concept_sportsteam_dallas_cowboys	concept:teamwontrophy	concept_awardtrophytournament_super_bowl_xlii
concept_vehicle_stock	concept:atdate	concept_dateliteral_n2008
concept_sportsteam_nuggets	concept:teamplaysagainstteam	concept_sportsteam_memphis_grizzlies
concept_city_baghdad	concept:atdate	concept_dateliteral_n2005
concept_book_network	concept:mutualproxyfor	concept_sportsequipment_board
concept_mammal_predators	concept:animalpreyson	concept_mammal_wild_dogs
concept_sportsteam_oilers	concept:teamplaysagainstteam	concept_sportsteam_kings_college
concept_plant_woodland	concept:plantincludeplant	concept_plant_acacia
concept_sportsleague_nba	concept:leaguestadiums	concept_stadiumoreventvenue_united_center
concept_automobilemaker_honda	concept:automobilemakerdealersincity	concept_city_wilmington
concept_politicianus_senator_kerry	concept:politicianusendorsedbypoliticianus	concept_politician_clinton
concept_vegetable_spinach	concept:agriculturalproductcookedwithagriculturalproduct	concept_agriculturalproduct_spices
concept_company_visitors	concept:atdate	concept_dateliteral_n2008
concept_country_poland	concept:atdate	concept_date_n2000
concept_company_national	concept:hasofficeincity	concept_city_arlington
concept_musicalbum_foundation	concept:atdate	concept_dateliteral_n2002
concept_ceo_eric_schmidt	concept:worksfor	concept_university_google
concept_coach_jeff_fisher	concept:coachesteam	concept_sportsteam_titans
concept_city_service	concept:atdate	concept_dateliteral_n2005
concept_musicartist_american	concept:agentactsinlocation	concept_museum_benton
concept_person_phil	concept:personbelongstoorganization	concept_politicalparty_college
concept_sportsteam_milwaukee_brewers	concept:teamplaysagainstteam	concept_sportsteam_chicago_cubs
concept_sportsgame_games	concept:sportsgameteam	concept_sportsteam_new_orleans_saints
concept_governmentorganization_house	concept:atdate	concept_date_n1977
concept_food_heart	concept:fooddecreasestheriskofdisease	concept_disease_arthritis
concept_mammal_dogs	concept:animalpreyson	concept_mammal_animals
concept_agriculturalproduct_products	concept:agriculturalproductincludingagriculturalproduct	concept_food_eggs
concept_city_new_york	concept:cityliesonriver	concept_river_niagara
concept_person_jason	concept:persongraduatedschool	concept_university_state_university
concept_person_charles001	concept:personhascitizenship	concept_country_sweden
concept_room_unit	concept:atdate	concept_month_october
concept_governmentorganization_chief_financial_officer	concept:atdate	concept_date_n2004
concept_mammal_small_animals	concept:animalistypeofanimal	concept_mammal_pets
concept_profession_staff	concept:professionistypeofprofession	concept_profession_professionals
concept_book_services	concept:atdate	concept_dateliteral_n2002
concept_country_morocco	concept:countrylocatedingeopoliticallocation	concept_stateorprovince_states
concept_person_bill	concept:personbelongstoorganization	concept_governmentorganization_representatives
concept_book_honeymoon	concept:mutualproxyfor	concept_book_new
concept_writer_kennedy	concept:personbelongstoorganization	concept_governmentorganization_house
concept_politicsissue_schools	concept:atdate	concept_month_may
concept_university_ministry	concept:atdate	concept_year_n1997
concept_company_ryanair	concept:hasofficeincity	concept_city_edinburgh
concept_sportsteam_knicks	concept:teamplaysagainstteam	concept_sportsteam_pistons
concept_sport_football	concept:sportfansincountry	concept_country_republic_of_india
concept_city_area	concept:agentcreated	concept_website_visit
concept_profession_psychotherapists	concept:professionistypeofprofession	concept_profession_professionals
concept_clothing_positions	concept:atdate	concept_dateliteral_n2005
concept_nongovorganization_guide	concept:organizationdissolvedatdate	concept_month_february
concept_sportsteam_buffalo_sabres	concept:teamplaysagainstteam	concept_sportsteam_devils
concept_automobilemaker_hyundai	concept:automobilemakerdealersincity	concept_city_san_diego
concept_animal_animals001	concept:animaldevelopdisease	concept_disease_tetanus
concept_city_sumter	concept:citylocatedinstate	concept_stateorprovince_alabama
concept_professor_andrew_revkin	concept:journalistwritesforpublication	concept_newspaper_ny_times
concept_sportsteam_ncaa_youth_kids	concept:agentcompeteswithagent	concept_stateorprovince_colorado
concept_biotechcompany_china	concept:atdate	concept_year_n1978
concept_country_rwanda	concept:atdate	concept_dateliteral_n2007
concept_governmentorganization_management	concept:atdate	concept_date_n2004
concept_hallwayitem_areas	concept:mutualproxyfor	concept_book_north
concept_city_service	concept:atdate	concept_date_n2000
concept_stateorprovince_paypal	concept:agentcompeteswithagent	concept_university_google
concept_buildingfeature_doors	concept:atdate	concept_date_n1979
concept_food_oil	concept:agriculturalproductcookedwithagriculturalproduct	concept_agriculturalproduct_cucumbers
concept_city_springfield	concept:atlocation	concept_city_florida
concept_insect_mites	concept:arthropodandotherarthropod	concept_insect_insects
concept_mammal_raccoons	concept:animalpreyson	concept_mammal_wild_animals
concept_city_jerusalem	concept:atdate	concept_dateliteral_n2006
concept_weapon_missiles	concept:weaponmadeincountry	concept_country_south_korea
concept_mlalgorithm_speech	concept:atdate	concept_dateliteral_n2002
concept_color_sky	concept:thinghascolor	concept_color_blue
concept_city_paris	concept:atdate	concept_year_n1921
concept_profession_medicine	concept:professionistypeofprofession	concept_profession_professions
concept_sportsteam_eagles	concept:teamplaysagainstteam	concept_sportsteam_skins
concept_language_english	concept:languageofuniversity	concept_university_dartmouth_college
concept_sportsteam_arizona_diamond_backs	concept:teamplaysagainstteam	concept_sportsteam_white_sox
concept_person_mugabe	concept:personleadsgeopoliticalorganization	concept_stateorprovince_ministers
concept_sportsteam_dallas_cowboys	concept:organizationhiredperson	concept_coach_bill_parcells
concept_country_croatia	concept:countrylocatedingeopoliticallocation	concept_geopoliticallocation_destinations
concept_profession_care_professionals	concept:professionistypeofprofession	concept_jobposition_physician
concept_bedroomitem_bath	concept:itemfoundinroom	concept_officebuildingroom_suites
concept_profession_tutors	concept:professionistypeofprofession	concept_profession_professionals
concept_geopoliticallocation_dvd	concept:atdate	concept_year_n1998
concept_profession_trainers	concept:professionistypeofprofession	concept_profession_professionals
concept_automobilemaker_bmw	concept:automobilemakerdealersincity	concept_city_denver
concept_politicsissue_elections	concept:atdate	concept_dateliteral_n1990
concept_sportsteam_ncaa_youth_kids	concept:agentactsinlocation	concept_stadiumoreventvenue_spartan_stadium
concept_biotechcompany_merrill_lynch	concept:companyeconomicsector	concept_economicsector_investment
concept_animal_babies	concept:animaldevelopdisease	concept_disease_syndrome
concept_sportsteam_sixers	concept:teamplaysagainstteam	concept_sportsteam_bucks
concept_profession_professionals	concept:professionistypeofprofession	concept_profession_anesthesiologists
concept_city_place	concept:atdate	concept_dateliteral_n2005
concept_musicartist_journal	concept:agentactsinlocation	concept_visualizablescene_ny
concept_insect_mosquitoes	concept:arthropodandotherarthropod	concept_insect_bugs
concept_profession_associate	concept:atdate	concept_dateliteral_n2007
concept_person_matt002	concept:personmovedtostateorprovince	concept_stateorprovince_new_york
concept_country_guyana	concept:countrylocatedingeopoliticallocation	concept_stateorprovince_states
concept_furniture_bed	concept:furniturefoundinroom	concept_officebuildingroom_one_room
concept_city_hawaii	concept:atdate	concept_dateliteral_n2007
concept_governmentorganization_governments	concept:atdate	concept_dateliteral_n2002
concept_city_prague	concept:atdate	concept_date_n2009
concept_politicsissue_students	concept:atdate	concept_dateliteral_n2008
concept_animal_carnivores	concept:animalpreyson	concept_animal_hyenas
concept_sport_ski	concept:sportusesequipment	concept_sportsequipment_apparel
concept_weapon_national	concept:atlocation	concept_city_morrow
concept_jobposition_premises	concept:atdate	concept_dateliteral_n2008
concept_automobilemaker_bmw	concept:automobilemakerdealersincity	concept_city_charlotte
concept_person_government	concept:agentcollaborateswithagent	concept_monarch_property
concept_sportsequipment_board	concept:mutualproxyfor	concept_attraction_academy
concept_profession_professionals	concept:professionistypeofprofession	concept_profession_healthcare_professionals
concept_sportsteam_texas_longhorns	concept:teamplaysagainstteam	concept_sportsteam_red_raiders
concept_scientist_email	concept:agentcreated	concept_movie_contact
concept_sportsteam_seahawks	concept:teamwontrophy	concept_awardtrophytournament_super_bowl
concept_stateorprovince_california	concept:statelocatedingeopoliticallocation	concept_country_u_s_
concept_mammal_cats	concept:animalistypeofanimal	concept_mammal_pets
concept_company_brother	concept:atdate	concept_year_n1995
concept_mammal_hunters	concept:animalpreyson	concept_bird_owls
concept_food_oils	concept:agriculturalproductcomingfromvertebrate	concept_animal_animals002
concept_bathroomitem_tub	concept:itemfoundinroom	concept_visualizablething_downstairs
concept_university_center	concept:agentcreated	concept_website_visit
concept_vegetable_pepper	concept:agriculturalproductcookedwithagriculturalproduct	concept_agriculturalproduct_cocoa
concept_vegetable_pepper	concept:agriculturalproductcookedwithagriculturalproduct	concept_meat_ham
concept_athlete_joe_bradley	concept:athleteplayssportsteamposition	concept_sportsteamposition_player
concept_personmexico_jose_castillo	concept:athletehomestadium	concept_stadiumoreventvenue_giants_stadium
concept_meat_bacon	concept:agriculturalproductcookedwithagriculturalproduct	concept_vegetable_pepper
concept_city_madrid	concept:atdate	concept_date_n2009
concept_visualizableobject_hair_dryer	concept:itemfoundinroom	concept_officebuildingroom_en_suite_bathroom
concept_musicgenre_american	concept:musicgenressuchasmusicgenres	concept_musicgenre_rock
concept_agriculturalproduct_thyme	concept:agriculturalproductcookedwithagriculturalproduct	concept_agriculturalproduct_salt
concept_charactertrait_agreement	concept:atdate	concept_year_n1991
concept_automobilemaker_request	concept:agentcreated	concept_programminglanguage_contact
concept_person_greg001	concept:personbelongstoorganization	concept_politicalparty_college
concept_country_ghana	concept:countrylocatedingeopoliticallocation	concept_stateorprovince_states
concept_sociopolitical_war	concept:atdate	concept_date_n1999
concept_sportsgame_games	concept:sportsgameteam	concept_sportsteam_cleveland_browns
concept_company_national	concept:hasofficeincity	concept_city_rochester
concept_mammal_animals	concept:animalpreyson	concept_mammal_whales
concept_politicaloffice_mayor	concept:atdate	concept_dateliteral_n2006
concept_profession_faculty	concept:professionistypeofprofession	concept_profession_staff
concept_musicalbum_family	concept:atdate	concept_dateliteral_n2002
concept_politicianus_george_w_	concept:agentcollaborateswithagent	concept_person_house
concept_sportsgame_postseason	concept:atdate	concept_date_n1993
concept_person_alex_rodriguez	concept:personbelongstoorganization	concept_company_new_york
concept_company_national	concept:agentactsinlocation	concept_airport_canton
concept_scientist_assistant_professor	concept:atdate	concept_dateliteral_n2008
concept_politicaloffice_executive_committee	concept:atdate	concept_date_n2004
concept_person_katsuaki_watanabe	concept:personleadsorganization	concept_automobilemaker_toyota_motor
concept_personnorthamerica_kevin_reilly	concept:personleadsorganization	concept_company_nbc
concept_country_belgium	concept:atdate	concept_dateliteral_n2005
concept_sportsteam_esu_hornets	concept:teamplaysagainstteam	concept_sportsteam_dallas_mavericks
concept_politicianus_mr__bush	concept:politicianusendorsedbypoliticianus	concept_politicianus_dick_cheney
concept_fish_game_fish	concept:animalsuchasfish	concept_fish_trout
concept_furniture_size_bed	concept:itemfoundinroom	concept_room_master
concept_geopoliticallocation_burma	concept:atdate	concept_date_n1944
concept_country_usa	concept:countrylocatedingeopoliticallocation	concept_river_counties
concept_mammal_cats	concept:animalistypeofanimal	concept_mammal_cat
concept_animal_manatees	concept:agentparticipatedinevent	concept_eventoutcome_result
concept_vegetable_corn	concept:agriculturalproductcookedwithagriculturalproduct	concept_vegetable_onion
concept_agriculturalproduct_cotton	concept:agriculturalproductgrowinginstateorprovince	concept_stateorprovince_texas
concept_geopoliticalorganization_theaters	concept:atdate	concept_dateliteral_n2007
concept_bank_barclays	concept:companyeconomicsector	concept_economicsector_investment
concept_sportsteam_bucs	concept:organizationhiredperson	concept_coach_jon_gruden
concept_year_new	concept:mutualproxyfor	concept_city_father
concept_sportsgame_national_league_championship_series	concept:sportsgamewinner	concept_sportsteam_phillies
concept_agriculturalproduct_black_pepper	concept:agriculturalproductcookedwithagriculturalproduct	concept_vegetable_parsley
concept_furniture_beds	concept:furniturefoundinroom	concept_officebuildingroom_deluxe_suites
