Goran_Vujović	playsFor	Kecskeméti_TE
Artsyom_Chelyadzinski	playsFor	Belarus_national_football_team
Adam_Lockwood	playsFor	Yeovil_Town_F.C.
Nuno_Miguel_Mendes_Cavaleiro	playsFor	C.F._Os_Belenenses
Salvatore_Masiello	playsFor	U.S._Città_di_Palermo
Clemer	playsFor	Esporte_Clube_Santo_André
John_Paul_II_International_Airport_Kraków–Balice	isConnectedTo	Paphos_International_Airport
Salih_Altın	playsFor	Eskişehirspor
Ryan_Coiner	playsFor	Arminia_Bielefeld
Lee_Steele	wasBornIn	Liverpool
Oleksandr_Sevidov	playsFor	FC_Metalurh_Donetsk
John_McNamee	playsFor	Celtic_F.C.
Wayne_Dyer_(footballer)	wasBornIn	Birmingham
Carlos_Castro_Mora	playsFor	FK_Haugesund
José_Dominguez	playsFor	Portugal_national_football_team
Benny_Wendt	playsFor	SC_Freiburg
Steve_White_(footballer)	playsFor	Bath_City_F.C.
Alfred_Phiri	playsFor	South_Africa_national_football_team
Vienna_International_Airport	isConnectedTo	Chios_Island_National_Airport
Vladimir_Bogdanović	playsFor	Panetolikos_F.C.
John_Ferguson_(English_footballer)	playsFor	Manchester_United_F.C.
Pedro_Mario_Álvarez	playsFor	Real_Betis
Fernando_Leal	playsFor	Betim_Esporte_Clube
Samuel_Quina	playsFor	Odivelas_F.C.
Michele_Mignani	playsFor	A.C._Monza_Brianza_1912
Alfred_G._Knudson	playsFor	Derby_County_F.C.
Péter_Andorka	playsFor	Zalaegerszegi_TE
Tomislav_Dujmović	wasBornIn	Zagreb
Dean_Holdsworth	playsFor	Watford_F.C.
Shane_Higgs	wasBornIn	Oxford
Derek_Brazil	playsFor	Cardiff_Metropolitan_University_F.C.
Kari_Ukkonen	playsFor	Kuopion_Palloseura
London_Heathrow_Terminal_5	isConnectedTo	Bologna
Craig_Herbert	playsFor	Torquay_United_F.C.
Dean_Peer	playsFor	Evesham_United_F.C.
David_Siradze	playsFor	Georgia_national_under-17_football_team
Hangzhou_Xiaoshan_International_Airport	isConnectedTo	Kota_Kinabalu_International_Airport
Rafał_Niżnik	playsFor	ŁKS_Łódź
Slavi_Kostenski	playsFor	OFC_Pomorie
Nabil_Baha	playsFor	S.C._Braga_B
Cyrille_Makanaky	playsFor	Barcelona_Sporting_Club
Daniel_Broadbent	playsFor	England_national_under-16_football_team
Goran_Vincetić	playsFor	HNK_Rijeka
Stephen_Hughes_(footballer,_born_1982)	playsFor	Scotland_national_football_B_team
Emil_Angelov	playsFor	Bulgaria_national_football_team
Leonardo_da_Vinci–Fiumicino_Airport	isConnectedTo	Abeid_Amani_Karume_International_Airport
Edison_Fonseca	playsFor	Envigado_F.C.
Ali_Riley	playsFor	Stanford_Cardinal
Andrzej_Juskowiak	playsFor	FC_Erzgebirge_Aue
Grzegorz_Bonin	playsFor	ŁKS_Łódź
Nantong_Xingdong_Airport	isConnectedTo	Chongqing_Jiangbei_International_Airport
Vedran_Celiščak	playsFor	NK_Posušje
Per_Frimann	playsFor	R.S.C._Anderlecht
Dubravko_Pavličić	playsFor	HNK_Rijeka
Abeid_Amani_Karume_International_Airport	isConnectedTo	Verona_Villafranca_Airport
Fabio_Daprelà	playsFor	Switzerland_national_under-19_football_team
José_Yudica	playsFor	Estudiantes_de_La_Plata
Lyubomir_Kantonistov	playsFor	FC_Baltika_Kaliningrad
Eduardo_Pereira	playsFor	Montevideo_Wanderers_F.C.
Thomas_Murray_(soccer)	playsFor	Brooklyn_Wanderers
Göteborg_Landvetter_Airport	isConnectedTo	Zadar_Airport
Phil_King_(footballer)	playsFor	Cinderford_Town_A.F.C.
Abdullah_Halman	playsFor	Gaziantep_Büyükşehir_Belediyespor
Paul_Gerrard	playsFor	Nottingham_Forest_F.C.
Carlos_Merino	playsFor	Gimnàstic_de_Tarragona
Héctor_Giménez_(footballer)	playsFor	San_Luis_F.C.
Mick_Moody	playsFor	Home_Farm_F.C.
Jaroslav_Hílek	playsFor	FC_Spartak_Trnava
Domingo_Cisma_González	wasBornIn	Seville
Selim_Benachour	playsFor	FC_Martigues
Daniel_Marín	playsFor	Gimnàstic_de_Tarragona
Steed_Malbranque	playsFor	Montpellier_HSC
Lee_Norfolk	playsFor	King's_Lynn_F.C.
Nazar_Baýramow	playsFor	FC_Astana
Marek_Jarolím	playsFor	Iraklis_Thessaloniki_F.C.
Ross_Barkley	playsFor	Leeds_United_A.F.C.
Robert_Paris	playsFor	Kingstonian_F.C.
Frank_Egharevba	playsFor	Widzew_Łódź
Rainer_Adrion	playsFor	SpVgg_Unterhaching
Victor_Ferreyra	playsFor	Club_Atlético_Belgrano
Nzelo_Hervé_Lembi	playsFor	Beerschot_AC
Andrew_Parkinson_(soccer)	playsFor	Newcastle_United_F.C.
Sergio_Hellings	wasBornIn	Amsterdam
Marco_Malagò	playsFor	Italy_national_under-19_football_team
Ruud_Brood	playsFor	FC_Den_Bosch
Amadou_Rabihou	playsFor	FK_DAC_1904_Dunajská_Streda
Avi_Reikan	playsFor	Israel_national_under-17_football_team
Sócrates	playsFor	Sport_Club_Corinthians_Paulista
Luis_Tevenet	playsFor	Sevilla_FC
Bernie_Slaven	playsFor	Queen_of_the_South_F.C.
Nigel_Winterburn	playsFor	Wimbledon_F.C.
Alex_Bunbury	playsFor	Toronto_Blizzard_(1986–93)
Bruno_César	playsFor	Sociedade_Esportiva_Palmeiras
Douglas_da_Costa_Souza	playsFor	Sport_Club_do_Recife
Renato_Queirós	playsFor	Amarante_FC
Scott_Murray_(footballer_born_1974)	playsFor	Aston_Villa_F.C.
Stefan_Wessels	playsFor	Germany_national_football_B_team
Gastón_Esmerado	playsFor	Estudiantes_de_La_Plata
Roberto_Carlos_Cortés	playsFor	Club_Libertad
Antonio_Pacheco_D'Agosti	playsFor	Albacete_Balompié
Eleandro_Pema	wasBornIn	Tirana
Júnior_Negrão	playsFor	Figueirense_Futebol_Clube
Rinaldo_Santana_dos_Santos	playsFor	Uberlândia_Esporte_Clube
Paulo_Ricardo_Alves_da_Silva	playsFor	Ceilândia_Esporte_Clube
Alan_Gow	playsFor	Rangers_F.C.
Hürriyet_Gücer	playsFor	Turkey_national_under-19_football_team
Jozef_Kožlej	playsFor	1._FC_Tatran_Prešov
Daniel_Šmejkal	playsFor	FK_Bohemians_Prague_(Střížkov)
Ersin_Güreler	playsFor	Eskişehirspor
Eber_Moas	wasBornIn	Montevideo
Bandaranaike_International_Airport	isConnectedTo	Sharjah_International_Airport
Liban_Abdi	playsFor	Ferencvárosi_TC
Alejandro_Osorio	playsFor	Club_Deportivo_Universidad_Católica
Hundred_Days	happenedIn	Prussia
Mario_Regueiro	playsFor	Racing_de_Santander
Zvonko_Monsider	playsFor	Yugoslavia_national_football_team
William_Mokoena	playsFor	AmaZulu_F.C.
Ervin_Bulku	playsFor	Albania_national_football_team
Shenzhen_Bao'an_International_Airport	isConnectedTo	Beihai_Fucheng_Airport
Pape_Samba_Ba	playsFor	KSZO_Ostrowiec_Świętokrzyski
Guntars_Silagailis	playsFor	FC_Jūrmala
Diogo_Tavares	playsFor	Frosinone_Calcio
Richard_Goulooze	playsFor	SC_Heerenveen
Halland	hasCapital	Halmstad
Russell_Coughlin	playsFor	Blackburn_Rovers_F.C.
Fallah_Johnson	playsFor	Persik_Kediri
Dario_Venitucci	playsFor	Foggia_Calcio
Rúnar_Már_Sigurjónsson	playsFor	Iceland_national_under-21_football_team
Aidas_Preikšaitis	playsFor	Kickers_Emden
Middle_Eastern_theatre_of_World_War_I	happenedIn	Egypt
Gilberto_Galdino_dos_Santos	playsFor	Rampla_Juniors
Juan_José_Borrelli	playsFor	Club_Atlético_Tigre
Vladan_Milovanović	playsFor	VfL_Osnabrück
Ljubljana_Jože_Pučnik_Airport	isConnectedTo	Sarajevo_International_Airport
Bouchaib_El_Moubarki	playsFor	Al-Wakrah_Sport_Club
Wayne_Burnett	playsFor	Fisher_Athletic_F.C.
Attila_Tököli	playsFor	1._FC_Köln
Dan_Gosling	playsFor	Newcastle_United_F.C.
Andrea_Lombardo	playsFor	Atalanta_B.C.
Michael_Tommy_(footballer)	wasBornIn	Freetown
Simon_Whaley	playsFor	Bradford_City_A.F.C.
Gyula_Nagy	playsFor	Grenoble_Foot_38
David_Forde_(footballer)	playsFor	Barnet_F.C.
Rychely	playsFor	Esporte_Clube_Santo_André
Dănuț_Lupu	wasBornIn	Galați
Roberto_Donadoni	playsFor	New_York_Red_Bulls
Edson_José_da_Silva	playsFor	São_Paulo_FC
Kristiansand_Airport,_Kjevik	isConnectedTo	Tenerife_South_Airport
Zoltán_Czibor	playsFor	CE_Europa
Levon_Hayrapetyan	playsFor	Widzew_Łódź
Trondheim_Airport,_Værnes	isConnectedTo	Murcia–San_Javier_Airport
Luciano_Emílio	playsFor	União_Agrícola_Barbarense_Futebol_Clube
Darren_Hare	playsFor	Folkestone_Invicta_F.C.
Sébastien_Bassong	playsFor	Newcastle_United_F.C.
Sílvio_Carlos_de_Oliveira	playsFor	FC_Zürich
Cho_Jae-jin	playsFor	South_Korea_national_under-23_football_team
Roberto_Lopes_Nascimento	playsFor	Fortaleza_Esporte_Clube
Gary_Silk	playsFor	Barnet_F.C.
Jari_Litmanen	playsFor	Malmö_FF
David_Perkins_(footballer)	playsFor	Stockport_County_F.C.
Jean_Luciano	playsFor	UD_Las_Palmas
Shymkent_International_Airport	isConnectedTo	Aktau_Airport
Avgerinos_Katranas	playsFor	Panetolikos_F.C.
Darko_Pančev	playsFor	Yugoslavia_national_football_team
André_Paulino	wasBornIn	Rio_de_Janeiro
Wasiu_Taiwo	playsFor	MVV_Maastricht
Frédéric_Tatarian	playsFor	US_Créteil-Lusitanos
Javier_Acuña	playsFor	Udinese_Calcio
Goran_Vujović	playsFor	Montenegro_national_under-21_football_team
Adam_Green_(footballer)	playsFor	Hayes_&_Yeading_United_F.C.
Ivan_Stoyanov_(footballer_born_1983)	playsFor	OFC_Sliven_2000
Stephen_O'Halloran	playsFor	Swansea_City_A.F.C.
Souleymane_Oulare	playsFor	K.S.K._Beveren
Neto_(footballer)	playsFor	São_Paulo_FC
Jonathan_Fabbro	playsFor	Club_Guaraní
Pierre-Emerick_Aubameyang	playsFor	Lille_OSC
José_Luis_Brown	playsFor	Estudiantes_de_La_Plata
Fernando_Meneses	playsFor	O'Higgins_F.C.
Miguel_Pedro	playsFor	C.D._Feirense
Ivan_Zammit	playsFor	Birkirkara_F.C.
Ramon_Menezes_Hubner	playsFor	Tokyo_Verdy
Pedro_Taborda	playsFor	F.C._Vizela
Jörg_Heinrich	playsFor	ACF_Fiorentina
Aleksandr_Khvostunov	playsFor	FC_Lada-Togliatti_Togliatti
Bernie_Wright	playsFor	Everton_F.C.
Stefan_Lexa	playsFor	TSV_1860_München
Javier_Araújo	playsFor	Juan_Aurich
Mihails_Ziziļevs	playsFor	FK_Ventspils
Emil_Angelov	playsFor	PFC_Levski_Sofia
Paul_Marshall_(footballer)	playsFor	Droylsden_F.C.
Eric_McMordie	playsFor	Middlesbrough_F.C.
Stuart_Elliott_(footballer,_born_1977)	playsFor	Northwich_Victoria_F.C.
Alan_Birchenall	playsFor	Trowbridge_Town_F.C.
Juan_Carlos_Bazalar	playsFor	Ciclista_Lima_Association
Ihor_Dotsenko	wasBornIn	Kiev
Chérif_Touré_Mamam	playsFor	FC_Rapid_București
Gesiel_José_de_Lima	playsFor	Comercial_Futebol_Clube_(Ribeirão_Preto)
Robbie_Winters	playsFor	Albion_Rovers_F.C.
Marcelo_Sarmiento	playsFor	Club_Olimpo
Lee_Shearer	playsFor	FF_Jaro
Giuliano_Tadeo_Aranda	playsFor	Associação_Desportiva_São_Caetano
Éder_Aleixo_de_Assis	playsFor	Santos_FC
Giuseppe_Galderisi	playsFor	New_England_Revolution
Scott_Sinclair	playsFor	Crystal_Palace_F.C.
Carlos_Valderrama	hasWonPrize	South_American_Footballer_of_the_Year
Jacques-Désiré_Périatambée	playsFor	Grenoble_Foot_38
Joseph_Ngwenya	playsFor	Houston_Dynamo
Tuna_Üzümcü	playsFor	Altay_S.K.
José_Carlos_Garcia_Leal	playsFor	Sport_Club_Corinthians_Paulista
Rafał_Niżnik	playsFor	Motor_Lublin
Arthur_Boka	wasBornIn	Abidjan
Vadym_Yevtushenko	playsFor	AIK_Fotboll
Shwan_Jalal	playsFor	Leyton_Orient_F.C.
Josef_Schneider_(footballer)	playsFor	Le_Havre_AC
Paul_Robinson_(footballer,_born_1984)	playsFor	Blyth_Spartans_A.F.C.
Verona_Villafranca_Airport	isConnectedTo	Pristina_International_Airport
Jean_Bouli	playsFor	Tonnerre_Yaoundé
Dariusz_Zawadzki	playsFor	Pogoń_Szczecin
Maksim_Buznikin	playsFor	FC_Rostov
Ljubljana_Jože_Pučnik_Airport	isConnectedTo	Cairo_International_Airport
Jack_Brand	playsFor	Toronto_Blizzard_(1971–84)
Vincenzo_Chiarenza	playsFor	S.S._Lazio
Ljubljana_Jože_Pučnik_Airport	isConnectedTo	Pristina_International_Airport
Dubai_International_Airport	isConnectedTo	Bandar_Abbas_International_Airport
Serhiy_Husyev	playsFor	Altay_S.K.
Viorel_Frunză	playsFor	FC_Politehnica_Iași
Brussels_Airport	isConnectedTo	Vienna_International_Airport
Tommy_Johnston	playsFor	Leyton_Orient_F.C.
Ronny_Van_Geneugden	playsFor	K.F.C._Lommel_S.K.
Ken_Snow	playsFor	Miami_Freedom
Vladimir_Vukajlović	playsFor	Diagoras_F.C.
Rudolf_Brunnenmeier	playsFor	TSV_1860_München
Colin_Waldron	playsFor	Philadelphia_Fury
Mallam_Aminu_Kano_International_Airport	isConnectedTo	Cairo_International_Airport
Laxmikant–Pyarelal	wasBornIn	Mumbai
Tommy_Coyne	playsFor	Dundee_F.C.
Roland_Andersson	wasBornIn	Malmö
Mikko_Paatelainen	playsFor	FC_KooTeePee
David_Oteo	playsFor	Mexico_national_football_team
Damian_Bellón	playsFor	FC_Vaduz
Guido_Gorges	playsFor	RSV_Göttingen_05
Brussels_Airport	isConnectedTo	Nantes_Atlantique_Airport
Yulin_Yuyang_Airport	isConnectedTo	Kunming_Changshui_International_Airport
Ricardo_Fuller	playsFor	Heart_of_Midlothian_F.C.
Uğur_Demirkol	playsFor	Kayseri_Erciyesspor
Jiří_Hanke	playsFor	Czechoslovakia_national_football_team
Marques_Batista_de_Abreu	playsFor	São_Paulo_FC
Randolph_Jerome	playsFor	Al-Mabarrah
Arthur_Laffer	playsFor	AmaZulu_F.C.
Moses_Ashikodi	playsFor	Rangers_F.C.
Michael_Tonge	playsFor	Stoke_City_F.C.
Marcos_Corrêa_dos_Santos	playsFor	Sociedade_Esportiva_Palmeiras
Maxwell_Konadu	playsFor	King_Faisal_Babes_FC
Pavol_Jurčo	playsFor	SV_Horn
Samuel_Boutal	playsFor	Kilmarnock_F.C.
Alexandro_Alves_Ferreira	playsFor	Mirassol_Futebol_Clube
Vilnius_Airport	isConnectedTo	Corfu_International_Airport
Christian_Sivebæk	playsFor	Skive_IK
Steve_Davey	wasBornIn	Plymouth
Anselmo_Robbiati	playsFor	Calcio_Como
James_Walker_(footballer,_born_1987)	playsFor	Hereford_United_F.C.
Sotiris_Ninis	playsFor	Apollon_Smyrni_F.C.
Stephan_Keller	playsFor	FC_Zürich
Diego_Rodríguez_Fernández	playsFor	Real_Betis
Charles_de_Gaulle_Airport	isConnectedTo	John_Paul_II_International_Airport_Kraków–Balice
Jinan_Yaoqiang_International_Airport	isConnectedTo	Weihai_Dashuibo_Airport
Andy_Porter_(footballer)	playsFor	Northwich_Victoria_F.C.
Brian_Dutton	playsFor	Havant_&_Waterlooville_F.C.
Pascal_Borel	playsFor	SV_Werder_Bremen
Teddy_Lučić	playsFor	Leeds_United_A.F.C.
Jonathan_Akpoborie	playsFor	VfL_Wolfsburg
Tony_Battersby	wasBornIn	Doncaster
Emilio_José_Viqueira	playsFor	Deportivo_de_La_Coruña
Shep_Messing	playsFor	Boston_Minutemen
Shaun_Smith_(footballer)	playsFor	Stockport_County_F.C.
Sebastián_Flores	wasBornIn	Montevideo
Wojciech_Kowalewski	playsFor	Iraklis_Thessaloniki_F.C.
Kris_Taylor	playsFor	Hereford_United_F.C.
Ray_Hudson	playsFor	Minnesota_Strikers
Frank_Barton	playsFor	Blackpool_F.C.
Brian_Joy	playsFor	Exeter_City_F.C.
Paulo_Valentim	playsFor	São_Paulo_FC
Henrique_Pacheco_Lima	playsFor	Figueirense_Futebol_Clube
Nantong_Xingdong_Airport	isConnectedTo	Shenzhen_Bao'an_International_Airport
Roberto_Gutiérrez	playsFor	C.F._Atlante
Stephen_Gleeson	playsFor	Republic_of_Ireland_national_under-21_football_team
Marcin_Narwojsz	playsFor	Ruch_Chorzów
Rafael_Santos_Bergamasco	playsFor	FC_Rostov
Mahmoud_El_Sayed_Samir	playsFor	Al_Ittihad_Alexandria
Ivan_Kozák	playsFor	1._FC_Union_Berlin
Aidas_Preikšaitis	playsFor	FC_Torpedo_Moscow
Orestas_Buitkus	playsFor	Skonto_FC
Max_Cream	playsFor	Bashley_F.C.
Péter_Andorka	playsFor	Nyíregyháza_Spartacus_FC
Nuremberg_Airport	isConnectedTo	Corfu_International_Airport
Yohai_Aharoni	playsFor	Maccabi_Ironi_Bat_Yam_F.C.
Joaquim_Ferraz	playsFor	C.F._Os_Belenenses
Michael_Bradley_(soccer)	playsFor	New_York_Red_Bulls
Onyekachi_Nwoha	wasBornIn	Aba,_Abia
Orestas_Buitkus	playsFor	FC_Baltika_Kaliningrad
Ronny_Johnsen	playsFor	Manchester_United_F.C.
Frank_Worthington	playsFor	Hinckley_United_F.C.
John_McGrath_(footballer,_born_1980)	playsFor	Aston_Villa_F.C.
Gilberto_Carlos_Nascimento	playsFor	Esporte_Clube_Santo_André
Ayden_Duffy	playsFor	Buxton_F.C.
Krzysztof_Pilarz	playsFor	Ruch_Chorzów
Miha_Kline	playsFor	NK_Ljubljana
Mickaël_Dogbé	playsFor	Baniyas_SC
Emir_Obuća	playsFor	NK_Čelik_Zenica
Nicolás_Peric	playsFor	Cobreloa
Tajikistan	dealsWith	Kyrgyzstan
Shahjalal_International_Airport	isConnectedTo	Jinnah_International_Airport
London_Heathrow_Terminal_5	isConnectedTo	O'Hare_International_Airport
Rodney_Rowe	playsFor	Farsley_Celtic_A.F.C.
Ostend-Bruges_International_Airport	isConnectedTo	Palma_de_Mallorca_Airport
Ruud_Kaiser	playsFor	Royal_Antwerp_F.C.
Brisbane_Airport	isConnectedTo	Los_Angeles_International_Airport
Wilman_Conde	playsFor	Sociedad_Deportiva_Aucas
Enes_Mešanović	playsFor	NK_Osijek
Haris_Tahirović	playsFor	BFC_Siófok
Almaty_International_Airport	isConnectedTo	Tbilisi_International_Airport
Mancini_(Brazilian_footballer)	playsFor	América_Futebol_Clube_(MG)
Massimo_Crippa	playsFor	A.C._Pavia
Wilson_Oruma	playsFor	Samsunspor
Vladimir_Vasilj	playsFor	NK_Široki_Brijeg
Daniel_Scheinhardt	playsFor	FC_St._Pauli
General_Roberto_Fierro_Villalobos_International_Airport	isConnectedTo	General_Ignacio_Pesqueira_García_International_Airport
Jermaine_Beckford	playsFor	Scunthorpe_United_F.C.
Gerard_van_der_Lem	playsFor	Feyenoord
Vedran_Ivanković	playsFor	NK_Hrvatski_Dragovoljac
Terry_Harkin	playsFor	Dundalk_F.C.
Michael_Kümmerle	playsFor	Stuttgarter_Kickers
Carlos_Erwin_Arias	playsFor	The_Strongest
Gábor_Korolovszky	playsFor	Nyíregyháza_Spartacus_FC
Paul_Marshall_(footballer)	playsFor	Stockport_County_F.C.
Mike_Ambersley	wasBornIn	St._Louis
Alexander_Ring	playsFor	Klubi-04
Aleksandar_Luković	playsFor	Udinese_Calcio
Aleksandar_Komadina	wasBornIn	Niš
Vince_Hilaire	playsFor	San_Jose_Earthquakes_(1974–88)
Karl-Heinz_Spikofski	playsFor	Calcio_Catania
Georgi_Kondratiev	playsFor	FC_Lokomotiv_Moscow
Davor_Vugrinec	playsFor	U.S._Lecce
Hans_Kraay,_Jr.	playsFor	Edmonton_Drillers_(1979–82)
Gareth_Ainsworth	playsFor	Blackburn_Rovers_F.C.
Islom_Inomov	playsFor	Lokomotiv_Tashkent_FK
Cédric_Berthelin	playsFor	Luton_Town_F.C.
Giuseppe_Vives	playsFor	U.S._Lecce
Ermin_Melunović	playsFor	SV_Darmstadt_98
Madeira_Airport	isConnectedTo	East_Midlands_Airport
Damir_Šutevski	playsFor	Rochester_Lancers
Davie_Dodds	playsFor	Rangers_F.C.
Leon_Jeanne	playsFor	Bath_City_F.C.
Ian_McKellen	hasWonPrize	Laurence_Olivier_Award
Krisztián_Csillag	playsFor	III._Kerületi_TUE
Dubai_International_Terminal_3	isConnectedTo	Ministro_Pistarini_International_Airport
Jordi_Alba	playsFor	Gimnàstic_de_Tarragona
Marc_Degryse	playsFor	Beerschot_AC
Jake_Thomson	wasBornIn	Portsmouth
Los_Angeles_International_Airport	isConnectedTo	Charles_de_Gaulle_Airport
Newcastle_Airport	isConnectedTo	Tenerife_South_Airport
Foz_do_Iguaçu_International_Airport	isConnectedTo	Deputado_Luís_Eduardo_Magalhães_International_Airport
Ilija_Spasojević	playsFor	FC_Dinamo_Tbilisi
Jordan_Spence	playsFor	Leyton_Orient_F.C.
Gediminas_Paulauskas	playsFor	FC_Dinamo_Brest
George_Blay	playsFor	Royal_Antwerp_F.C.
Javier_Cámpora	playsFor	Club_Deportes_Concepción
Kwon_Jung-hyuk	playsFor	South_Korea_national_football_team
Heydar_Aliyev_International_Airport	isConnectedTo	Minsk_National_Airport
Jorge_Chávez_International_Airport	isConnectedTo	Ministro_Pistarini_International_Airport
Gaúcho_(footballer)	playsFor	Esporte_Clube_Santo_André
Charlie_Ide	playsFor	Hayes_&_Yeading_United_F.C.
Peter_Sand	playsFor	Stabæk_Fotball
Paulo_Antônio_de_Oliveira	playsFor	Ventforet_Kofu
John_Fashanu	playsFor	Aston_Villa_F.C.
Heraklion_International_Airport	isConnectedTo	Lyon–Saint_Exupéry_Airport
Pablo_Couñago	playsFor	Kitchee_SC
Lee_Jong-min_(footballer_born_1983)	playsFor	Suwon_Samsung_Bluewings
Anthony_Elding	playsFor	Ferencvárosi_TC
Derek_O'Brien_(footballer_born_1979)	playsFor	St_Patrick's_Athletic_F.C.
Claude_Stephane_Seanla	playsFor	Barnet_F.C.
Bashiru_Gambo	playsFor	Stuttgarter_Kickers
Daniele_Amerini	playsFor	ACF_Fiorentina
Bob_Hoskins	hasWonPrize	European_Film_Award_for_Best_Actor
Paulino_Martínez_Soria	playsFor	CF_Villanovense
Oscar_Crino	playsFor	Australia_national_under-20_association_football_team
Austro-Prussian_War	happenedIn	Austrian_Empire
Patrik_Siegl	playsFor	SSV_Jahn_Regensburg
Tolga_Seyhan	playsFor	Gaziantepspor
Dragan_Simeunović	playsFor	FK_Vardar
Guillermo_Molins	playsFor	Real_Betis
Matías_Alonso	playsFor	Celta_de_Vigo_B
Jairo_Luis_Blumer	playsFor	Guaratinguetá_Futebol
Billy_Mehmet	playsFor	Bangkok_Glass_F.C.
Esmail_Halali	playsFor	Paykan_F.C.
Stephen_Rice_(footballer)	playsFor	Republic_of_Ireland_national_under-17_football_team
Memphis_International_Airport	isConnectedTo	Raleigh–Durham_International_Airport
Li_Weifeng	playsFor	Suwon_Samsung_Bluewings
Pierre_Aubameyang	playsFor	Le_Havre_AC
Szeto_Man_Chun	playsFor	Eastern_AA
Ernie_Cooksey	playsFor	Bishop's_Stortford_F.C.
Newcastle_Airport	isConnectedTo	John_Paul_II_International_Airport_Kraków–Balice
Nerijus_Barasa	playsFor	FBK_Kaunas
Gary_Charles	playsFor	Derby_County_F.C.
Kevin_Keelan	playsFor	Wrexham_F.C.
Palma_de_Mallorca_Airport	isConnectedTo	Geneva_International_Airport
Darius_Maciulevičius	playsFor	Atlantis_FC
Dajan_Šimac	playsFor	1._FC_Kaiserslautern
Travis_Dodd	playsFor	Australia_national_under-20_association_football_team
Yervand_Sukiasyan	playsFor	BV_Cloppenburg
Eggert_Jónsson	playsFor	C.F._Os_Belenenses
Roberto_Biffi	playsFor	Savona_F.B.C.
Fabrício_Lopes_Alcântara	playsFor	Sampaio_Corrêa_Futebol_Clube
Gareth_Williams_(English_footballer)	playsFor	Gainsborough_Trinity_F.C.
Tolmachevo_Airport	isConnectedTo	Kazan_International_Airport
Iván_Pérez_Muñoz	playsFor	Girona_FC
Kostas_Giannoulis	playsFor	Iraklis_Thessaloniki_F.C.
Clemens_Fritz	playsFor	Germany_national_football_team
John_Hills_(footballer)	playsFor	Blackpool_F.C.
Valencia_Airport	isConnectedTo	Madeira_Airport
Dejan_Ognjanović	playsFor	FK_Budućnost_Podgorica
Željko_Milinovič	playsFor	Grazer_AK
Vince_Hilaire	playsFor	England_national_under-21_football_team
Moldova	dealsWith	Turkey
Elnatan_Salami	playsFor	Israel_national_under-17_football_team
Fernando_Fernández_Escribano	playsFor	Real_Madrid_C.F.
Spencer_Weir-Daley	playsFor	Nottingham_Forest_F.C.
Mustafa_Yücedağ	playsFor	Gaziantepspor
Salih_Altın	playsFor	Germany_national_youth_football_team
Guangzhou_Baiyun_International_Airport	isConnectedTo	Jinggangshan_Airport
Paulo_Futre	playsFor	Yokohama_Flügels
José_Luis_Díaz	playsFor	Provincial_Osorno
Mohamed_Kallon	playsFor	AEK_Athens_F.C.
Tommy_Miller	playsFor	Hartlepool_United_F.C.
Martín_Vilallonga	playsFor	Avispa_Fukuoka
Rémi_Adiko	wasBornIn	Abidjan
Gordon_Hill_(footballer)	playsFor	FC_Twente
Hugo_Sánchez	playsFor	Real_Madrid_C.F.
Linate_Airport	isConnectedTo	Charles_de_Gaulle_Airport
Rayco_García_Dauta	playsFor	Rayo_Vallecano
Adam_Ledwoń	playsFor	SK_Sturm_Graz
Peter_Cormack_(footballer_born_1974)	playsFor	Raith_Rovers_F.C.
Siniša_Linić	playsFor	Bnei_Yehuda_Tel_Aviv_F.C.
Mohammed_Aliyu_Datti	playsFor	Nigeria_national_football_team
Eric_Hassli	playsFor	San_Antonio_Scorpions
Iulian_Arhire	playsFor	FC_Metalurh_Donetsk
Jason_Beckford	playsFor	Blackburn_Rovers_F.C.
Márcio_Amoroso	playsFor	São_Paulo_FC
Gary_Speed	playsFor	Everton_F.C.
Alexander_Ring	playsFor	R.S.C._Anderlecht
Milovan_Mirošević	playsFor	Club_Deportivo_Universidad_Católica
Eddy_Baggio	playsFor	Calcio_Catania
Mark_Warren_(footballer)	playsFor	King's_Lynn_F.C.
Andrea_Sottil	playsFor	Udinese_Calcio
Alberto_Rafael_da_Silva	playsFor	Clube_Atlético_Bragantino
Jon_Gittens	playsFor	Exeter_City_F.C.
Fred_Grgurev	playsFor	New_Jersey_Rockets_(MISL)
Shane_Paul	playsFor	Scunthorpe_United_F.C.
Roberto_Bonano	playsFor	Rosario_Central
Shijiazhuang_Zhengding_International_Airport	isConnectedTo	Nanchang_Changbei_International_Airport
Bartholomew_Ogbeche	playsFor	SC_Cambuur
Yervand_Krbachyan	playsFor	FC_Torpedo-ZIL_Moscow
Almaty_International_Airport	isConnectedTo	Shymkent_International_Airport
Honore_Kabongo	playsFor	Samut_Songkhram_F.C.
Marko_Lomić	playsFor	FK_Partizan
Scott_Tynan	playsFor	Barnet_F.C.
Paul_McGee_(footballer_born_1954)	playsFor	HFC_Haarlem
Léon_Hese	wasBornIn	Arnhem
Darío_Figueroa	playsFor	Zamora_FC
Carles_Coto	playsFor	FC_Barcelona
Yury_Tsyhalka	playsFor	Belarus_national_football_team
Alejandro_Sabella	playsFor	Leeds_United_A.F.C.
Luboš_Kubík	playsFor	FC_Hradec_Králové
Walter_Guglielmone	playsFor	Montevideo_Wanderers_F.C.
Paulo_Pina	playsFor	A.D._Lousada
Kim_Shin-young	playsFor	Busan_IPark
Marcelino_García_Toral	playsFor	Racing_de_Santander
Republic_of_the_Congo	dealsWith	China
Darren_Wassall	playsFor	Nottingham_Forest_F.C.
Anwar_Uddin	playsFor	Sutton_United_F.C.
Los_Angeles_International_Airport	isConnectedTo	Zurich_Airport
Brian_Carey	playsFor	Chicago_Sting
Marcel_Schied	playsFor	SpVgg_Unterhaching
Michael_Hansen	playsFor	Silkeborg_IF
Mikhail_Kalashnikov	hasWonPrize	Order_of_St._Andrew
José_Augusto_Freitas_Sousa	playsFor	Al_Hazm_(football_club)
Leonel_Álvarez	playsFor	Deportes_Quindío
Richard_Witschge	playsFor	Blackburn_Rovers_F.C.
Aaron_O'Connor	playsFor	Nuneaton_Town_F.C.
Ilgar_Gurbanov	playsFor	Boluspor
Timo_Hildebrand	playsFor	FC_Schalke_04_II
Michael_Howard_(footballer)	playsFor	Afan_Lido_F.C.
Éric_Sitruk	playsFor	Paris_FC
Giuseppe_Chiappella	playsFor	A.C._Pisa_1909
Cristian_Dănălache	playsFor	CS_Otopeni
Linate_Airport	isConnectedTo	Bari
Stefan_Szefer	playsFor	Chicago_Sting
João_Pedro_Santos_Gonçalves	playsFor	C.D._Fátima
Robert_Péri	playsFor	Sporting_Toulon_Var
Ronnie_Wallwork	playsFor	Royal_Antwerp_F.C.
Jorge_Bermúdez	playsFor	Independiente_Santa_Fe
Warren_Patmore	playsFor	Dundalk_F.C.
Cicinho	playsFor	Real_Madrid_C.F.
José_Burtovoy	playsFor	Provincial_Osorno
Kenny_Lowe	playsFor	Stoke_City_F.C.
Andrei_Karpovich	playsFor	FC_Spartak_Semey
Heraklion_International_Airport	isConnectedTo	Zurich_Airport
Bandar_Abbas_International_Airport	isConnectedTo	Tabriz_International_Airport
Mauro_Boselli	playsFor	Estudiantes_de_La_Plata
Mark_Bunn_(English_footballer)	playsFor	Norwich_City_F.C.
Habib_Mohamed	playsFor	Molde_FK
Ihor_Chuchman	playsFor	Kazakhstan_national_football_team
William_Torres	playsFor	C.D._Águila
Miguel_Ángel_Sebastián_Romero	playsFor	Club_de_Gimnasia_y_Esgrima_La_Plata
Michael_Gilkes_(footballer)	playsFor	Reading_F.C.
Montréal–Mirabel_International_Airport	isConnectedTo	Québec_City_Jean_Lesage_International_Airport
Marijo_Marić	wasBornIn	Heilbronn
Mikkel_Bischoff	playsFor	Lyngby_Boldklub
Richard_Duffy	playsFor	Portsmouth_F.C.
Casiano_Delvalle	playsFor	Guangzhou_Pharmaceuticals
George_Travers	playsFor	Manchester_United_F.C.
Shenyang_Taoxian_International_Airport	isConnectedTo	Jinan_Yaoqiang_International_Airport
Paul_Dickov	playsFor	Derby_County_F.C.
Mark_McChrystal	playsFor	Bradford_City_A.F.C.
Josip_Broz_Tito	hasWonPrize	Order_of_Leopold_(Belgium)
Aparecido_Lima	playsFor	Clube_Atlético_Paranaense
Younis_Mahmoud	playsFor	Al-Wakrah_Sport_Club
Diego_Rivas	playsFor	Real_Sociedad
Stuart_Hicks	playsFor	Leyton_Orient_F.C.
Martin_Horsell	playsFor	Yate_Town_F.C.
Besart_Ibraimi	playsFor	FK_Renova
Carlos_Asprilla	playsFor	C.D._Atlético_Balboa
Pablo_González_Reyes	playsFor	Ñublense
Djimi_Traoré	playsFor	Portsmouth_F.C.
Francis_Laurent	wasBornIn	Paris
Jamar_Beasley	playsFor	Boston_Bulldogs_(soccer)
Eduardo_Godinho_Felipe	playsFor	Tampere_United
Shanghai_Pudong_International_Airport	isConnectedTo	Chūbu_Centrair_International_Airport
Antoni_Piechniczek	playsFor	Ruch_Chorzów
Henning_Munk_Jensen	playsFor	Edmonton_Drillers_(1979–82)
Papiss_Cissé	playsFor	LB_Châteauroux
Jimmy_Gallagher	playsFor	New_York_Nationals_(ASL)
Fabiano_Gadelha	playsFor	Clube_Atlético_Juventus
Jefferson_Andrade_Siqueira	playsFor	ACF_Fiorentina
Aleksandar_Živković_(footballer_born_1912)	playsFor	Yugoslavia_national_football_team
Ricardo_Páez	playsFor	Estudiantes_de_Mérida
Diego_Cabrera	playsFor	Itagüí_F.C.
Gustavo_Nery	playsFor	Sport_Club_Corinthians_Paulista
Francesco_Tavano	playsFor	Empoli_F.C.
Indianapolis_International_Airport	isConnectedTo	Tampa_International_Airport
Stockholm_Skavsta_Airport	isConnectedTo	Bremen_Airport
Diego_Cabrera	playsFor	Cúcuta_Deportivo
Vladimir_But	playsFor	FC_Chernomorets_Novorossiysk
Joseph_Ngwenya	playsFor	Columbus_Crew
Álvaro_Santos	playsFor	América_Futebol_Clube_(MG)
Sergio_Santín	playsFor	Santos_FC
Zlatko_Runje	playsFor	NK_Solin
Łukasz_Tumicz	playsFor	Zagłębie_Sosnowiec
Julio_Aguilar	playsFor	Club_Sol_de_América
Comoros	dealsWith	Turkey
Mike_Conroy_(footballer_born_1965)	playsFor	Carlton_S.C.
Sylvain_N'Diaye	playsFor	FC_Girondins_de_Bordeaux
Stéphane_Auvray	playsFor	Guadeloupe_national_football_team
Fred_Grgurev	wasBornIn	Zadar
Felix_Bastians	playsFor	SC_Freiburg
Hangzhou_Xiaoshan_International_Airport	isConnectedTo	Incheon_International_Airport
Luís_Mário_Miranda_da_Silva	playsFor	Clube_Atlético_Bragantino
Robert_L._Eichelberger	hasWonPrize	Air_Medal
Guangzhou_Baiyun_International_Airport	isConnectedTo	Zhanjiang_Airport
Lyon–Saint_Exupéry_Airport	isConnectedTo	Birmingham_Airport
Oleksiy_Antyukhin	wasBornIn	Zaporizhia
Jacob_Spoonley	playsFor	New_Zealand_national_under-20_football_team
Eugène_Dadi	playsFor	Nottingham_Forest_F.C.
Anthony_Vanden_Borre	playsFor	Belgium_national_under-21_football_team
Russian_Civil_War	happenedIn	Finland
Bruno_Meneghel	playsFor	Goiás_Esporte_Clube
Stéphane_Paille	playsFor	Montpellier_HSC
Marcelo_Lipatín	playsFor	C.D._Trofense
Alexandre_Luiz_Fernandes	playsFor	Guaratinguetá_Futebol
Brayan_Angulo	playsFor	CD_Atlético_Baleares
Andy_Jones_(footballer)	playsFor	Leyton_Orient_F.C.
Nantes_Atlantique_Airport	isConnectedTo	Ajaccio_Napoleon_Bonaparte_Airport
John_Salako	wasBornIn	Ibadan
Steven_Masterton	playsFor	Hayes_&_Yeading_United_F.C.
Jason_Blunt	playsFor	Goole_A.F.C.
Giancarlo_Camolese	playsFor	S.S._Lazio
Filippo_Cristante	playsFor	Ravenna_F.C.
Francesco_Bolzoni	playsFor	Italy_national_under-20_football_team
Frédéric_Tatarian	playsFor	FC_Mulhouse
Márcio_Martins	playsFor	Goytacaz_Futebol_Clube
Ian_Gore	playsFor	Blackpool_F.C.
Danny_Bacon	playsFor	Hednesford_Town_F.C.
Craig_O'Reilly	playsFor	East_Fife_F.C.
Andrea_Masiello	playsFor	Italy_national_under-18_football_team
Ernesto_Mascheroni	wasBornIn	Montevideo
Leandro_Fernández_(footballer)	playsFor	FC_Dynamo_Moscow
Tomer_Hemed	playsFor	Israel_national_under-17_football_team
Björn_Ziegenbein	playsFor	SV_Wehen_Wiesbaden
Róbert_Zeher	wasBornIn	Košice
Con_Martin	playsFor	Leeds_United_A.F.C.
Alan_Waddle	playsFor	Happy_Valley_AA
Ahmed_Ouattara_(footballer)	playsFor	Africa_Sports_d'Abidjan
Edward_Critchley	playsFor	Preston_North_End_F.C.
Pune_Airport	isConnectedTo	Rajiv_Gandhi_International_Airport
Steve_Davey	playsFor	Hereford_United_F.C.
Adam_Czerkas	playsFor	Świt_Nowy_Dwór_Mazowiecki
Matt_Carbon	playsFor	Derby_County_F.C.
Ali_El-Omari	playsFor	C.S._Marítimo
Marcus_Haber	playsFor	FC_Groningen
Renato_Pilipović	playsFor	HNK_Rijeka
Tony_Hemmings	playsFor	Northwich_Victoria_F.C.
Palma_de_Mallorca_Airport	isConnectedTo	Maastricht_Aachen_Airport
Tampa_International_Airport	isConnectedTo	Atlantic_City_International_Airport
Venice_Marco_Polo_Airport	isConnectedTo	Heraklion_International_Airport
Alan_Waddle	playsFor	Swansea_City_A.F.C.
Irakli_Modebadze	playsFor	FC_Merani_Tbilisi
Haris_Safwan_Kamal	playsFor	Felda_United_F.C.
Emmanuel_Ekpo	playsFor	Nigeria_national_football_team
Rory_Prendergast	playsFor	Farsley_Celtic_A.F.C.
Ismael_Urzaiz	playsFor	Real_Madrid_C.F.
Christian_Ribeiro	playsFor	Stockport_County_F.C.
Scott_Barrett_(footballer)	playsFor	Kingstonian_F.C.
Andrés_Martínez_(footballer)	playsFor	U.S._Lecce
Kandia_Traoré	playsFor	Étoile_du_Sahel
David_Meza_(footballer)	playsFor	A.C._Pavia
Gerardo_Espinoza	playsFor	C.F._Atlante
Devi_Ahilyabai_Holkar_Airport	isConnectedTo	Sardar_Vallabhbhai_Patel_International_Airport
Gerald_Klews	playsFor	SV_Babelsberg_03
Scott_Bannerman	playsFor	Raith_Rovers_F.C.
Michael_Connelly	hasWonPrize	Shamus_Award
Moisés_Moura_Pinheiro	playsFor	FC_Spartak_Moscow
Carlos_Cuéllar	wasBornIn	Madrid
Jean-François_Larios	playsFor	AS_Saint-Étienne
Kevin_Franck	playsFor	K.S.V._Oudenaarde
Mark_Burchill	playsFor	Portsmouth_F.C.
Łukasz_Madej	playsFor	Lech_Poznań
Rick_Kruys	wasBornIn	Utrecht
John_O'Kane	playsFor	Bury_F.C.
Liverpool_John_Lennon_Airport	isConnectedTo	John_Paul_II_International_Airport_Kraków–Balice
Robert_Nikolic	playsFor	Bayer_04_Leverkusen
Krystian_Prymula	playsFor	Zagłębie_Sosnowiec
Ernest_Rutherford	hasWonPrize	Elliott_Cresson_Medal
Frederick_Law_Olmsted	playsFor	Al-Gharafa_Sports_Club
Rainer_Torres	playsFor	Sport_Boys
Fernando_Alves_Santa_Clara	playsFor	Fortaleza_Esporte_Clube
Montréal–Pierre_Elliott_Trudeau_International_Airport	isConnectedTo	McCarran_International_Airport
Flávio_Augusto_do_Nascimento	wasBornIn	Recife
Norberto_Araujo	playsFor	Racing_de_Córdoba
Tolmachevo_Airport	isConnectedTo	Dalaman_Airport
Mourad_Bounoua	playsFor	Stuttgarter_Kickers
Lee_Hendrie	playsFor	Bradford_City_A.F.C.
Mourtala_Diakité	playsFor	C.S._Marítimo
Pini_Balili	playsFor	Bnei_Yehuda_Tel_Aviv_F.C.
Wolfgang_Sühnholz	playsFor	Toronto_Blizzard_(1971–84)
Dubai_International_Terminal_3	isConnectedTo	Geneva_International_Airport
Aleh_Konanaw	playsFor	FC_Iskra_Smolensk
Emmanuel_Osei	playsFor	FC_Politehnica_Timișoara
Reinaldo_de_Souza	playsFor	Avaí_Futebol_Clube
Paulo_Madeira	playsFor	C.S._Marítimo
Andy_van_der_Meyde	playsFor	PSV_Eindhoven
Aleksandr_Dmitrijev	playsFor	FC_Levadia_II_Tallinn
Danny_Milosevic	playsFor	Inglewood_United_SC
Sheremetyevo_International_Airport	isConnectedTo	Catania–Fontanarossa_Airport
Sergio_Floccari	playsFor	S.S._Lazio
Ryszard_Staniek	playsFor	CA_Osasuna
Vlad_Munteanu	playsFor	FSV_Frankfurt
Gavin_Ward_(footballer)	playsFor	Stoke_City_F.C.
Nicolas_de_Géa	playsFor	AS_Beauvais_Oise
John_Gayle_(footballer)	playsFor	Shrewsbury_Town_F.C.
Zaur_Khapov	playsFor	FC_Dinamo_Tbilisi
Gunter_Thiebaut	playsFor	MVV_Maastricht
Florence_Airport,_Peretola	isConnectedTo	Birmingham_Airport
Atanas_Fidanin	playsFor	PFC_Pirin_Gotse_Delchev
Davit_Bolkvadze	playsFor	FC_Merani_Tbilisi
Peter_Larsson_(footballer_born_1961)	playsFor	AIK_Fotboll
Ricardo_Páez	playsFor	CD_Castellón
Jon_Stevenson	playsFor	Swindon_Town_F.C.
Great_Turkish_War	happenedIn	Republic_of_Venice
Eddie_Nolan	playsFor	Hartlepool_United_F.C.
Nikos_Skarmoutsos	playsFor	Apollon_Smyrni_F.C.
Carl_XVI_Gustaf_of_Sweden	hasWonPrize	Order_of_Merit_of_the_Federal_Republic_of_Germany
Alberto_Fontana_(footballer_born_1967)	playsFor	A.C._Chievo_Verona
Maikon_Leite	playsFor	Sociedade_Esportiva_Palmeiras
Dante_Washington	playsFor	Washington_Warthogs
Cem_Karaca_(footballer)	playsFor	FC_St._Pauli
Teemu_Pukki	playsFor	FC_KooTeePee
Gabriel_Calderón	playsFor	Real_Betis
Craig_Ireland	playsFor	Airdrieonians_F.C._(1878)
James_Coppinger	playsFor	Nottingham_Forest_F.C.
Mike_Metcalf	wasBornIn	Liverpool
Miguel_Ángel_Loayza	playsFor	Peru_national_football_team
Thomas_Meggle	playsFor	FC_St._Pauli
Jon_Moya	playsFor	SD_Eibar
Dennis_Schmidt_(footballer)	playsFor	Bayer_04_Leverkusen_II
Shijiazhuang_Zhengding_International_Airport	isConnectedTo	Zhuhai_Jinwan_Airport
Jaime_Bragança	playsFor	FC_Ingolstadt_04
Jon_Bass	playsFor	Hartlepool_United_F.C.
Bert_Crossthwaite	playsFor	Stoke_City_F.C.
Terry_Phelan	playsFor	Swansea_City_A.F.C.
Phil_O'Connor	playsFor	Luton_Town_F.C.
Krisztián_Szollár	playsFor	SV_Darmstadt_98
Serdar_Topraktepe	playsFor	Kocaelispor
Nwankwo_Kanu	hasWonPrize	African_Footballer_of_the_Year
Michaël_Murcy	playsFor	US_Créteil-Lusitanos
Dario_Bodrušić	playsFor	HNK_Rijeka
Martyn_Booty	playsFor	Chesterfield_F.C.
Otmane_El_Assas	playsFor	Al-Gharafa_Sports_Club
Bradley_Orr	wasBornIn	Liverpool
Mërgim_Mavraj	playsFor	1._FC_Köln
Agustín_De_La_Canal	playsFor	Club_Atlético_Nueva_Chicago
Jaime_Sánchez_Fernández	playsFor	Real_Madrid_C.F.
Jason_Blunt	playsFor	Blackpool_F.C.
Hassan_Abdel-Fattah	playsFor	Al-Wehdat_SC
Mesut_Bakkal	playsFor	İzmirspor
Rob_Friend	playsFor	Molde_FK
Kevin_Hatchi	playsFor	AJ_Auxerre
Mary_Sattler	playsFor	Torquay_United_F.C.
Javi_García	playsFor	Real_Madrid_C.F.
Jürgen_Klinsmann	hasWonPrize	Order_of_Merit_of_the_Federal_Republic_of_Germany
Arnór_Guðjohnsen	playsFor	FC_Girondins_de_Bordeaux
José_María_Antón	playsFor	Real_Betis_B
Jairo_Álvarez_Gutiérrez	playsFor	Real_Oviedo_Vetusta
Viktor_Zvyahintsev	playsFor	FC_Metalurh_Zaporizhya
Memphis_International_Airport	isConnectedTo	Los_Angeles_International_Airport
Fernando_Clavijo	playsFor	New_York_Apollo
Charles_Fernando_Basílio_da_Silva	wasBornIn	Rio_de_Janeiro
Jorge_Drovandi	playsFor	C.S._Herediano
Robert_Reilly_(footballer)	playsFor	Albion_Rovers_F.C.
Narimanovo_Airport	isConnectedTo	Kazan_International_Airport
Sascha_Studer	playsFor	FC_Aarau
Neil_Whitworth	playsFor	Preston_North_End_F.C.
Guillermo_Franco	playsFor	Mexico_national_football_team
Dean_Gorré	playsFor	FC_Groningen
Andrea_Sottil	playsFor	Italy_national_under-21_football_team
Hasan_Gültang	playsFor	Kayseri_Erciyesspor
Jacob_Timpano	playsFor	Australia_national_under-20_association_football_team
Aleksandar_Mijatović	playsFor	FK_Sloga_Kraljevo
Anthony_Elding	playsFor	Gainsborough_Trinity_F.C.
Charlie_Adam	playsFor	Blackpool_F.C.
Kléber_de_Souza_Freitas	playsFor	São_Paulo_FC
Alejandro_Alonso_(footballer)	playsFor	FC_Girondins_de_Bordeaux
Kuala_Lumpur_International_Airport	isConnectedTo	Kota_Kinabalu_International_Airport
Benjamin_Totori	playsFor	Richmond_Athletic_F.C.
George_H._W._Bush	hasWonPrize	Order_of_Merit_of_the_Federal_Republic_of_Germany
Francesco_Bolzoni	playsFor	Frosinone_Calcio
Rob_Matthaei	wasBornIn	Amsterdam
Paulino_Lopes_Tavares	playsFor	Gabala_FK
Pat_McGibbon	playsFor	Scunthorpe_United_F.C.
Jerry_Sularz	playsFor	Górnik_Wałbrzych
Rahman_Rezaei	playsFor	Al_Ahli_SC_(Doha)
Víctor_López	playsFor	CF_Extremadura
Roy_Contout	playsFor	AS_Beauvais_Oise
Devi_Ahilyabai_Holkar_Airport	isConnectedTo	Srinagar_Airport
Hennadiy_Altman	playsFor	PFC_Oleksandriya
Haruna_Babangida	playsFor	FC_Metalurh_Donetsk
Gerry_Peyton	playsFor	Everton_F.C.
António_Mendonça	playsFor	Varzim_S.C.
Orly_Airport	isConnectedTo	Venice_Marco_Polo_Airport
Adolfino_Cañete	playsFor	Club_Sol_de_América
Cristiano_da_Silva_Santos	playsFor	Betim_Esporte_Clube
Gabriel_Heinze	playsFor	Real_Madrid_C.F.
Karapet_Mikaelyan	playsFor	Armenia_national_football_team
Billund_Airport	isConnectedTo	Düsseldorf_Airport
Woo_Sung-yong	playsFor	Ajou_University
Stuart_Lee	playsFor	Carolina_Lightnin'
Billy_McEwan_(footballer,_born_1951)	playsFor	Chesterfield_F.C.
Jaroslav_Hílek	playsFor	FK_Senica
Adnan_Menderes_Airport	isConnectedTo	Gatwick_Airport
Miloš_Nikolić	playsFor	FK_Partizan
Avimiled_Rivas	playsFor	Deportes_Quindío
Eduardo_Uribe	playsFor	Unión_Huaral
Jonas_De_Roeck	playsFor	Belgium_national_under-21_football_team
Derek_Brazil	playsFor	Republic_of_Ireland_national_under-23_football_team
Ancona_Falconara_Airport	isConnectedTo	Düsseldorf_Airport
Joaquim_Ferraz	playsFor	C.S._Marítimo
Alan_Foggon	playsFor	Middlesbrough_F.C.
Bahrain_International_Airport	isConnectedTo	Cairo_International_Airport
Joey_Kirk	playsFor	Sacramento_Knights
Sammy_Lee_(footballer)	playsFor	CA_Osasuna
Dayro_Moreno	playsFor	Club_Tijuana
Phil_Hughes_(footballer_born_1964)	playsFor	Leeds_United_A.F.C.
Eric_Wynalda	playsFor	Club_León
Shijiazhuang_Zhengding_International_Airport	isConnectedTo	Shanghai_Pudong_International_Airport
Francesco_Della_Rocca	playsFor	Italy_national_under-19_football_team
Zhengzhou_Xinzheng_International_Airport	isConnectedTo	Zhuhai_Jinwan_Airport
Hrishikesh_Mukherjee	hasWonPrize	Padma_Vibhushan
Salvatore_Gambino	playsFor	1._FC_Köln
Josef_Miso	playsFor	Sandefjord_Fotball
Sergio_Canales	playsFor	Racing_de_Santander
Maarten_Martens	playsFor	AZ_Alkmaar
Nicola_Corrent	playsFor	A.C._Monza_Brianza_1912
Balázs_Borbély	playsFor	AEL_Limassol
Teco_(footballer)	playsFor	Mirassol_Futebol_Clube
Andrius_Jokšas	playsFor	FC_Baltika_Kaliningrad
Stephan_Keller	wasBornIn	Zürich
Robert_Warzycha	playsFor	Columbus_Crew
Guilherme_Afonso	playsFor	FC_Lugano
Billy_Woods_(Irish_footballer)	playsFor	Republic_of_Ireland_national_under-21_football_team
Michael_Gray_(footballer)	playsFor	Manchester_United_F.C.
Lumír_Sedláček	playsFor	Polonia_Warsaw
Denny_Mundee	playsFor	Dorchester_Town_F.C.
Froylán_Ledezma	playsFor	FC_Admira_Wacker_Mödling
Grant_Holt	playsFor	Aston_Villa_F.C.
Mickaël_Dogbé	wasBornIn	Paris
Ralf_Edström	playsFor	PSV_Eindhoven
Becky_Sauerbrunn	playsFor	FC_Kansas_City
Latvia	dealsWith	Germany
Otto_Pfister	playsFor	FC_Chiasso
Takayuki_Morimoto	playsFor	Japan_national_under-20_football_team
Brent_Fisher	playsFor	Canterbury_United_FC
Brussels_Airport	isConnectedTo	Zagreb_Airport
Sandro_Calabro	playsFor	FC_St._Gallen
Edgars_Gauračs	playsFor	FC_Yenisey_Krasnoyarsk
Edino_Nazareth_Filho	playsFor	Udinese_Calcio
Jeremiah_Denton	hasWonPrize	Purple_Heart
Kaya_Tarakçı	playsFor	Kocaelispor
Gerald_R._Ford_International_Airport	isConnectedTo	Lambert–St._Louis_International_Airport
Goran_Šubara	playsFor	Warriors_F.C.
Paulino_Martínez_Soria	playsFor	Albacete_Balompié
Oleh_Shelayev	wasBornIn	Luhansk
Ralf_Keidel	playsFor	1._FC_Schweinfurt_05
Marco_Weißhaupt	playsFor	FC_Rot-Weiß_Erfurt
Göteborg_City_Airport	isConnectedTo	Palma_de_Mallorca_Airport
Rocco_Placentino	playsFor	Montreal_Impact
Márcio_Amoroso	playsFor	Borussia_Dortmund
Eric_Obinna_Chukwunyelu	playsFor	FC_Rouen
Craig_Nelthorpe	playsFor	Gainsborough_Trinity_F.C.
Incheon_International_Airport	isConnectedTo	Ürümqi_Diwopu_International_Airport
Hurghada_International_Airport	isConnectedTo	Gatwick_Airport
Pelé_(footballer,_born_1987)	wasBornIn	Porto
Paulo_Jorge_Pedro_Lopes	playsFor	C.D._Trofense
Moses_Ashikodi	playsFor	Hereford_United_F.C.
Arron_Davies	playsFor	Exeter_City_F.C.
Samir_Kozarac	playsFor	FC_Baden
East_Midlands_Airport	isConnectedTo	Valencia_Airport
Ralph_Allen_(footballer)	playsFor	Torquay_United_F.C.
Janne_Hietanen	playsFor	UD_Las_Palmas
Angelo_Vier	playsFor	Arminia_Bielefeld
Jofre_Mateu	playsFor	FC_Barcelona
Harry_Hubbick	playsFor	Blyth_Spartans_A.F.C.
Andriy_Proshyn	playsFor	FC_Rostov
San_Jose_International_Airport	isConnectedTo	McCarran_International_Airport
Tenerife_South_Airport	isConnectedTo	Brussels_Airport
Enfidha_–_Hammamet_International_Airport	isConnectedTo	Ostend-Bruges_International_Airport
Andrés_Vasquez	playsFor	Sweden_national_under-17_football_team
Igor_Sypniewski	playsFor	Halmstads_BK
Robbie_Farrell	playsFor	Dundalk_F.C.
Csaba_Horváth_(footballer)	playsFor	Zagłębie_Lubin
Tyson_Wahl	playsFor	Orange_County_Blue_Star
Steve_McClaren	wasBornIn	York
Tony_Taylor_(footballer)	playsFor	Kilmarnock_F.C.
Richard_Thompson_(footballer)	playsFor	Taunton_Town_F.C.
Jiří_Jarošík	playsFor	FC_Krylia_Sovetov_Samara
Almir_Tolja	playsFor	Nassaji_Mazandaran_F.C.
Andre_Arendse	playsFor	SuperSport_United_F.C.
John_Brownlie	playsFor	Hartlepool_United_F.C.
Detroit_Metropolitan_Wayne_County_Airport	isConnectedTo	The_Eastern_Iowa_Airport
Eurico_de_Aguiar_Salles_Airport	isConnectedTo	Deputado_Luís_Eduardo_Magalhães_International_Airport
Luca_Cecconi	playsFor	U.S._Città_di_Palermo
Piet_Keur	playsFor	Feyenoord
Alharbi_El_Jadeyaoui	playsFor	Morocco_national_football_team
Benina_International_Airport	isConnectedTo	Mohammed_V_International_Airport
Luiz_Alberto_da_Silva_Oliveira	wasBornIn	Rio_de_Janeiro
Adriano_Rossato	playsFor	Comercial_Futebol_Clube_(Ribeirão_Preto)
Daúd_Gazale	playsFor	Chile_national_football_team
Alessandro_Gherardi	playsFor	FC_Chiasso
Teddy_Glover	playsFor	Wigan_Borough_F.C.
Peter_Thomson_(footballer_born_1977)	playsFor	Chorley_F.C.
Israel_Delgado_Andrés	playsFor	Lorca_Deportiva_CF
Florent_Raimy	playsFor	FCM_Bacău
Ivan_Klasnić	playsFor	Croatia_national_under-21_football_team
Edison_Fonseca	playsFor	Cúcuta_Deportivo
Scott_Partridge	playsFor	Sheffield_F.C.
Guangzhou_Baiyun_International_Airport	isConnectedTo	Mianyang_Nanjiao_Airport
Michael_Pook	playsFor	Maidenhead_United_F.C.
Nantes_Atlantique_Airport	isConnectedTo	Brussels_Airport
Lyon–Saint_Exupéry_Airport	isConnectedTo	Heraklion_International_Airport
Nelson_San_Martín	playsFor	Deportes_Temuco
Guillermo_La_Rosa	playsFor	Sport_Boys
César_Sampaio	playsFor	Yokohama_Flügels
Aleksandrs_Cauņa	playsFor	Skonto_FC
Dmitri_Ekimov	playsFor	FC_FShM_Torpedo_Moscow
Greg_Shields	wasBornIn	Falkirk
Paulo_Fonseca	playsFor	C.S._Marítimo
Lewis_Cook	playsFor	Maidenhead_United_F.C.
Germán_Lux	playsFor	Deportivo_de_La_Coruña
Mohammad_Nosrati	playsFor	F.C._Aboomoslem
Giovanni_Stroppa	playsFor	Udinese_Calcio
Robbie_Savage_(footballer_born_1960)	playsFor	Bradford_City_A.F.C.
Vienna_International_Airport	isConnectedTo	Mytilene_International_Airport
Borislav_Georgiev	playsFor	FC_Sachsen_Leipzig
Bruno_Ferraz_das_Neves	playsFor	Esporte_Clube_Noroeste
Russian_Civil_War	happenedIn	Austria-Hungary
Andy_Welsh	playsFor	Yeovil_Town_F.C.
Alan_Curtis_(footballer)	playsFor	Stoke_City_F.C.
Kevin_Richardson_(footballer)	playsFor	Everton_F.C.
Sascha_Riether	playsFor	1._FC_Köln
Lluís_Carreras	playsFor	Deportivo_Alavés
Denílson_Martins_Nascimento	playsFor	Feyenoord
Nigel_Callaghan	playsFor	Aston_Villa_F.C.
Lebanon	dealsWith	China
Nigel_Gleghorn	playsFor	Birmingham_City_F.C.
Vladislav_Lemish	playsFor	FC_Kuban_Krasnodar
Roger_Boli	wasBornIn	Abidjan
Obafemi_Martins	playsFor	Levante_UD
Balázs_Rabóczki	playsFor	Dunaújváros_FC
Lionel_Carole	playsFor	Troyes_AC
Viola_(footballer)	playsFor	Sociedade_Esportiva_Palmeiras
İbrahim_Akın	playsFor	Gaziantepspor
Zlatko_Kranjčar	playsFor	Yugoslavia_national_football_team
José_Sátiro_do_Nascimento	playsFor	Esporte_Clube_Santo_André
Jérémie_Bréchet	playsFor	Troyes_AC
Eugene_Airport	isConnectedTo	Salt_Lake_City_International_Airport
Indianapolis_International_Airport	isConnectedTo	Raleigh–Durham_International_Airport
Bradley_International_Airport	isConnectedTo	Denver_International_Airport
Sergio_Omar_Almirón	playsFor	Tours_FC
Bekim_Kastrati	playsFor	Wuppertaler_SV
Eduardo_Marques	playsFor	Shonan_Bellmare
Joe_Miller_(footballer)	playsFor	Celtic_F.C.
Paul_Sheerin	playsFor	Ayr_United_F.C.
Javier_Manjarín	playsFor	Atlético_Celaya
Cristiano_Bergodi	playsFor	Sliema_Wanderers_F.C.
Christian_Wück	playsFor	VfL_Wolfsburg
Jiří_Mašek	playsFor	FK_Baumit_Jablonec
Zagreb_Airport	isConnectedTo	Brussels_Airport
Al_Najaf_International_Airport	isConnectedTo	Kish_International_Airport
Jason_Cundy	playsFor	Crystal_Palace_F.C.
General_Francisco_J._Mujica_International_Airport	isConnectedTo	Ixtapa-Zihuatanejo_International_Airport
Maastricht_Aachen_Airport	isConnectedTo	Girona–Costa_Brava_Airport
Terry_Venables	playsFor	England_national_football_team
Vladimir_Vasilj	playsFor	NK_Hrvatski_Dragovoljac
Wrocław–Copernicus_Airport	isConnectedTo	Torp
Seydou_Koné	playsFor	FC_Botoșani
Błażej_Radler	playsFor	Pogoń_Szczecin
Alan_Foggon	playsFor	Hartlepool_United_F.C.
Chris_Burke_(footballer)	playsFor	Rangers_F.C.
Imre_Varadi	playsFor	Leeds_United_A.F.C.
Prince_Said_Ibrahim_International_Airport	isConnectedTo	Dzaoudzi_Pamandzi_International_Airport
Ian_Helliwell_(footballer)	playsFor	Matlock_Town_F.C.
Hassan_Abdel-Fattah	playsFor	Kuwait_SC
Brimah_Razak	playsFor	Real_Betis_B
Aleksandar_Komadina	playsFor	FK_Jagodina
André_Luciano_da_Silva	playsFor	Santos_FC
Stan_Bowles	playsFor	Leyton_Orient_F.C.
David_Bičík	playsFor	SK_Kladno
Ceyhun_Gülselam	playsFor	Kayserispor
Fábio_Bala	playsFor	Democrata_Futebol_Clube
Mark_Stimson	playsFor	Newcastle_United_F.C.
Mihály_Tóth_(footballer_born_1974)	playsFor	Diósgyőri_VTK
Darren_Sawatzky	playsFor	FC_Dallas
Blas_Pérez	playsFor	Al_Wasl_FC
Lucas_Rimoldi	playsFor	Frosinone_Calcio
William_Bradford_(Plymouth_Colony_governor)	playsFor	PSV_Eindhoven
Antoine_Hey	playsFor	Birmingham_City_F.C.
Ali_Aliyev_(footballer)	playsFor	Kazakhstan_national_football_team
Leonid_Kovel	playsFor	FC_Irtysh_Pavlodar
Atdhe_Nuhiu	playsFor	Eskişehirspor
Scott_Cannon	playsFor	Tampa_Bay_Mutiny
Lothar_Emmerich	playsFor	1._FC_Schweinfurt_05
Georgia_(country)	dealsWith	China
Orlando_Fanasca	playsFor	Ternana_Calcio
Monterrey_International_Airport	isConnectedTo	Ciudad_Obregón_International_Airport
Catilina_Aubameyang	playsFor	A.C._Rimini_1912
Yulin_Yuyang_Airport	isConnectedTo	Guangzhou_Baiyun_International_Airport
Christian_Callejas	playsFor	Centro_Atlético_Fénix
Paderborn_Lippstadt_Airport	isConnectedTo	Tenerife_South_Airport
Guangzhou_Baiyun_International_Airport	isConnectedTo	Zhijiang_Airport
Igor_Sypniewski	playsFor	Kallithea_F.C.
Windorah_Airport	isConnectedTo	Mount_Isa_Airport
Tony_Bird_(footballer_born_1974)	playsFor	Haverfordwest_County_A.F.C.
Héctor_Almandoz	wasBornIn	Morón,_Buenos_Aires
Khanty-Mansiysk_Airport	isConnectedTo	Roshchino_International_Airport
Robbie_Fowler	playsFor	England_national_under-21_football_team
Jimmy_Schmidt	playsFor	C.S.D._Villa_Española
Luis_Guevara_Mora	playsFor	C.D._Águila
Peter_Neustädter	playsFor	Kazakhstan_national_football_team
Mitar_Peković	playsFor	FK_Budućnost_Podgorica
Alick_Maemae	playsFor	YoungHeart_Manawatu
Felipe_Caicedo	playsFor	Barcelona_Sporting_Club
Salt_Lake_City_International_Airport	isConnectedTo	Los_Angeles_International_Airport
Eddie_Nolan	playsFor	Blackburn_Rovers_F.C.
Bruno_Herrero_Arias	playsFor	Girona_FC
Liam_Buckley	playsFor	Athlone_Town_A.F.C.
Aaron_Conway	playsFor	Peterhead_F.C.
Diego_Martiñones	wasBornIn	Montevideo
Papa_Bouba_Diop	playsFor	Birmingham_City_F.C.
Alessandro_Faria	wasBornIn	Porto_Alegre
Andre_Arendse	playsFor	South_Africa_national_football_team
Sammy_Cox	playsFor	Queen's_Park_F.C.
Franz_Beckenbauer	playsFor	Germany_national_football_team
Michael_Howard_(footballer)	playsFor	Swansea_City_A.F.C.
Lebanon	dealsWith	Germany
Yakir_Aharonov	hasWonPrize	National_Medal_of_Science
Michael_Howard_(footballer)	playsFor	Aberystwyth_Town_F.C.
Clemer	playsFor	Goiás_Esporte_Clube
Nigel_Callaghan	playsFor	Derby_County_F.C.
Scott_Garlick	playsFor	Tampa_Bay_Mutiny
Danny_McLennan	playsFor	Dundee_F.C.
Khalilou_Fadiga	playsFor	Lommel_United
Alen_Bašić	playsFor	Dynamo_Dresden
Dubrovnik_Airport	isConnectedTo	Geneva_International_Airport
Jean-François_Gillet	playsFor	Belgium_national_under-17_football_team
Michael_Holt_(English_footballer)	playsFor	Blackburn_Rovers_F.C.
Danny_Carlton	playsFor	Hyde_F.C.
Felix_Bastians	playsFor	Borussia_Dortmund
Simon_Kjær	playsFor	VfL_Wolfsburg
Ferdinand_Foch	hasWonPrize	Distinguished_Service_Medal_(U.S._Army)
Loïc_Nego	playsFor	FC_Nantes
Lakhdar_Adjali	playsFor	Amiens_SC
Sébastien_Grimaldi	playsFor	Chesterfield_F.C.
Dioh_Williams	wasBornIn	Monrovia
Cairo_International_Airport	isConnectedTo	Barcelona–El_Prat_Airport
Édison_Méndez	playsFor	PSV_Eindhoven
Raúl_Palacios	playsFor	Deportes_La_Serena
Yannick_Bolasie	playsFor	DR_Congo_national_football_team
Dominik_Rodinger	playsFor	FK_Bohemians_Prague_(Střížkov)
Guillermo_Amor	playsFor	Benidorm_CF
Derek_Decamps	playsFor	Angers_SCO
Ariel_Jakubowski	playsFor	Ruch_Chorzów
Igor_Djuric_(Swiss_footballer)	playsFor	FC_Chiasso
Juan_Manuel_Lucero	playsFor	Cerro_Porteño
Elinton_Andrade	playsFor	Fluminense_FC
Chūbu_Centrair_International_Airport	isConnectedTo	Guangzhou_Baiyun_International_Airport
Modou_Sougou	playsFor	AS_Douanes_(Dakar)
Yohai_Aharoni	playsFor	F.C._Nazareth_Illit
Samir_Ujkani	playsFor	Albania_national_football_team
Marcílio_Alves_da_Silva	playsFor	Bangu_Atlético_Clube
Jorge_Wagner	playsFor	FC_Lokomotiv_Moscow
Paulo_Assunção	playsFor	São_Paulo_FC
Nicola_Legrottaglie	playsFor	A.C._Chievo_Verona
Evandro_Adauto_da_Silva	playsFor	Associação_Atlética_Ponte_Preta
Tolmachevo_Airport	isConnectedTo	Khanty-Mansiysk_Airport
Paul_Evans_(footballer_born_1973)	playsFor	South_Africa_national_football_team
Michael_Utting	playsFor	SuperSport_United_F.C.
Harry_Hubbick	playsFor	Port_Vale_F.C.
Callum_Tapping	playsFor	Celtic_F.C.
Gordon_Durie	playsFor	Heart_of_Midlothian_F.C.
Dagui_Bakari	playsFor	Amiens_SC
Beto_Naveda	playsFor	Dundee_F.C.
Vojtěch_Schulmeister	playsFor	Czech_Republic_national_under-21_football_team
Alessandro_Pellicori	playsFor	U.S._Lecce
Phil_Clarkson	playsFor	Scunthorpe_United_F.C.
Abe_Hartley	wasBornIn	Dumbarton
Rafał_Lasocki	playsFor	Dyskobolia_Grodzisk_Wielkopolski
Pisa_International_Airport	isConnectedTo	Cagliari_Elmas_Airport
Dave_Smith_(footballer_born_1943)	playsFor	Rangers_F.C.
Viola_Odebrecht	playsFor	1._FFC_Turbine_Potsdam
Mark_Dobie	playsFor	Queen_of_the_South_F.C.
Graham_Paddon	playsFor	England_national_under-21_football_team
Joachim_Standfest	playsFor	SK_Sturm_Graz
Boubacar_Kébé	playsFor	AS_Cherbourg_Football
Rudi_Völler	playsFor	SV_Werder_Bremen
Brussels_Airport	isConnectedTo	Hurghada_International_Airport
Jackie_Mudie	wasBornIn	Dundee
Juan_Ramón_Fernández	playsFor	Club_Olimpo
Clark_International_Airport	isConnectedTo	Macau_International_Airport
James_Thompson_(footballer)	playsFor	Luton_Town_F.C.
Yuri_Kovtun	playsFor	FC_Dynamo_Moscow
Abiodun_Baruwa	playsFor	Nigeria_national_football_team
Cairo_International_Airport	isConnectedTo	Dubai_International_Airport
Jurgen_Cavens	playsFor	R._Cappellen_F.C.
Sunday_Oliseh	playsFor	1._FC_Köln
Miguel_Alfredo_Portillo	playsFor	BSC_Young_Boys
Jean_Carlos	playsFor	Clube_Atlético_Hermann_Aichinger
Craig_Brewster	playsFor	Inverness_Caledonian_Thistle_F.C.
Ivica_Banović	playsFor	Croatia_national_under-21_football_team
Landon_Donovan	playsFor	Bayer_04_Leverkusen
Luis_Jonne	playsFor	Club_Nacional_de_Football
Madeira_Airport	isConnectedTo	Tenerife_South_Airport
Harry_Hooper_(footballer,_born_1933)	playsFor	Dunstable_Town_F.C.
Mancini_(Brazilian_footballer)	playsFor	Associação_Desportiva_São_Caetano
Bert_Crossthwaite	playsFor	Preston_North_End_F.C.
Craig_Farrell_(footballer)	playsFor	Leeds_United_A.F.C.
Walter_Caprile	playsFor	C.D._Motagua
Mahesh_Bhatt	wasBornIn	Mumbai
Stein_Huysegems	playsFor	K.R.C._Genk
Nicolae_Dică	wasBornIn	Pitești
Steven_Smith_(footballer)	playsFor	Preston_North_End_F.C.
Lee_Martin_(footballer,_born_February_1968)	playsFor	Manchester_United_F.C.
Fort_Lauderdale–Hollywood_International_Airport	isConnectedTo	Québec_City_Jean_Lesage_International_Airport
Ringo_Starr	wasBornIn	Liverpool
Rogério_Gaúcho	playsFor	União_Agrícola_Barbarense_Futebol_Clube
Ammar_Jemal	playsFor	1._FC_Köln
Nicolas_Douchez	playsFor	LB_Châteauroux
Óscar_Aguirregaray	wasBornIn	Montevideo
Hangzhou_Xiaoshan_International_Airport	isConnectedTo	Zhuhai_Jinwan_Airport
Stuart_Wardley	wasBornIn	Cambridge
Frantz_Bertin	playsFor	Racing_de_Santander
Henri_Toivomäki	playsFor	Atalanta_B.C.
Luigi_Della_Rocca	playsFor	Unione_Triestina_2012_S.S.D.
John_Mosquera	playsFor	SV_Wacker_Burghausen
Gunnlaugur_Jónsson	playsFor	Örebro_SK
Danny_Granville	playsFor	Norwich_City_F.C.
Ray_Burse	playsFor	FC_Dallas
Augusto_Recife	playsFor	Santa_Cruz_Futebol_Clube
Said_Husejinović	playsFor	SV_Werder_Bremen
Carsten_Lakies	wasBornIn	Kassel
Mista_(footballer)	playsFor	Real_Madrid_Castilla
A._R._Rawlinson	playsFor	Wimbledon_F.C.
Gesiel_José_de_Lima	playsFor	Santa_Cruz_Futebol_Clube
José_Moisela	playsFor	Peru_national_football_team
Fábio_Gonçalves_dos_Santos	playsFor	Associação_Desportiva_São_Caetano
Alfie_Conn,_Jr.	playsFor	Blackpool_F.C.
Marcelo_Tejera	playsFor	Boca_Juniors
David_Bisconti	playsFor	Yokohama_F._Marinos
James_H._Kasler	hasWonPrize	American_Campaign_Medal
Dayro_Moreno	playsFor	Clube_Atlético_Paranaense
Ireland_West_Airport_Knock	isConnectedTo	Luton_Airport
Mariusz_Kukiełka	playsFor	Dynamo_Dresden
Charles_de_Gaulle_Airport	isConnectedTo	Philadelphia_International_Airport
Narada_Bernard	playsFor	Barnet_F.C.
Moisés_Matias_de_Andrade	playsFor	Sport_Club_Corinthians_Paulista
Juan_Pablo_Galavis	playsFor	Deportivo_Petare
Sung_Lin_Yung	playsFor	Tianjin_Teda_F.C.
Magnum_Rafael_Farias_Tavares	playsFor	Associação_Desportiva_São_Caetano
Nikolay_Harizanov	playsFor	PFC_Hebar_Pazardzhik
Efstathios_Tavlaridis	playsFor	Lille_OSC
David_Vaughan_(footballer)	playsFor	Real_Sociedad
Jermaine_Pennant	playsFor	England_national_under-21_football_team
Billy_Crook_(American_soccer)	playsFor	San_Jose_Earthquakes_(1974–88)
Björn_Schlicke	playsFor	Hamburger_SV_II
Daniel_Olerum	playsFor	F.C._Aboomoslem
António_Carlos_dos_Santos	playsFor	FC_Baden
Jorge_Chávez_International_Airport	isConnectedTo	Foz_do_Iguaçu_International_Airport
Triguinho	playsFor	Santos_FC
Orly_Airport	isConnectedTo	Brest_Bretagne_Airport
Ádám_Simon	playsFor	U.S._Città_di_Palermo
Comodoro_Arturo_Merino_Benítez_International_Airport	isConnectedTo	Los_Angeles_International_Airport
Zdeněk_Svoboda	playsFor	Sliema_Wanderers_F.C.
James_Miller_(footballer)	playsFor	St._Mirren_F.C.
Gernot_Rohr	wasBornIn	Mannheim
Georgi_Georgiev_(footballer_born_1970)	playsFor	Apollon_Smyrni_F.C.
Brimah_Razak	playsFor	Real_Betis
Djalmir_Vieira_Andrade	playsFor	Cascavel_Clube_Recreativo
Fort_Lauderdale–Hollywood_International_Airport	isConnectedTo	Gatwick_Airport
Andriy_Kornyev	wasBornIn	Kiev
Igor_Sypniewski	playsFor	Malmö_FF
Rubén_Sosa	playsFor	Shanghai_Greenland_F.C.
Jinan_Yaoqiang_International_Airport	isConnectedTo	Guiyang_Longdongbao_International_Airport
Emerson_de_Andrade_Santos	playsFor	Associação_Atlética_Ponte_Preta
Izu_Azuka	wasBornIn	Port_Harcourt
Guillermo_La_Rosa	playsFor	Deportivo_Pereira
Timo_Furuholm	playsFor	Finland_national_under-21_football_team
Paul_Brayson	playsFor	Newcastle_Blue_Star_F.C.
Romulus_Buia	playsFor	FC_Politehnica_Timișoara
Cyril_Théréau	playsFor	R.S.C._Anderlecht
Paul_Brayson	playsFor	Bedlington_Terriers_F.C.
Dubai_International_Terminal_3	isConnectedTo	Clark_International_Airport
Patricio_Hernández	playsFor	Estudiantes_de_La_Plata
Ruud_Geels	playsFor	Feyenoord
Billy_Draycott	playsFor	Port_Vale_F.C.
Indianapolis_International_Airport	isConnectedTo	Philadelphia_International_Airport
Leonardo_Andrés_Iglesias	wasBornIn	Lanús
Álvaro_Arbeloa	playsFor	Real_Madrid_C
Shay_Given	playsFor	Newcastle_United_F.C.
Naoya_Saeki	wasBornIn	Tokyo
Sandro_Calabro	playsFor	Feyenoord
Vladimir_Vujović_(footballer)	playsFor	Shenyang_Zhongze_F.C.
Felipe_Baloy	playsFor	Clube_Atlético_Paranaense
Valeri_Domovchiyski	playsFor	PFC_Botev_Plovdiv
Béla_Balogh_(footballer)	playsFor	BFC_Siófok
Dave_Campbell_(footballer)	playsFor	Shelbourne_F.C.
Adam_Wolanin	playsFor	FC_Spartak_Moscow
Koltsovo_Airport	isConnectedTo	Federico_Fellini_International_Airport
Fuzhou_Changle_International_Airport	isConnectedTo	Jinan_Yaoqiang_International_Airport
Mark_McCulloch	playsFor	Forfar_Athletic_F.C.
Bristol_Airport	isConnectedTo	Chambéry_Airport
Dmitriy_Kramarenko	playsFor	Neftchi_Baku_PFK
Koltsovo_Airport	isConnectedTo	Monastir_Habib_Bourguiba_International_Airport
Brendon_Šantalab	playsFor	Sydney_FC
Dave_Regis	playsFor	Birmingham_City_F.C.
Frank_Carrodus	playsFor	Aston_Villa_F.C.
Ivan_Lietava	playsFor	FK_Dukla_Prague
Garry_Brady	playsFor	Norwich_City_F.C.
Daniel_N'Gom_Kome	playsFor	Levante_UD
Montréal–Pierre_Elliott_Trudeau_International_Airport	isConnectedTo	Calgary_International_Airport
Germán_Pietrobon	playsFor	PFC_CSKA_Sofia
Moldova	dealsWith	China
Daniel_Sánchez_(Uruguayan_footballer)	playsFor	Club_Atlético_River_Plate_(Montevideo)
Mauricio_Victorino	playsFor	Tiburones_Rojos_de_Veracruz
George_C._Scott	hasWonPrize	Genie_Awards
Davide_Bombardini	playsFor	U.S._Città_di_Palermo
Scott_Canham	playsFor	Thurrock_F.C.
William_da_Silva_Barbosa	playsFor	A.S.D._Portogruaro
Alan_Little	playsFor	Torquay_United_F.C.
Nathan_Taylor_(footballer)	playsFor	Bradford_Park_Avenue_A.F.C.
Marco_Aurélio_Pereira_Alves	playsFor	Fluminense_FC
Łukasz_Madej	playsFor	Górnik_Zabrze
Rafael_Martins	playsFor	Clube_Atlético_Juventus
Aaron_Callaghan_(footballer_born_1966)	playsFor	Dundalk_F.C.
Venice_Marco_Polo_Airport	isConnectedTo	Brussels_Airport
Vladimir_Dimitrovski	playsFor	FK_Metalurg_Skopje
Miloslav_Kousal	playsFor	SK_Kladno
Jacob_Spoonley	playsFor	New_Zealand_national_football_team
Sammy_McMillan	playsFor	Wrexham_F.C.
Daniel_Akhtyamov	wasBornIn	Tashkent
Mati_Lember	wasBornIn	Tallinn
Rodrigo_Mannara	playsFor	Cobreloa
S._P._Balasubrahmanyam	hasWonPrize	Filmfare_Awards
Grégory_Dufer	playsFor	K.S.C._Lokeren_Oost-Vlaanderen
Iván_Zamorano	playsFor	Cobresal
Namkung_Woong	playsFor	Suwon_Samsung_Bluewings
Ricardo_Costa_(Portuguese_footballer)	playsFor	Lille_OSC
Harry_Kewell	playsFor	Al-Gharafa_Sports_Club
Montréal–Pierre_Elliott_Trudeau_International_Airport	isConnectedTo	Charles_de_Gaulle_Airport
Ion_Vlădoiu	playsFor	FC_Rapid_București
Aron_Wilford	playsFor	Dandenong_Thunder_SC
Daniel_Addo	playsFor	Bayer_04_Leverkusen
Roland_Goriupp	wasBornIn	Graz
Jonathan_Gould	playsFor	Celtic_F.C.
Split_Airport	isConnectedTo	Visby_Airport
Paul_Robinson_(footballer,_born_1984)	playsFor	Newcastle_United_F.C.
Jason_Bowen_(footballer)	playsFor	Birmingham_City_F.C.
Alessio_Manzoni	playsFor	Frosinone_Calcio
Daniel_Addo	playsFor	FK_Vardar
Matthew_Osman	playsFor	Manly_United_FC
Guti_(footballer)	playsFor	Real_Madrid_Castilla
Eduardo_Bustos_Montoya	playsFor	Avispa_Fukuoka
Rômulo_Marques_Antoneli	playsFor	Hapoel_Nir_Ramat_HaSharon_F.C.
Siim_Luts	wasBornIn	Tallinn
Tadas_Papečkys	playsFor	FK_Rīga
Juan_Carlos_Mariño	playsFor	Cádiz_CF
Stanley_Udenkwor	playsFor	Podbeskidzie_Bielsko-Biała
Tomislav_Kaloperović	playsFor	FK_Partizan
Adolfino_Cañete	playsFor	General_Caballero_Sport_Club
K._V._Subbanna	playsFor	Iceland_national_under-19_football_team
Rinus_Israël	playsFor	PEC_Zwolle
Pascal_Vahirua	playsFor	Tours_FC
Sergio_Torres	playsFor	Crawley_Town_F.C.
Saúl_Ñíguez	playsFor	Rayo_Vallecano
Júlio_César_(footballer,_born_1963)	playsFor	Panathinaikos_F.C.
Vladimir_Eshtrekov	playsFor	FC_Spartak_Moscow
Ben_Thornley	playsFor	Stockport_County_F.C.
Ivica_Kralj	playsFor	FC_Spartak_Trnava
Ionuț_Rada	playsFor	CS_Otopeni
Gustavo_Lombardi	playsFor	Middlesbrough_F.C.
Davor_Krznarić	playsFor	FC_Augsburg
Pavel_Kováč	playsFor	MFK_Dubnica
Erbil_International_Airport	isConnectedTo	Tbilisi_International_Airport
Leandro_Farias	playsFor	Avaí_Futebol_Clube
Rodrigo_Barbosa_Rodrigues_Costa	playsFor	TSV_1860_München
Catania–Fontanarossa_Airport	isConnectedTo	Ancona_Falconara_Airport
François_Félix	playsFor	Nîmes_Olympique
Chris_McPhee	playsFor	Swindon_Town_F.C.
Nick_van_der_Velden	playsFor	N.E.C._(football_club)
Theo_Schneider	playsFor	Borussia_Dortmund
Giorgio_Gorgone	playsFor	F.C._AlzanoCene_1909
Lee_Yo-han	playsFor	Busan_IPark
Jimmy_Greenhoff	playsFor	Manchester_United_F.C.
Choi_Chul-woo	playsFor	Busan_IPark
David_Smith_(footballer_born_1968)	playsFor	England_national_under-21_football_team
Ürümqi_Diwopu_International_Airport	isConnectedTo	Chongqing_Jiangbei_International_Airport
Đorđe_Kamber	playsFor	Zalaegerszegi_TE
Ralf_Loose	playsFor	Borussia_Dortmund
Antonio_Adán	playsFor	Real_Madrid_C
Jack_Wilshere	playsFor	England_national_under-17_football_team
Anri_Khagush	playsFor	FC_Kuban_Krasnodar
Peter_Withe	playsFor	Portland_Timbers_(1975–82)
Billy_Thomson	playsFor	St._Mirren_F.C.
Sidney_Santos_de_Brito	playsFor	Santa_Cruz_Futebol_Clube
Çağdaş_Atan	playsFor	Turkey_national_football_B_team
Michael_Görlitz	playsFor	FSV_Frankfurt
Alberto_Cossentino	playsFor	Gela_Calcio
Shaun_Bajada	playsFor	Marsaxlokk_F.C.
Aldo_Dolcetti	playsFor	Novara_Calcio
Nikolai_Pisarev	playsFor	FC_St._Pauli
Brett_Holman	playsFor	Feyenoord
Gabriel_de_Paulo_Limeira	playsFor	Associação_Desportiva_São_Caetano
Zoltan_Crișan	playsFor	FCM_Baia_Mare
Imre_Szabics	playsFor	FC_Augsburg
Michael_Blackwood_(footballer)	wasBornIn	Birmingham
Lilian_Nalis	playsFor	AJ_Auxerre
Juanda_International_Airport	isConnectedTo	Iskandar_Airport
Marcelo_Tejera	playsFor	Club_Nacional_de_Football
Boško_Boškovič	playsFor	SC_Freiburg
Peter_Hattrup	playsFor	Portland_Timbers_(1985–90)
Lhasa_Gonggar_Airport	isConnectedTo	Hangzhou_Xiaoshan_International_Airport
Mariano_Torres	playsFor	Sport_Club_Corinthians_Paulista
Franco_Navarro	playsFor	Peru_national_football_team
Alberto_Comazzi	playsFor	S.S._Lazio
Radivoje_Ognjanović	playsFor	Yugoslavia_national_football_team
Diego_Walsh	wasBornIn	Santos,_São_Paulo
Mark_Quayle	playsFor	Grantham_Town_F.C.
Graham_Smith_(footballer)	playsFor	Hednesford_Town_F.C.
Tommaso_Rocchi	playsFor	A.C.D._Treviso_2013
Dejan_Martinović	playsFor	FSV_Oggersheim
Guangzhou_Baiyun_International_Airport	isConnectedTo	Kuala_Lumpur_International_Airport
Mehdi_Amirabadi	playsFor	Bahman_F.C.
Dominik_Jakubek	playsFor	Garbarnia_Kraków
Orosco_Anonam	playsFor	Floriana_F.C.
Josh_Walker	playsFor	Watford_F.C.
Iorlando_Pereira_Marques_Filho	playsFor	Vila_Nova_Futebol_Clube
Sebastián_Roco	playsFor	Gimnasia_y_Esgrima_de_Jujuy
Darren_Roberts_(footballer)	wasBornIn	Birmingham
Kevin_Twaddle	playsFor	Raith_Rovers_F.C.
Kevin_Rapley	playsFor	Leigh_Genesis_F.C.
Franco_Brienza	playsFor	U.S._Città_di_Palermo
Anderson_Luiz_Domingos	playsFor	Betim_Esporte_Clube
Migjen_Basha	playsFor	F.C._Esperia_Viareggio
Ed_Brookes	playsFor	Irish_League_representative_team
Adam_Ledwoń	playsFor	GKS_Katowice
Gary_Mills_(footballer,_born_1961)	playsFor	Alfreton_Town_F.C.
Chad_Deering	playsFor	Charleston_Battery
Alpay_Özalan	playsFor	Incheon_United_FC
Rodrigo_Possebon	playsFor	Mirassol_Futebol_Clube
Tancredo_Neves_International_Airport	isConnectedTo	Greater_Natal_International_Airport
Manuel_Ruz	playsFor	Valencia_CF_Mestalla
Carlos_Pérez_García	playsFor	FC_Spartak_Trnava
Alessandro_Turchetta	playsFor	A.S._Gubbio_1910
Ali_Zitouni	playsFor	Al_Ahli_Club_(Dubai)
Euller	playsFor	Sociedade_Esportiva_Palmeiras
John_Bain	wasBornIn	Falkirk
Dylan_Hughes	playsFor	SSV_Jahn_Regensburg
Carsten_Keuler	playsFor	Stuttgarter_Kickers
Pedro_Paulo_de_Oliveira	playsFor	Fluminense_FC
Kim_Yoo-jin_(footballer)	playsFor	Ansan_Police_FC
Iskandar_Airport	isConnectedTo	Achmad_Yani_International_Airport
Eduardo_Ratinho	playsFor	Sport_Club_Corinthians_Paulista
Ákos_Elek	playsFor	Hungary_national_football_team
Jacques_Vergnes	playsFor	Nîmes_Olympique
Alan_Hunter_(footballer)	playsFor	Australia_national_association_football_team
Jordan_Stewart	playsFor	Derby_County_F.C.
Cho_Jae-jin	playsFor	Jeonbuk_Hyundai_Motors
Rosana_dos_Santos_Augusto	playsFor	Sport_Club_Corinthians_Paulista
Jack_Lemmon	hasWonPrize	Academy_Award_for_Best_Actor
Iyseden_Christie	wasBornIn	Coventry
Bristol_Airport	isConnectedTo	Madeira_Airport
Thankgod_Amaefule	playsFor	Dolphins_F.C._(Port_Harcourt)
Husref_Musemić	playsFor	Heart_of_Midlothian_F.C.
Brussels_Airport	isConnectedTo	Paphos_International_Airport
John_Inglis_(footballer)	playsFor	PFC_Botev_Plovdiv
Achim_Pfuderer	playsFor	SC_Pfullendorf
Attila_Tököli	playsFor	Ferencvárosi_TC
Álvaro_Arbeloa	playsFor	Deportivo_de_La_Coruña
Francesco_Bega	wasBornIn	Milan
Neil_Franklin	playsFor	Stoke_City_F.C.
Tommy_Mooney	playsFor	Watford_F.C.
Alexandre_Luiz_Fernandes	playsFor	Clube_Atlético_Juventus
Gabriel_Álvez	playsFor	El_Tanque_Sisley
Stoyan_Kolev	playsFor	Bulgaria_national_football_team
Paul_Evans_(footballer_born_1974)	playsFor	Shrewsbury_Town_F.C.
Frankie_Hejduk	playsFor	Columbus_Crew
Nantes_Atlantique_Airport	isConnectedTo	Valencia_Airport
Yevgeny_Savin	playsFor	FC_Lokomotiv_Moscow
Didier_Sénac	playsFor	FC_Girondins_de_Bordeaux
Michael_Tommy_(footballer)	playsFor	A.D._Belén
Darren_Anderton	playsFor	England_national_under-21_football_team
Detroit_Metropolitan_Wayne_County_Airport	isConnectedTo	Raleigh–Durham_International_Airport
Bruno_Sutter	playsFor	FC_Zürich
Guy_Madjo	playsFor	Stafford_Rangers_F.C.
Mike_Mampuya	playsFor	Lierse_S.K.
Gareth_Ainsworth	wasBornIn	Blackburn
Joël_Thomas	playsFor	FC_Girondins_de_Bordeaux
Cyprus	exports	wordnet_clothing_103051540
Allan_Russell	playsFor	Kilmarnock_F.C.
Nadir_Benchenaa	playsFor	SV_Babelsberg_03
Dave_Henderson_(footballer)	playsFor	Republic_of_Ireland_national_under-21_football_team
Milton_Coimbra	playsFor	Beijing_Guoan_F.C.
J._R._Reid	playsFor	Club_Ferro_Carril_Oeste
Benny_Gall	playsFor	Brønshøj_BK
Mark_Lovell_(footballer)	playsFor	Hastings_United_F.C.
Dubai_International_Airport	isConnectedTo	Birmingham_Airport
Dubai_International_Terminal_3	isConnectedTo	Sydney_Airport
Osvaldo_Díaz	playsFor	Club_Sportivo_San_Lorenzo
Gavin_Glinton	playsFor	FC_Dallas
Roberto_Lopes_Nascimento	wasBornIn	Fortaleza
Miguel_Ángel_Nieto	playsFor	Racing_de_Santander
Kiril_Nikolov_(footballer)	playsFor	FC_Vihren_Sandanski
John_DeBrito	playsFor	Columbus_Crew
Oumar_Kondé	playsFor	TOT_S.C.
Ryan_Coiner	playsFor	1._FC_Union_Berlin
Scott_Garlick	playsFor	D.C._United
Stevica_Ristić	playsFor	Suwon_Samsung_Bluewings
Saša_Kovačević	playsFor	FK_Obilić
Maxwell_Konadu	playsFor	Ghana_national_football_team
Bandaranaike_International_Airport	isConnectedTo	Guangzhou_Baiyun_International_Airport
Ulisses_Morais	playsFor	Varzim_S.C.
Dubai_International_Airport	isConnectedTo	Shahjalal_International_Airport
Diego_Placente	playsFor	FC_Girondins_de_Bordeaux
Bordeaux–Mérignac_Airport	isConnectedTo	Florence_Airport,_Peretola
Ryan_Mallon	playsFor	Matlock_Town_F.C.
Barcelona–El_Prat_Airport	isConnectedTo	Pisa_International_Airport
Dario_Dainelli	playsFor	A.C._Chievo_Verona
Sergio_Escudero_(footballer_born_1983)	playsFor	Sport_Club_Corinthians_Paulista
Rzeszów–Jasionka_Airport	isConnectedTo	Luton_Airport
David_Vandenbossche	playsFor	US_Boulogne
Étienne_Capoue	playsFor	Chamois_Niortais_F.C.
Douglas_Marques	playsFor	Clube_Atlético_Paranaense
István_Ferenczi	playsFor	Hungary_national_football_team
General_Enrique_Mosconi_International_Airport	isConnectedTo	Almirante_Marcos_A._Zar_Airport
Mateusz_Kowalski	playsFor	Piast_Gliwice
Edison_Giménez	playsFor	Independiente_Medellín
A._R._Rawlinson	hasWonPrize	Legion_of_Merit
Ricardo_Fuller	playsFor	Crystal_Palace_F.C.
José_Oliveira_de_Souza	playsFor	C.D._Municipal_Limeño
Javier_Páez	playsFor	Gimnasia_y_Esgrima_de_Jujuy
Lee_Hendrie	wasBornIn	Birmingham
Marcelo_Corrales	playsFor	Coquimbo_Unido
Wayne_Bullimore	playsFor	Bradford_City_A.F.C.
Serhiy_Hrybanov	playsFor	PFC_Oleksandriya
Jonathan_Fabbro	playsFor	Club_Deportivo_Universidad_Católica
Finland	dealsWith	Norway
Serhiy_Turiansky	playsFor	Nyíregyháza_Spartacus_FC
Ivica_Jozić	playsFor	VfL_Wolfsburg
Australia	dealsWith	Singapore
Bahrain_International_Airport	isConnectedTo	Al_Najaf_International_Airport
Alberto_Frison	playsFor	A.C.D._Treviso_2013
Marco_Esposito	playsFor	A.C._Pisa_1909
César_Cortés	playsFor	Club_Universidad_de_Chile
Lamberto_Zauli	playsFor	Alma_Juventus_Fano_1906
Bréiner_Castillo	playsFor	Sociedad_Deportiva_Aucas
Dirk_Jan_Derksen	playsFor	Roda_JC_Kerkrade
Christian_Obodo	playsFor	ACF_Fiorentina
Junas_Naciri	playsFor	Moreirense_F.C.
Filipe_da_Costa	playsFor	Leeds_United_A.F.C.
Johan_Cavalli	playsFor	US_Créteil-Lusitanos
Masoud_Shojaei	playsFor	Iran_B_national_football_team
Are_Tronseth	wasBornIn	Trondheim
Edmar_Bernardes	playsFor	Santos_FC
Benjamin_Weigelt	playsFor	FC_St._Pauli
Ilie_Stan	playsFor	FC_Progresul_București
Leandro_da_Silva_(footballer_born_1985)	playsFor	FC_Arsenal_Kyiv
Guntars_Silagailis	playsFor	FK_Rīga
Zbyněk_Pospěch	playsFor	SFC_Opava
Arnaud_Dos_Santos	playsFor	US_Boulogne
Robbie_Horgan	playsFor	St_Patrick's_Athletic_F.C.
Yossi_Shivhon	playsFor	Hapoel_Nir_Ramat_HaSharon_F.C.
Sunday_Chibuike	playsFor	Nigeria_national_football_team
Jody_Banim	playsFor	Hyde_F.C.
Murat_Suyumagambetov	playsFor	FC_Astana
Kalin_Bankov	playsFor	Minnesota_Thunder
Michal_Papadopulos	playsFor	Zagłębie_Lubin
Adrian_Alston	playsFor	Canberra_City_FC
Hans_Gillhaus	playsFor	FC_Den_Bosch
San_Pablo_Airport	isConnectedTo	Gatwick_Airport
Radosław_Gilewicz	playsFor	ASKÖ_Pasching
Ricardo_Pinto_(footballer)	playsFor	Sport_Club_Corinthians_Paulista
Frederik_Sørensen	playsFor	Denmark_national_under-21_football_team
Georgi_Yartsev	playsFor	FC_Gomel
Tony_Cottee	playsFor	England_national_football_team
Sheremetyevo_International_Airport	isConnectedTo	Zagreb_Airport
Paulo_Jorge_Pedro_Lopes	playsFor	C.D._Feirense
Lee_Fowler	playsFor	Wrexham_F.C.
Sérgio_Henrique_Silva_Guedes	playsFor	Bangu_Atlético_Clube
Fábio_Luís_Ramim	playsFor	Mil-Muğan_FK
Makhach_Gadzhiyev	playsFor	FC_Krylia_Sovetov_Samara
Ivan_Jovanović_(footballer_born_1978)	playsFor	Shanghai_Greenland_F.C.
Charles_de_Gaulle_Airport	isConnectedTo	Minsk_National_Airport
Dong_Fangzhuo	playsFor	FC_Mika
Tony_Battersby	playsFor	Stamford_A.F.C.
Clarence_R._Huebner	hasWonPrize	Silver_Star
Aleksandr_Chikhradze	playsFor	FC_Dinamo_Tbilisi
Stevo_Glogovac	playsFor	FK_Zemun
Felix_Katongo	playsFor	Mamelodi_Sundowns_F.C.
Queen_Paola_of_Belgium	hasWonPrize	Order_of_Leopold_(Belgium)
Robert_Reilly_(footballer)	playsFor	Kilmarnock_F.C.
Vinícius_Conceição_da_Silva	wasBornIn	Porto_Alegre
Nolberto_Solano	playsFor	Peru_national_football_team
Deiniol_Graham	playsFor	Stockport_County_F.C.
Frode_Grodås	playsFor	Racing_de_Santander
Diego_Fabbrini	playsFor	Watford_F.C.
Francisco_Martos	playsFor	Girona_FC
Pini_Balili	playsFor	Shimshon_Tel_Aviv_F.C.
Bernardo_Fernandes_da_Silva	playsFor	São_Paulo_FC
Ezequiel_Óscar_Scarione	playsFor	FC_St._Gallen
Marcelo_dos_Santos_Marinho	playsFor	Paysandu_Sport_Club
Jimmy_Gilligan	playsFor	Swansea_City_A.F.C.
Abraham_Gneki_Guié	playsFor	Tours_FC
Jonas_Elmer	playsFor	Switzerland_national_under-21_football_team
Ante_Milicic	playsFor	HNK_Rijeka
William_Júnior_Salles_de_Lima_Souza	playsFor	Santos_FC
Hugh_Fisher_(footballer)	playsFor	Denver_Dynamos
Carlos_Squeo	playsFor	Club_Atlético_Belgrano
Atif_Bashir	playsFor	Haverfordwest_County_A.F.C.
Paul_Sheerin	playsFor	Arbroath_F.C.
Matías_Manrique	playsFor	Ñublense
Colin_Hendry	playsFor	Rangers_F.C.
Henri_Bedimo	playsFor	Le_Havre_AC
Ted_Richardson	playsFor	Newcastle_United_F.C.
Darko_Matić	playsFor	Beijing_Guoan_F.C.
Jonathan_Sesma	playsFor	Orihuela_CF
Scott_Hiley	playsFor	Birmingham_City_F.C.
Arron_Davies	playsFor	Yeovil_Town_F.C.
Leandro_Cruz_de_Oliveira	wasBornIn	Rio_de_Janeiro
Stéphane_Chapuisat	playsFor	Borussia_Dortmund
Reinaldo_Elias_da_Costa	playsFor	Al-Raed
Trevor_Hockey	playsFor	Bradford_City_A.F.C.
David_Byrne_(footballer,_born_1961)	playsFor	Blackburn_Rovers_F.C.
Ármann_Smári_Björnsson	playsFor	Íþróttabandalag_Akraness
Giorgio_Frezzolini	playsFor	A.C._Chievo_Verona
Damián_Ariel_Álvarez	playsFor	C.F._Pachuca
Nikolay_Vasilyevich_Ivanov	playsFor	FC_Vityaz_Podolsk
Ivica_Kralj	playsFor	FC_Rostov
Darko_Djukič	playsFor	NK_Maribor
Andy_Herron	playsFor	Fort_Lauderdale_Strikers
Pisa_International_Airport	isConnectedTo	Torp
Matthew_Turner_(footballer)	playsFor	Ilkeston_F.C.
Dubai_International_Airport	isConnectedTo	Ashgabat_International_Airport
Cyril_Théréau	playsFor	Angers_SCO
Kalin_Bankov	playsFor	Bulgaria_national_football_team
Tampa_International_Airport	isConnectedTo	Lambert–St._Louis_International_Airport
Richie_Alagich	playsFor	West_Adelaide_SC
Caleb_Norkus	playsFor	United_States_men's_national_under-17_soccer_team
Grant_Watts	playsFor	Crystal_Palace_F.C.
Philadelphia_International_Airport	isConnectedTo	Akron–Canton_Airport
Luiz_Alberto_da_Silva_Oliveira	playsFor	Duque_de_Caxias_Futebol_Clube
Brussels_Airport	isConnectedTo	Jomo_Kenyatta_International_Airport
Erbim_Fagu	playsFor	KF_Teuta_Durrës
Béla_Sárosi	playsFor	Bologna_F.C._1909
Shanghai_Pudong_International_Airport	isConnectedTo	Ürümqi_Diwopu_International_Airport
Boban_Grnčarov	playsFor	FC_Metalurh_Donetsk
Charles_Ambler	playsFor	Luton_Town_F.C.
Maxime_Agueh	playsFor	FC_Gueugnon
Alexander_Bugera	playsFor	FC_Bayern_Munich
Ancona_Falconara_Airport	isConnectedTo	Leonardo_da_Vinci–Fiumicino_Airport
Bjørnar_Holmvik	playsFor	Norway_national_under-21_football_team
Simon_Colosimo	playsFor	Australian_Institute_of_Sport
Oliver_Cuadrado_Martín	playsFor	Real_Madrid_Castilla
Scott_McCulloch	playsFor	Airdrieonians_F.C._(1878)
Stockholm_Skavsta_Airport	isConnectedTo	Palma_de_Mallorca_Airport
Gary_Wales	playsFor	Green_Gully_SC
Paul_Reid_(footballer_born_1968)	playsFor	Afan_Lido_F.C.
Karl_Del'Haye	playsFor	Germany_national_football_team
Mark_Ovendale	wasBornIn	Leicester
Tampa_International_Airport	isConnectedTo	Detroit_Metropolitan_Wayne_County_Airport
Girona–Costa_Brava_Airport	isConnectedTo	Ireland_West_Airport_Knock
Júlio_César_(footballer,_born_January_1983)	playsFor	FC_Metalurh_Donetsk
Abeid_Amani_Karume_International_Airport	isConnectedTo	Brussels_Airport
Rubenilson_Monteiro_Ferreira	playsFor	Royal_Antwerp_F.C.
Éverton_Santos	playsFor	Fluminense_FC
Peter_Hattrup	playsFor	United_States_national_futsal_team
Óscar_Téllez	wasBornIn	Madrid
Vladimir_Chelomey	playsFor	FC_Vityaz_Podolsk
Mario_Martínez_Rubio	playsFor	Olympiakos_Nicosia
Calgary_International_Airport	isConnectedTo	Manchester_Airport
Zadar_Airport	isConnectedTo	Billund_Airport
Novak_Martinović	playsFor	FK_BSK_Borča
Artur_Yedigaryan	playsFor	FC_Banants
Gabriele_Puccio	wasBornIn	Milan
Dwight_D._Eisenhower	hasWonPrize	Order_of_Merit
Harry_Kane_(footballer)	playsFor	Norwich_City_F.C.
Moisés_Matias_de_Andrade	playsFor	Bangu_Atlético_Clube
Jakob_Poulsen	playsFor	SC_Heerenveen
Mateusz_Kowalski	playsFor	LKS_Nieciecza
Bledi_Shkëmbi	playsFor	HNK_Rijeka
Monastir_Habib_Bourguiba_International_Airport	isConnectedTo	Belgrade_Nikola_Tesla_Airport
Marvin_Braun	playsFor	VfL_Osnabrück
Marcin_Robak	playsFor	Piast_Gliwice
Milan_Vještica	playsFor	FC_Ural_Sverdlovsk_Oblast
Rüdiger_Abramczik	playsFor	Germany_national_football_team
Richard_Forsyth	playsFor	Stoke_City_F.C.
Adnan_Menderes_Airport	isConnectedTo	Bremen_Airport
Angelo_Carbone	playsFor	Ternana_Calcio
Jorge_Trezeguet	playsFor	Chacarita_Juniors
Aaron_Conway	playsFor	Dundee_F.C.
Colin_Cramb	playsFor	Bury_F.C.
Ray_Crawford_(footballer)	playsFor	England_national_football_team
Dion_Esajas	playsFor	FC_Lisse
Davide_Succi	playsFor	Calcio_Como
Ricardo_Sánchez_(footballer)	playsFor	Club_Tijuana
Patrick_Zoundi	playsFor	1._FC_Saarbrücken
International_Airport_Irkutsk	isConnectedTo	Osh_Airport
Foto_Strakosha	playsFor	Kallithea_F.C.
Cagliari_Elmas_Airport	isConnectedTo	Orly_Airport
Aloísio_dos_Santos_Gonçalves	playsFor	Figueirense_Futebol_Clube
Marel_Baldvinsson	playsFor	Stabæk_Fotball
Marcos_Antônio_de_Lima	playsFor	Grêmio_Esportivo_Novorizontino
Michael_Love_(footballer)	playsFor	Nuneaton_Town_F.C.
Keith_Robson	playsFor	Norwich_City_F.C.
Wayne_Gill	playsFor	Blackpool_F.C.
Dirk_Caspers	playsFor	Schwarz-Weiß_Essen
Ben_Brewster	playsFor	Tacoma_Tides
Janez_Zavrl_(footballer)	wasBornIn	Ljubljana
Iván_Moreno_y_Fabianesi	playsFor	Club_Atlético_Banfield
Aberdeen_Airport	isConnectedTo	Birmingham_Airport
Ante_Razov	playsFor	Sacramento_Scorpions
José_Moreno_Mora	playsFor	Club_Atlético_Independiente
Robert_Gaspar	playsFor	Sydney_Olympic_FC
Steve_MacLean_(footballer)	playsFor	Yeovil_Town_F.C.
Arnaldo_Edi_Lopes_da_Silva	playsFor	PAOK_FC
Włodzimierz_Lubański	playsFor	K.S.C._Lokeren_Oost-Vlaanderen
Steve_Mardenborough	wasBornIn	Birmingham
Chris_Day	playsFor	Crystal_Palace_F.C.
Johan_Elmander	playsFor	Örgryte_IS
Eino_Puri	playsFor	FC_Botoșani
Pedro_Pineda	playsFor	C.F._Pachuca
Göteborg_Landvetter_Airport	isConnectedTo	Málaga_Airport
Steve_Pittman	playsFor	Linlithgow_Rose_F.C.
Richard_Graham_(Northern_Ireland_footballer)	playsFor	Chesham_United_F.C.
Massamba_Sambou	playsFor	Troyes_AC
Konstantin_Golovskoy	playsFor	FC_Taraz
Ronnachai_Rangsiyo	playsFor	Everton_F.C.
Danny_Carlton	playsFor	Morecambe_F.C.
David_Mehew	playsFor	Leeds_United_A.F.C.
Nicky_Adams	playsFor	Crawley_Town_F.C.
Josimar_de_Carvalho_Ferreira	wasBornIn	Rio_de_Janeiro
Serhiy_Kryvtsov	playsFor	FC_Metalurh_Zaporizhya
Nabil_Baha	playsFor	Montpellier_HSC
Federico_Balzaretti	wasBornIn	Turin
Cristián_Canío	playsFor	Club_Universidad_de_Chile
Vaidas_Žutautas	playsFor	FK_Sūduva_Marijampolė
Christian_Rodrigo_Zurita	playsFor	Gaziantepspor
César_Peixoto	playsFor	Portugal_national_football_team
Adolfo_Baloncieri	playsFor	Italy_national_football_team
Siramana_Dembélé	playsFor	Olympique_Alès
Michel_Pineda	playsFor	Sporting_Toulon_Var
Aleksandr_Salugin	playsFor	PFC_CSKA_Moscow
Christian_Hanson_(footballer)	playsFor	Middlesbrough_F.C.
Valencia_Airport	isConnectedTo	Mohammed_V_International_Airport
Giacomo_Cipriani	playsFor	S.S.D._Piacenza_Calcio_1919
Dubai_International_Airport	isConnectedTo	Dnipropetrovsk_International_Airport
Dejan_Ognjanović	playsFor	ŁKS_Łódź
Tomáš_Belic	playsFor	FK_AS_Trenčín
Neville_Chamberlain_(footballer)	playsFor	Worksop_Town_F.C.
Seyfo_Soley	playsFor	Preston_North_End_F.C.
Flavio_Roma	playsFor	A.C._Chievo_Verona
Paul_Wright_(soccer)	playsFor	Philadelphia_KiXX
Leongino_Unzaim	playsFor	FC_Rouen
Birkir_Bjarnason	playsFor	Iceland_national_under-21_football_team
Jaroslav_Plašil	playsFor	FC_Girondins_de_Bordeaux
David_Thompson_(footballer_born_1977)	playsFor	Blackburn_Rovers_F.C.
Deividas_Česnauskis	playsFor	FC_Lokomotiv_Moscow
Antoine_Préget	playsFor	LB_Châteauroux
David_Healy_(footballer)	playsFor	Leeds_United_A.F.C.
Alex_Sandro	playsFor	Santos_FC
Winnipeg_James_Armstrong_Richardson_International_Airport	isConnectedTo	Los_Cabos_International_Airport
Demy_de_Zeeuw	playsFor	R.S.C._Anderlecht
Ernest_Rutherford	hasWonPrize	Order_of_Merit
Marco_Adaggio	playsFor	Rushall_Olympic_F.C.
Janusz_Michallik	wasBornIn	Chorzów
André_Marques	playsFor	Iraklis_Thessaloniki_F.C.
Kristian_Kojola	playsFor	Tampere_United
Sekou_Baradji	wasBornIn	Paris
José_Serrizuela	playsFor	Tiburones_Rojos_de_Veracruz
Georgios_Vakouftsis	playsFor	Ergotelis_F.C.
Pietro_Vierchowod	playsFor	S.S.D._Piacenza_Calcio_1919
Francesco_Bolzoni	playsFor	Italy_national_under-17_football_team
Víctor_Aquino	playsFor	Club_Atlético_Belgrano
George_Boyd_(footballer)	playsFor	Scotland_national_football_B_team
Chris_Marsden	playsFor	Stockport_County_F.C.
Leonardo_da_Vinci–Fiumicino_Airport	isConnectedTo	Belgrade_Nikola_Tesla_Airport
Samuel_Baños	playsFor	AD_Alcorcón
Mamadou_Doumbia	wasBornIn	Abidjan
Ervin_Fakaj	playsFor	CD_Toledo
Miguel_Aceval	playsFor	O'Higgins_F.C.
Milan_Blagojevic	playsFor	Australia_national_association_football_team
Aleksandr_Shmarko	playsFor	FC_Kuban_Krasnodar
Eduardo_Ramos_Martins	playsFor	Paysandu_Sport_Club
Nantes_Atlantique_Airport	isConnectedTo	Florence_Airport,_Peretola
Carl_Airey	playsFor	Torquay_United_F.C.
Danny_Crow	playsFor	Norwich_City_F.C.
Dudu_Georgescu	playsFor	FCM_Bacău
Adolfino_Cañete	playsFor	Club_River_Plate_(Asunción)
Bajram_Nebihi	playsFor	Zob_Ahan_Isfahan_F.C.
Mark_Gayle	playsFor	Rushall_Olympic_F.C.
Yannick_Bolasie	playsFor	Crystal_Palace_F.C.
Lilian_Compan	playsFor	US_Créteil-Lusitanos
Błażej_Radler	playsFor	Znicz_Pruszków
Emir_Hadžić	playsFor	NK_Čelik_Zenica
Nikola_Jozić	playsFor	FC_Gloria_Buzău
Bernard_Bosquier	playsFor	FC_Martigues
Marcel_Silva_Andrade	playsFor	Associação_Desportiva_São_Caetano
Kim_Yoo-jin_(footballer)	wasBornIn	Busan
Jaime_Bragança	playsFor	Odivelas_F.C.
Papiss_Cissé	playsFor	Newcastle_United_F.C.
Regillio_Nooitmeer	playsFor	Birkirkara_F.C.
Carsten_Keuler	playsFor	SSV_Jahn_Regensburg
Sissi_(footballer)	playsFor	Scunthorpe_United_F.C.
Junior_Ross	playsFor	Coronel_Bolognesi
Mehdi_Benatia	playsFor	Tours_FC
Sérgio_Manoel	playsFor	Ceará_Sporting_Club
Gilmar_Silva_Santos	playsFor	Tokyo_Verdy
Jim_Henry_(footballer_born_1975)	playsFor	Forfar_Athletic_F.C.
Lucas_Severino	playsFor	Clube_Atlético_Paranaense
Edgardo_Simovic	playsFor	Sociedad_Deportiva_Aucas
Karim_Kerkar	playsFor	Dubai_CSC
Sacramento_International_Airport	isConnectedTo	Portland_International_Airport
Dean_Walling	playsFor	Nuneaton_Town_F.C.
Germán_Pietrobon	playsFor	C.S._Marítimo
Aldo_Adorno	playsFor	Club_Sol_de_América
Sotiris_Leontiou	playsFor	Panathinaikos_F.C.
Bristol_Airport	isConnectedTo	Málaga_Airport
Giacomo_Cipriani	playsFor	A.C._Rimini_1912
Dimitar_Iliev_(footballer_born_1988)	wasBornIn	Plovdiv
David_Cabarcos	playsFor	Pontevedra_CF
Cássio_Vargas	wasBornIn	Porto_Alegre
Marius_Croitoru	playsFor	FC_Steaua_II_București
Mark_Burke	playsFor	FC_Rapid_București
Vladimir_Koman	playsFor	Hungary_national_under-19_football_team
Marco_Engelhardt	playsFor	FC_Rot-Weiß_Erfurt
Djerba–Zarzis_International_Airport	isConnectedTo	Charles_de_Gaulle_Airport
Adrián_Mahía	playsFor	Club_Atlético_Independiente
Cícero_Santos	playsFor	Figueirense_Futebol_Clube
Gilles_De_Bilde	playsFor	R.S.C._Anderlecht
Lee_Dong-won	playsFor	Busan_IPark
Dessie_Gorman	playsFor	Bangor_F.C.
Johannes_Ertl	playsFor	Crystal_Palace_F.C.
Igor_Nascimento_Soares	playsFor	Clube_Atlético_Paranaense
Steve_O'Shaughnessy_(footballer)	playsFor	Exeter_City_F.C.
José_Claudinei	playsFor	Goiás_Esporte_Clube
Joan_Verdú	playsFor	Deportivo_de_La_Coruña
Ernie_Hunt	playsFor	Swindon_Town_F.C.
Nery_Castillo	playsFor	C.F._Pachuca
Hürriyet_Gücer	playsFor	Eskişehirspor
Rafik_Halliche	playsFor	C.D._Nacional
Alexander_Ludwig_(footballer)	playsFor	Dynamo_Dresden
Daniel_Quinteros	playsFor	Beerschot_AC
Steve_Pantelidis	playsFor	Gold_Coast_United_FC
Greg_Shields	playsFor	Kilmarnock_F.C.
Nantes_Atlantique_Airport	isConnectedTo	Palma_de_Mallorca_Airport
Leipzig/Halle_Airport	isConnectedTo	Hurghada_International_Airport
Paulo_Assunção	playsFor	AEK_Athens_F.C.
Georgi_Kakalov_(footballer)	playsFor	Olympiakos_Nicosia
Errol_McFarlane	playsFor	North_East_Stars_F.C.
Shanghai_Pudong_International_Airport	isConnectedTo	Hefei_Xinqiao_International_Airport
Shigeyoshi_Mochizuki	playsFor	Shimizu_Commercial_High_School
John_Gayle_(footballer)	playsFor	Torquay_United_F.C.
Bobby_Collins_(footballer)	playsFor	Greenock_Morton_F.C.
Kenny_Lowe	playsFor	Hartlepool_United_F.C.
Gonzalo_García_García	playsFor	Real_Madrid_Castilla
Patrick_Pircher	playsFor	FC_Admira_Wacker_Mödling
Michał_Janota	playsFor	Go_Ahead_Eagles
Chien-Shiung_Wu	hasWonPrize	Wolf_Prize_in_Physics
Teco_(footballer)	playsFor	Associação_Atlética_Internacional_(Limeira)
Alberto_Regazzoni	playsFor	FC_Lugano
Kunming_Changshui_International_Airport	isConnectedTo	Shijiazhuang_Zhengding_International_Airport
Kunming_Changshui_International_Airport	isConnectedTo	Mandalay_International_Airport
Henry_León	playsFor	Universidad_Católica_del_Ecuador
Kenneth_Brylle_Larsen	playsFor	Lierse_S.K.
Roberto_Sosa_(footballer)	playsFor	Boca_Juniors
Brussels_Airport	isConnectedTo	Dubai_International_Airport
Liam_Ridgewell	playsFor	England_national_under-21_football_team
Jan_Vorel	playsFor	Aris_Limassol_F.C.
War_of_the_Fifth_Coalition	happenedIn	Poland
Catania–Fontanarossa_Airport	isConnectedTo	Venice_Marco_Polo_Airport
Xavier_Gravelaine	playsFor	Le_Havre_AC
Michael_Blackwood_(footballer)	playsFor	Aston_Villa_F.C.
Froylán_Ledezma	playsFor	FC_Augsburg
Arzu_(footballer)	playsFor	Real_Betis
Federico_Giampaolo	playsFor	Sorrento_Calcio
Francis_Crick	hasWonPrize	Nobel_Prize_in_Physiology_or_Medicine
Marcin_Folc	playsFor	Górnik_Wałbrzych
Răzvan_Pădurețu	wasBornIn	Bucharest
Rafael_Gordillo	playsFor	Real_Betis
Mário_Soares	hasWonPrize	Order_of_Liberty
Kazan_International_Airport	isConnectedTo	Heraklion_International_Airport
Kwon_Jung-hyuk	playsFor	Vaasan_Palloseura
Dmitriy_Kramarenko	playsFor	FC_Baltika_Kaliningrad
Timo_Gebhart	playsFor	Germany_national_youth_football_team
Nicky_Banger	playsFor	Andover_F.C.
Sergio_Bernardo_Almirón	playsFor	Empoli_F.C.
John_Sheridan_(footballer)	playsFor	Birmingham_City_F.C.
Second_Anglo-Dutch_War	happenedIn	Dutch_Republic
Thomaz_(footballer)	playsFor	Rio_Claro_Futebol_Clube
Peter_Lérant	playsFor	HNK_Rijeka
N'Dayi_Kalenga_(footballer_born_1978)	playsFor	Göztepe_S.K.
Aleh_Shkabara	playsFor	FC_Dynamo_Moscow
Michael_Connelly	hasWonPrize	Anthony_Awards
Samuel_Baños	playsFor	FinnPa
William_Júnior_Salles_de_Lima_Souza	playsFor	Fortaleza_Esporte_Clube
Samuele_Dalla_Bona	playsFor	Italy_national_under-21_football_team
Karl-Heinz_Schnellinger	wasBornIn	Düren
Paulo_Dinarte	playsFor	Portugal_national_under-20_football_team
Cláudio_Pitbull	wasBornIn	Porto_Alegre
Frank_Barton	playsFor	Hereford_United_F.C.
Neto_Baiano	playsFor	Mirassol_Futebol_Clube
Txiki_Begiristain	playsFor	Deportivo_de_La_Coruña
David_Vandenbossche	playsFor	Paris_FC
Alexander_III_of_Russia	hasWonPrize	Order_of_St._Vladimir
Jersey_Airport	isConnectedTo	East_Midlands_Airport
Mark_Hudson_(footballer,_born_1980)	playsFor	Middlesbrough_F.C.
Juan_Sebastián_Botero	playsFor	FC_Dallas
Julianne_Moore	playsFor	Portsmouth_F.C.
Leon_Jeanne	wasBornIn	Cardiff
Singapore	dealsWith	China
Vladimir_But	playsFor	SC_Freiburg
Thiago_Martins	playsFor	New_York_Red_Bulls
Branislav_Vukomanović	playsFor	Syrianska_FC
Papiss_Cissé	playsFor	AS_Douanes_(Dakar)
Ogün_Altıparmak	wasBornIn	Adapazarı
Frank_de_Boer	playsFor	Rangers_F.C.
João_do_Canto_e_Castro	playsFor	Heart_of_Midlothian_F.C.
Stephen_O'Flynn	playsFor	St_Patrick's_Athletic_F.C.
Narada_Bernard	playsFor	Bishop's_Stortford_F.C.
Thomas_Brdarić	playsFor	VfL_Wolfsburg
Pablo_de_Muner	playsFor	Deportivo_Merlo
Kiko_Ratón	playsFor	Orihuela_CF
Charles_de_Gaulle_Airport	isConnectedTo	O'Hare_International_Airport
Antonio_Pinilla	playsFor	FC_Barcelona_B
Ignacio_Ithurralde	playsFor	Rosario_Central
Radomir_Antić	playsFor	FK_Partizan
Kiril_Ivkov	playsFor	F.C._Etar
Andy_Lonergan	playsFor	Preston_North_End_F.C.
Matija_Matko	playsFor	HNK_Rijeka
Alan_Connell	playsFor	Bradford_City_A.F.C.
Toni_Koskela	playsFor	FC_KooTeePee
Yuri_Matveyev	playsFor	PFC_CSKA_Moscow
Sébastien_Bassong	wasBornIn	Paris
Sebastian_Mila	playsFor	ŁKS_Łódź
Claudio_Enría	playsFor	Club_Atlético_Belgrano
Alharbi_El_Jadeyaoui	playsFor	Angers_SCO
Brian_McGovern	wasBornIn	Dublin
Geneva_International_Airport	isConnectedTo	Minsk_National_Airport
Mati_Lember	playsFor	Nõmme_Kalju_FC
Abel_Aguilar	playsFor	Deportivo_de_La_Coruña
Diego_Martiñones	playsFor	Central_Español
Pablo_Pinillos_Caro	playsFor	Levante_UD
Wojciech_Trochim	playsFor	Zagłębie_Lubin
Ted_Lavie	playsFor	Angers_SCO
Richard_Socrier	playsFor	Angers_SCO
Kujtim_Shala	playsFor	VfR_Mannheim
Kamel_Ghilas	playsFor	Stade_de_Reims
Andrija_Kaluđerović	playsFor	FK_Spartak_Zlatibor_Voda
Jamie_Cureton	playsFor	Busan_IPark
Igor_Bogdanović	playsFor	Szombathelyi_Haladás
William_Viali	playsFor	A.C._Monza_Brianza_1912
Michele_Andreolo	wasBornIn	Montevideo
Ode_Thompson	playsFor	Lommel_United
Dalian_Zhoushuizi_International_Airport	isConnectedTo	Zhengzhou_Xinzheng_International_Airport
Nicola_Ventola	playsFor	Torino_F.C.
Diego_Serna	playsFor	Fort_Lauderdale_Strikers
Makadji_Boukar	playsFor	Nyíregyháza_Spartacus_FC
Ian_Stevens_(footballer)	playsFor	Wrexham_F.C.
Giuseppe_Scurto	playsFor	Unione_Triestina_2012_S.S.D.
Kristijan_Polovanec	wasBornIn	Zagreb
Dubravko_Pavličić	playsFor	Croatia_national_football_team
Jack_de_Gier	playsFor	Lierse_S.K.
Oļegs_Malašenoks	playsFor	FC_Jūrmala
Ervin_Fakaj	wasBornIn	Vlorë
Reza_Enayati	playsFor	F.C._Aboomoslem
Jardel_Pereira_de_Souza	playsFor	C.S._Marítimo
André_Strappe	playsFor	FC_Nantes
Oleg_Teryokhin	playsFor	FC_Sokol_Saratov
Paul_Koulibaly	playsFor	Burkina_Faso_national_football_team
Ricardo_Ribeiro_Fernandes	playsFor	Doxa_Katokopias_F.C.
Alain_Sutter	playsFor	BSC_Young_Boys
Miroslav_Kadlec	playsFor	1._FC_Kaiserslautern
Luigi_Sartor	playsFor	Italy_national_under-21_football_team
Eric_Davis_(footballer)	playsFor	Leeds_United_A.F.C.
Kevin_Strootman	playsFor	Netherlands_national_under-19_football_team
Marinko_Mačkić	playsFor	FK_Partizan
Franco_Foda	playsFor	Bayer_04_Leverkusen
Gabriele_Paonessa	wasBornIn	Bologna
Francisco_Antonio_Pavón	playsFor	BSV_Bad_Bleiberg
Francisco_Aguirre	playsFor	Aris_Limassol_F.C.
Atanas_Bornosuzov	playsFor	PFC_Levski_Sofia
Bima_Sakti	playsFor	PSM_Makassar
Steve_Fulton	playsFor	Celtic_F.C.
Garry_Haylock	playsFor	Shelbourne_F.C.
Vilnius_Airport	isConnectedTo	Palma_de_Mallorca_Airport
Sheremetyevo_International_Airport	isConnectedTo	Düsseldorf_Airport
Juan_Joya	playsFor	Peru_national_football_team
Adam_Kwasnik	playsFor	Manly_United_FC
Seol_Ki-hyeon	playsFor	Reading_F.C.
Darren_Sawatzky	playsFor	Charleston_Battery
Sani_Kaita	playsFor	Enyimba_International_F.C.
Marco_Quotschalla	playsFor	1._FC_Köln
Jerry_Best	playsFor	Newcastle_United_F.C.
Rüdiger_Abramczik	playsFor	Wormatia_Worms
Mick_Cooke_(football_manager)	playsFor	Republic_of_Ireland_national_under-19_football_team
Alexei_Savinov	playsFor	FC_Rapid_Ghidighici
Richard_Roelofsen	playsFor	PEC_Zwolle
Konstantin_Golovskoy	playsFor	FC_Tobol
Colin_Hoyle	playsFor	King's_Lynn_F.C.
Danny_Carlton	playsFor	Chester_F.C.
Monterrey_International_Airport	isConnectedTo	Los_Angeles_International_Airport
Marek_Czakon	playsFor	Næstved_BK
Pablo_Gabriel_García	playsFor	F.B.C._Unione_Venezia
Denis_Zubko	playsFor	FC_Baden
Jung_Jo-gook	playsFor	South_Korea_national_under-23_football_team
Brno–Tuřany_Airport	isConnectedTo	Heraklion_International_Airport
Selver_Hodžić	playsFor	FC_Lugano
Luciano_Henrique	playsFor	Clube_Atlético_Sorocaba
Robbie_Herrera	playsFor	Torquay_United_F.C.
Alhassane_Keita	playsFor	FC_Zürich
Kakhaber_Tskhadadze	playsFor	FC_Spartak_Moscow
Graham_Carr	playsFor	Bradford_Park_Avenue_A.F.C.
Ogün_Altıparmak	playsFor	Karşıyaka_S.K.
Eric_Obinna_Chukwunyelu	playsFor	AS_Saint-Étienne
Stefan_Maierhofer	playsFor	First_Vienna_FC
Răzvan_Cociș	playsFor	FC_Rostov
Miodrag_Anđelković	playsFor	FC_Irtysh_Pavlodar
Vali_Gasimov	playsFor	FC_Spartak_Moscow
Brian_Waltrip	playsFor	C.F._Os_Belenenses
Alfredo_Moreno	playsFor	San_Luis_F.C.
Eggert_Jónsson	playsFor	Iceland_national_under-17_football_team
Kevin_Schöneberg	playsFor	1._FC_Köln
Nicolás_Martínez_(Paraguayan_footballer)	playsFor	Tacuary
Paolo_Tramezzani	playsFor	Atalanta_B.C.
Pierre_Sinibaldi	playsFor	FC_Nantes
Chris_Weale	playsFor	Yeovil_Town_F.C.
Ely_Thadeu	playsFor	Betim_Esporte_Clube
Giuseppe_Iachini	playsFor	ACF_Fiorentina
Evando	playsFor	Avaí_Futebol_Clube
Adam_Cristman	playsFor	D.C._United
Shaun_Teale	playsFor	Northwich_Victoria_F.C.
Adi_Rocha	playsFor	Associação_Atlética_Internacional_(Limeira)
Scott_Partridge	wasBornIn	Leicester
Predrag_Jurić	playsFor	CP_Mérida
Frederick_the_Great	playsFor	São_Paulo_FC
Mike_Metcalf	playsFor	Altrincham_F.C.
Henk_Vos	playsFor	Beerschot_AC
Cristián_Ariel_Morales	playsFor	Tiburones_Rojos_de_Veracruz
Franco_Foda	playsFor	Arminia_Bielefeld
Catania–Fontanarossa_Airport	isConnectedTo	Leonardo_da_Vinci–Fiumicino_Airport
Keith_Briggs_(footballer)	playsFor	Norwich_City_F.C.
Ryan_Caugherty	playsFor	Boldklubben_1913
Shiraz_International_Airport	isConnectedTo	Tabriz_International_Airport
Tommy_Breen	wasBornIn	Drogheda
Nolberto_Solano	playsFor	Hartlepool_United_F.C.
Sergio_Órteman	playsFor	Central_Español
Peter_Läng	playsFor	Al-Nasr_S.C.S.C.
Brimah_Razak	playsFor	VfL_Wolfsburg
Nick_van_der_Velden	playsFor	FC_Dordrecht
Charles_de_Gaulle_Airport	isConnectedTo	Riga_International_Airport
Valter_Guchua	playsFor	FC_Dinamo_Tbilisi
Detinho	playsFor	Citizen_AA
Grigori_Perelman	wasBornIn	Saint_Petersburg
H._P._Lovecraft	hasWonPrize	Academy_Award_for_Best_Actor
Dumitru_Mitu	playsFor	HNK_Rijeka
Hundred_Days	happenedIn	German_Confederation
Andrea_Chiopris_Gori	playsFor	A.S.D._Portogruaro
Jimmy_Broad	playsFor	Greenock_Morton_F.C.
Herbert_Banks	playsFor	St._Mirren_F.C.
Sadat_Bukari	playsFor	Étoile_du_Sahel
Paul_Robinson_(footballer,_born_1984)	playsFor	Whitley_Bay_F.C.
Petar_Kolev_(footballer_born_1984)	playsFor	PFC_Neftochimic_Burgas
Oleh_Ostapenko	playsFor	FC_Vorskla_Poltava
Mickaël_Dogbé	playsFor	Grenoble_Foot_38
Yuri_Susloparov	wasBornIn	Kharkiv
Jorge_Wagner	playsFor	Real_Betis
Leipzig/Halle_Airport	isConnectedTo	Varna_Airport
Tyson_Wahl	playsFor	Montreal_Impact
Juan_Elía	playsFor	CA_Osasuna
Málaga_Airport	isConnectedTo	Düsseldorf_Airport
Álvaro_Peña	playsFor	The_Strongest
Mikhail_Kalashnikov	hasWonPrize	Order_of_Lenin
Girona–Costa_Brava_Airport	isConnectedTo	Billund_Airport
Radomir_Đalović	playsFor	NK_Zagreb
Marin_Skender	playsFor	NK_Zagreb
Dobrin_Orlovski	playsFor	FC_Spartak_Plovdiv
Mark_McNally_(footballer)	playsFor	Stoke_City_F.C.
Oleg_Șișchin	playsFor	FC_Olimpia_Bălți
Joselu	playsFor	Celta_de_Vigo_B
Piet_Keur	playsFor	AZ_Alkmaar
Barry_Ferguson_(Irish_footballer)	playsFor	Republic_of_Ireland_national_under-21_football_team
Plamen_Kolev	playsFor	OFC_Pomorie
Dudu_Georgescu	playsFor	FC_Progresul_București
Harrison_Omoko	playsFor	Nigeria_national_football_team
Dominik_Jakubek	playsFor	Columbus_Crew
Dermot_Keely	playsFor	Dundalk_F.C.
Marcelo_Bielsa	playsFor	Argentino_de_Rosario
Pablo_Caballero_Cáceres	playsFor	Club_Guaraní
Kieron_Dyer	playsFor	Queens_Park_Rangers_F.C.
Marco_Zamboni	playsFor	U.S._Lecce
Windsor_del_Llano	playsFor	The_Strongest
Joffre_Guerrón	playsFor	Ecuador_national_football_team
Yevgeni_Kharlachyov	playsFor	FC_Baltika_Kaliningrad
Kim_Falkenberg	playsFor	Germany_national_youth_football_team
Mark_Burke	playsFor	Luton_Town_F.C.
Bordeaux–Mérignac_Airport	isConnectedTo	Palma_de_Mallorca_Airport
Alain_Liri	playsFor	Tours_FC
Winnie_Haatrecht	wasBornIn	Paramaribo
Leo_Gibson	playsFor	Monrovia_Black_Star_Football_Club
Jocimar_Nascimento	playsFor	C.D._Motagua
Carlos_Navarro_Montoya	playsFor	Club_Atlético_Independiente
Steve_Wegerle	playsFor	New_York_Cosmos
Marcel_Silva_Andrade	playsFor	Resende_Futebol_Clube
Andrzej_Rudy	playsFor	1._FC_Köln
Domingos_Alexandre_Martins_Costa	playsFor	VfL_Wolfsburg
Andrea_Chiopris_Gori	playsFor	L'Aquila_Calcio_1927
Ben_Hinchliffe	playsFor	Derby_County_F.C.
Marcelo_Trobbiani	playsFor	Boca_Juniors
Raïs_M'Bolhi	playsFor	PFC_CSKA_Sofia
Dayro_Moreno	playsFor	Once_Caldas
Islam_El-Shater	playsFor	Zamalek_SC
Ivan_Artipoli	playsFor	Foggia_Calcio
Costinha	playsFor	Portugal_national_football_team
Graham_Coughlan	wasBornIn	Dublin
Jack_Elkes	playsFor	Middlesbrough_F.C.
Antonio_Núñez	wasBornIn	Madrid
Milton_Andrade_Vaz_Mendes	playsFor	Doxa_Katokopias_F.C.
Avi_Ivgi	playsFor	Hapoel_Petah_Tikva_F.C.
Mark_McChrystal	playsFor	Scunthorpe_United_F.C.
Paulo_Ricardo_Alves_da_Silva	playsFor	Sampaio_Corrêa_Futebol_Clube
Eren_Şen	playsFor	FC_St._Pauli
Ibrahim_Tall	playsFor	Senegal_national_football_team
Łukasz_Grzeszczyk	playsFor	Sandecja_Nowy_Sącz
Fa'a'ā_International_Airport	isConnectedTo	La_Tontouta_International_Airport
Onur_Tuncer	playsFor	Antalyaspor
César_La_Paglia	playsFor	Independiente_Medellín
Yervand_Krbachyan	playsFor	Armenia_national_football_team
Cam_Ranh_International_Airport	isConnectedTo	Perm_International_Airport
George_Blay	playsFor	Ghana_national_football_team
Gareth_Grant	playsFor	Farsley_Celtic_A.F.C.
Giovanni_van_Bronckhorst	playsFor	Rangers_F.C.
Giuseppe_Rossini	playsFor	Belgium_national_under-21_football_team
T._S._Eliot	hasWonPrize	Nobel_Prize_in_Literature
Dave_Langan	wasBornIn	Dublin
Carlos_Alberto_de_Jesus	playsFor	SV_Werder_Bremen
DaMarcus_Beasley	playsFor	Rangers_F.C.
Wayne_Bullimore	playsFor	Stockport_County_F.C.
David_Martin_(footballer_born_1986)	playsFor	Derby_County_F.C.
Jaime_Ruiz	playsFor	Irapuato_FC
War_of_the_First_Coalition	happenedIn	Republic_of_Venice
Amadou_Rabihou	playsFor	SK_Sturm_Graz
Mustapha_Carayol	playsFor	Middlesbrough_F.C.
Leonardo_Andrés_Iglesias	playsFor	Club_Atlético_Tigre
Tony_Bird_(footballer_born_1974)	playsFor	Bath_City_F.C.
Mohammed_El_Yaagoubi	playsFor	Morocco_national_football_team
Peter_Rufai	playsFor	K.S.K._Beveren
Fábio_Bahia	playsFor	Vila_Nova_Futebol_Clube
Gerhard_Progni	playsFor	Albania_national_under-19_football_team
Josip_Tadić	playsFor	Bayer_04_Leverkusen
Lee_Cook	playsFor	Watford_F.C.
Felipe_Nery_Franco	playsFor	Cúcuta_Deportivo
Steve_Fulton	playsFor	Kilmarnock_F.C.
Darren_Purse	playsFor	Port_Vale_F.C.
Bjørn_Tore_Kvarme	wasBornIn	Trondheim
Francisco_Jairo_Silva_Santos	playsFor	Figueirense_Futebol_Clube
Marcin_Wachowicz	playsFor	ŁKS_Łódź
Denis_Volodin	playsFor	FC_Vostok
Victor_Pony_Carr	playsFor	Szombathelyi_Haladás
Rwanda	dealsWith	Malaysia
Carlos_Pérez_García	playsFor	AD_Alcorcón
Alberto_Fontana_(footballer_born_1967)	playsFor	Atalanta_B.C.
Tosin_Dosunmu	playsFor	MVV_Maastricht
Kevin_Ellison_(footballer)	playsFor	Morecambe_F.C.
Emmanuel_Okoduwa	playsFor	FC_Arsenal_Kyiv
Ilie_Bărbulescu	playsFor	FC_Callatis_Mangalia
Vince_Grella	playsFor	Minnesota_Thunder
Harrison_Omoko	playsFor	FC_Volyn_Lutsk
Kenny_Brown_(footballer,_born_1967)	playsFor	Crystal_Palace_F.C.
Lorenzo_Amoruso	wasBornIn	Bari
Emir_Spahić	playsFor	Bayer_04_Leverkusen
Tancredo_Neves_International_Airport	isConnectedTo	Fortaleza
Balázs_Molnár	playsFor	Hungary_national_football_team
Sacramento_International_Airport	isConnectedTo	Philadelphia_International_Airport
Tümer_Metin	playsFor	Zonguldakspor
Marques_Batista_de_Abreu	playsFor	Sport_Club_Corinthians_Paulista
Jack_Palethorpe	playsFor	Stoke_City_F.C.
Antonio_Floro_Flores	wasBornIn	Naples
Suree_Sukha	playsFor	Buriram_United_F.C.
Pablo_Gaglianone	playsFor	Once_Caldas
Yahor_Zubovich	playsFor	FC_Partizan_Minsk
Kamloops_Airport	isConnectedTo	Calgary_International_Airport
Brigit_of_Kildare	playsFor	Stockport_County_F.C.
Givi_Kvaratskhelia	playsFor	FBK_Kaunas
Guillermo_Santo	wasBornIn	Lanús
Darius_Maciulevičius	playsFor	FC_Vilnius
Charles_Bunyan,_Sr.	playsFor	Heanor_Town_F.C.
Fiachra_McArdle	playsFor	Kildare_County_F.C.
Cafú_(footballer_born_1977)	playsFor	C.F._Os_Belenenses
Takashi_Hirano	playsFor	Japan_national_under-20_football_team
Vienna_International_Airport	isConnectedTo	Valencia_Airport
Paul_Bodin	playsFor	Reading_F.C.
Milan_Stojanoski	playsFor	Pegah_F.C.
Stephen_McPhee	playsFor	Port_Vale_F.C.
David_Healy_(footballer)	playsFor	Port_Vale_F.C.
Ray_Harford	playsFor	Romford_F.C.
Chris_Barker	playsFor	Stoke_City_F.C.
Leonardo_da_Vinci–Fiumicino_Airport	isConnectedTo	Nantes_Atlantique_Airport
Márkó_Futács	playsFor	Portsmouth_F.C.
Massimiliano_Cappioli	playsFor	Italy_national_football_team
Stephen_Elliott_(footballer)	playsFor	Preston_North_End_F.C.
Lukáš_Janič	playsFor	MFK_Košice
Håkan_Mild	playsFor	Wimbledon_F.C.
Alessandro_Gherardi	playsFor	Calcio_Lecco_1912
Edu_Albácar	playsFor	Gimnàstic_de_Tarragona
Bill_Williams_(footballer_born_1942)	playsFor	Durban_City_F.C._(1959)
Göteborg_City_Airport	isConnectedTo	Pisa_International_Airport
Bruno_Alicarte	playsFor	Deportivo_Alavés
Milton_Coimbra	playsFor	O'Higgins_F.C.
Václav_Havel	hasWonPrize	Order_of_Merit_of_the_Federal_Republic_of_Germany
Răzvan_Cociș	playsFor	FC_Politehnica_Timișoara
Ronald_Waterreus	playsFor	PSV_Eindhoven
John_Inglis_(footballer)	playsFor	Brechin_City_F.C.
Paul_Ritchie_(footballer_born_1975)	playsFor	AC_Omonia
Rui_Paulo_Silva_Júnior	playsFor	AEL_Limassol
Dubai_International_Airport	isConnectedTo	Incheon_International_Airport
Paulo_Pezzolano	wasBornIn	Montevideo
Los_Angeles_International_Airport	isConnectedTo	Brisbane_Airport
Riga_International_Airport	isConnectedTo	Leonardo_da_Vinci–Fiumicino_Airport
Marcelo_Carracedo	playsFor	Santos_Laguna
Gláucio_de_Jesus_Carvalho	playsFor	Al-Salmiya_SC
Souleymane_Oulare	playsFor	K.S.C._Lokeren_Oost-Vlaanderen
Jorge_Luiz_dos_Santos_Dias	playsFor	Clube_de_Regatas_Brasil
İbrahim_Aydemir	playsFor	VfB_Stuttgart_II
Luca_Tabbiani	playsFor	Calcio_Lecco_1912
Andrej_Komac	playsFor	Ruch_Chorzów
Shah_Amanat_International_Airport	isConnectedTo	Dubai_International_Airport
Fredrik_Stoor	playsFor	Sweden_national_football_team
Diego_Klimowicz	playsFor	Borussia_Dortmund
East_Midlands_Airport	isConnectedTo	Paphos_International_Airport
Adolf_Hütter	playsFor	Grazer_AK
Ürümqi_Diwopu_International_Airport	isConnectedTo	Shenzhen_Bao'an_International_Airport
Stuart_Wilson_(footballer)	playsFor	Nuneaton_Town_F.C.
Verona_Villafranca_Airport	isConnectedTo	Charles_de_Gaulle_Airport
Ahmed_al_Masli	playsFor	Stade_Tunisien
Ian_Stewart_(Northern_Ireland_footballer)	playsFor	Portsmouth_F.C.
Jinan_Yaoqiang_International_Airport	isConnectedTo	Dalian_Zhoushuizi_International_Airport
Tamás_Hajnal	playsFor	1._FC_Kaiserslautern
Marcus_Bent	playsFor	Crystal_Palace_F.C.
Derlis_Gómez	playsFor	Club_Sol_de_América
Aron_Wilford	playsFor	Middlesbrough_F.C.
Mauricio_Castro	playsFor	Club_Deportivo_Necaxa
Barcelona–El_Prat_Airport	isConnectedTo	Zurich_Airport
Lukas_Sinkiewicz	playsFor	Germany_national_youth_football_team
Roberto_Holsen	playsFor	Total_Chalaco
Paul_Henderson_(footballer)	playsFor	Manly_United_FC
Raman_Vasilyuk	playsFor	Belarus_national_football_team
Leonardo_Devanir_de_Paula	playsFor	Tupi_Football_Club
Carlos_Pedro_Silva_Morais	playsFor	Al_Ahli_SC_(Doha)
Vítor_Valente	playsFor	Associação_Académica_de_Coimbra_–_O.A.F.
Republic_of_Macedonia	dealsWith	Turkey
Michael_Sternkopf	playsFor	FC_Bayern_Munich
Oleg_Salenko	playsFor	Pogoń_Szczecin
Alberto_Rafael_da_Silva	playsFor	Betim_Esporte_Clube
Bruno_Simão	playsFor	F.C._Barreirense
Lee_Hendrie	playsFor	Chasetown_F.C.
Aleksandar_Sarić	playsFor	Varzim_S.C.
Ibad_Muhamadu	playsFor	FC_Twente
Said_Daftari	playsFor	Wuppertaler_SV
Aaron_Brown_(footballer_born_1980)	playsFor	Bath_City_F.C.
Stevie_Nicholas	playsFor	Northwich_Victoria_F.C.
Benny_Wendt	playsFor	Sweden_national_football_team
Andrew_Mangan	playsFor	Bury_F.C.
José_Manuel_Abundis	playsFor	C.F._Pachuca
Jacksonville_International_Airport	isConnectedTo	Denver_International_Airport
Valentine_Atem	playsFor	Neftchi_Baku_PFK
Dan_Counce	playsFor	Boston_Minutemen
Janne_Hietanen	playsFor	Vaasan_Palloseura
Ganiyu_Oseni	playsFor	Nigeria_national_football_team
Charles_de_Gaulle_Airport	isConnectedTo	East_Midlands_Airport
Júnior_César	playsFor	São_Paulo_FC
Zvezdan_Čebinac	playsFor	Yugoslavia_national_football_team
Pablo_Sánchez	playsFor	K.R.C._Zuid-West-Vlaanderen
Dan_Canter	playsFor	Minnesota_Strikers
Scott_McGarvey	playsFor	Aris_Limassol_F.C.
Adam_Grad	playsFor	ŁKS_Łódź
Emlyn_Hughes	playsFor	Blackpool_F.C.
Efstathios_Tavlaridis	playsFor	Iraklis_Thessaloniki_F.C.
Andrew_Julius	playsFor	Kingstonian_F.C.
Rafael_Dudamel	playsFor	Venezuela_national_football_team
Pisa_International_Airport	isConnectedTo	Liverpool_John_Lennon_Airport
Jacques_Lemée	playsFor	US_Orléans
Wolfgang_Rolff	playsFor	1._FC_Köln
Ned_Weir	playsFor	Republic_of_Ireland_national_football_team
Mike_Williamson_(footballer)	wasBornIn	Stoke-on-Trent
Andrea_Sottil	playsFor	Calcio_Catania
Ljubljana_Jože_Pučnik_Airport	isConnectedTo	Skopje_\u0022Alexander_the_Great\u0022_Airport
Baki_Mercimek	wasBornIn	Amsterdam
Mike_Walsh_(footballer)	playsFor	Norwich_City_F.C.
Mariano_Fernández_(footballer)	playsFor	Cosenza_Calcio
Danny_Mitchley	playsFor	Marine_F.C.
Daniel_Francis_(footballer)	playsFor	Aveley_F.C.
Marián_Sluka	playsFor	BFC_Siófok
Ruslan_Levyha	playsFor	FC_Sokol_Saratov
Philippe_Christanval	playsFor	Clairefontaine
Sergio_Rodríguez_García	playsFor	FC_Barcelona
Ritchie_Jones	playsFor	Hartlepool_United_F.C.
Alan_Kardec	playsFor	Santos_FC
Tore_André_Flo	playsFor	Tromsø_IL
Mark_Quayle	playsFor	Telford_United_F.C.
Pablo_Campos	wasBornIn	Rio_de_Janeiro
Subrahmanyan_Chandrasekhar	hasWonPrize	Copley_Medal
Fernando_Marqués	playsFor	Racing_de_Santander
Volkan_Kahraman	playsFor	First_Vienna_FC
Gustavo_Zapata	playsFor	Chacarita_Juniors
Diogo_Tavares	playsFor	Portugal_national_under-20_football_team
Hefei_Xinqiao_International_Airport	isConnectedTo	Shenyang_Taoxian_International_Airport
Vladimir_Voskoboinikov	playsFor	Syrianska_FC
Roy_McDonough	playsFor	Exeter_City_F.C.
Peter_Hetherston	playsFor	Raith_Rovers_F.C.
Alessandro_Pellicori	playsFor	Queens_Park_Rangers_F.C.
Dale_Tempest	playsFor	K.S.C._Lokeren_Oost-Vlaanderen
Grzegorz_Lewandowski	playsFor	Ruch_Wysokie_Mazowieckie
Massimo_Paganin	playsFor	ACF_Fiorentina
Volodymyr_Pyatenko	playsFor	FC_Vorskla_Poltava
Marco_Küntzel	playsFor	FC_Augsburg
John_Brownlie	playsFor	Blyth_Spartans_A.F.C.
Ajaccio_Napoleon_Bonaparte_Airport	isConnectedTo	Lyon–Saint_Exupéry_Airport
Kazan_International_Airport	isConnectedTo	Chelyabinsk_Airport
Pablo_Lavallén	playsFor	San_Luis_F.C.
Chemcedine_El_Araichi	playsFor	R.E._Mouscron
Lyon–Saint_Exupéry_Airport	isConnectedTo	Göteborg_Landvetter_Airport
Vidak_Bratić	playsFor	FC_St._Gallen
Đorđe_Pantić	playsFor	FK_Partizan
John_Deehan	playsFor	Norwich_City_F.C.
Bouchaib_El_Moubarki	playsFor	Grenoble_Foot_38
Liédson	playsFor	Sport_Club_Corinthians_Paulista
Gianluca_Falsini	playsFor	Calcio_Catania
Danny_Pena	playsFor	San_Francisco_Bay_Blackhawks
Frank_Jonke	playsFor	FF_Jaro
Luisa_de_Guzmán	playsFor	FK_Metalac
Kevin_Summerfield	playsFor	Birmingham_City_F.C.
Konstantin_Golovskoy	playsFor	FC_Spartak_Moscow
Cristiano_da_Silva_Santos	playsFor	Comercial_Futebol_Clube_(Ribeirão_Preto)
John_Matthews_(footballer)	playsFor	Chesterfield_F.C.
Nathan_Taylor_(footballer)	playsFor	Northwich_Victoria_F.C.
Keith_Bertschin	playsFor	Barnet_F.C.
Andy_Morrison	playsFor	Blackpool_F.C.
Julio_dos_Santos	playsFor	FC_Bayern_Munich
Ferdi_Elmas	wasBornIn	Amsterdam
Jorge_Alberto_Rojas	playsFor	Universidad_de_Los_Andes_FC
Radosav_Bulić	playsFor	FK_Radnički_Obrenovac
Aleksandr_Malygin	wasBornIn	Luhansk
Shah_Amanat_International_Airport	isConnectedTo	Shahjalal_International_Airport
Hubert_Robaszek	playsFor	Widzew_Łódź
Adelino_Batista_da_Silva_Neto	playsFor	Campinense_Clube
Mick_Harford	playsFor	Wimbledon_F.C.
Hugo_Fernández	playsFor	Club_de_Gimnasia_y_Esgrima_La_Plata
Marcelo_Ojeda	playsFor	Estudiantes_de_La_Plata
Juan_Sebastián_Botero	playsFor	Independiente_Medellín
Manuel_Neira	playsFor	Deportes_La_Serena
Mohammadou_Idrissou	playsFor	SV_Wehen_Wiesbaden
Hector_International_Airport	isConnectedTo	Denver_International_Airport
Dubai_International_Airport	isConnectedTo	Newcastle_Airport
Kalu_Uche	playsFor	Nigeria_national_football_team
Ikechukwu_Kalu	playsFor	Nigeria_national_football_team
Louis_Gabrillargues	playsFor	Nîmes_Olympique
Lars_Lunde	playsFor	Zug_94
Grégory_Arnolin	playsFor	Villemomble_Sports
Giovanni_Stroppa	playsFor	Italy_national_under-21_football_team
Adam_Straith	playsFor	SV_Wehen_Wiesbaden
Ibad_Muhamadu	playsFor	Cercle_Brugge_K.S.V.
José_Batista_Leite_da_Silva	playsFor	Operário_Ferroviário_Esporte_Clube
Valencia_Airport	isConnectedTo	Barcelona–El_Prat_Airport
Zé_Castro	wasBornIn	Coimbra
Pini_Balili	wasBornIn	Jerusalem
Joey_Godee	wasBornIn	Utrecht
Georgi_Adamia	playsFor	Baku_FC
Mariano_Gonzalvo	playsFor	CE_Europa
Adrian_Serioux	playsFor	Houston_Dynamo
Liam_Buckley	playsFor	Shelbourne_F.C.
Talal_Khalfan	playsFor	Najran_SC
Serhiy_Zakarlyuka	playsFor	FC_Arsenal_Kyiv
Marc_Mboua	playsFor	Telephonat_Beni_Suef_SC
Patrick_Baumann	playsFor	FC_Zürich
Miroslav_Sovič	playsFor	FK_Baumit_Jablonec
Alexander_Vladimirovich_Panov	playsFor	AS_Saint-Étienne
James_Obiorah	playsFor	Cádiz_CF
John_McCain	hasWonPrize	Silver_Star
Los_Angeles_International_Airport	isConnectedTo	The_Eastern_Iowa_Airport
Vladimirs_Babičevs	playsFor	FC_Torpedo-ZIL_Moscow
Ulises_de_la_Cruz	playsFor	Sociedad_Deportiva_Aucas
Shijiazhuang_Zhengding_International_Airport	isConnectedTo	Shenyang_Taoxian_International_Airport
Kagoshima_Airport	isConnectedTo	Shizuoka_Airport
Diarmuid_O'Carroll	playsFor	Ross_County_F.C.
Gabriel_Vochin	playsFor	F.C._Nazareth_Illit
Łukasz_Grzeszczyk	playsFor	Widzew_Łódź
Andrei_Stepanov_(footballer)	playsFor	FC_Torpedo_Moscow
Li_Hang_Wui	playsFor	Citizen_AA
Ákos_Füzi	playsFor	FC_Admira_Wacker_Mödling
Josip_Broz_Tito	hasWonPrize	Nishan-e-Pakistan
Dejan_Grabič	playsFor	NK_Ljubljana
Valencia_Airport	isConnectedTo	Treviso_Airport
Pierre-Alain_Frau	wasBornIn	Montbéliard
Cagliari_Elmas_Airport	isConnectedTo	Valencia_Airport
Jonas_De_Roeck	playsFor	Royal_Antwerp_F.C.
Paul_Jones_(footballer,_born_1978)	playsFor	Hyde_F.C.
José_Luis_Cuciuffo	playsFor	Boca_Juniors
Santi_Chaiyaphuak	playsFor	TOT_S.C.
Jorge_Pellegrini	playsFor	Club_Atlético_Independiente
Péguy_Luyindula	playsFor	New_York_Red_Bulls
Los_Angeles_International_Airport	isConnectedTo	Portland_International_Airport
Mark_Bell_(footballer)	playsFor	Heart_of_Midlothian_F.C.
Jairo_Castillo	playsFor	Atlético_Tucumán
Răzvan_Țârlea	playsFor	Gabala_FK
Carl_Andrew_Spaatz	hasWonPrize	Order_of_the_British_Empire
Juan_José_Bezares_Alarcón	playsFor	Cádiz_CF
Comodoro_Arturo_Merino_Benítez_International_Airport	isConnectedTo	Auckland_Airport
Fabinho_Capixaba	playsFor	Volta_Redonda_Futebol_Clube
Przemysław_Kaźmierczak	playsFor	Derby_County_F.C.
Dillon_Sheppard	playsFor	Platinum_Stars_F.C.
John_Steinbeck	playsFor	Australia_women's_national_association_football_team
Roberto_Holsen	playsFor	Juan_Aurich
Tomoyuki_Sakai	playsFor	Urawa_Red_Diamonds
DaMarcus_Beasley	playsFor	PSV_Eindhoven
Aleksandr_Dmitrijev	playsFor	Tallinna_Jalgpalliklubi
Jean_(footballer)	playsFor	Fluminense_FC
John_Roberts_(footballer_born_1946)	playsFor	Wrexham_F.C.
Leigh_Richmond_Roose	playsFor	Celtic_F.C.
Tenerife_South_Airport	isConnectedTo	Torp
Graeme_Lee_(footballer)	playsFor	Celtic_Nation_F.C.
Belgrade_Nikola_Tesla_Airport	isConnectedTo	Falcone–Borsellino_Airport
James_Scowcroft	playsFor	Leyton_Orient_F.C.
Travis_Dodd	playsFor	Australia_national_association_football_team
William_Prunier	playsFor	AJ_Auxerre
James_Wesolowski	wasBornIn	Sydney
Greater_Rochester_International_Airport	isConnectedTo	Tampa_International_Airport
Lee_Chapman	playsFor	England_national_under-21_football_team
Kuala_Lumpur_International_Airport	isConnectedTo	Ted_Stevens_Anchorage_International_Airport
Dan_Antoniuk	playsFor	Montreal_Impact
Daniele_Amerini	playsFor	F.B.C._Unione_Venezia
Paul_Barron	playsFor	Stoke_City_F.C.
Dimitrios_Grammozis	playsFor	Ergotelis_F.C.
Miloslav_Kousal	playsFor	FK_Baumit_Jablonec
Salvatore_Bocchetti	wasBornIn	Naples
Diego_Martiñones	playsFor	Tacuarembó_F.C.
Faryd_Mondragón	playsFor	Cerro_Porteño
Shiraz_International_Airport	isConnectedTo	Kish_International_Airport
Rocco_Sabato	playsFor	Cosenza_Calcio
Gilberto_Palacios	playsFor	Club_Deportivo_Universidad_Católica
Abdulrazak_Ekpoki	playsFor	Gimnàstic_de_Tarragona
Lorenzo_Melgarejo	playsFor	FC_Kuban_Krasnodar
Dennis_Lota	playsFor	Moroka_Swallows_F.C.
Baki_Mercimek	playsFor	SC_Telstar
Ernie_Blenkinsop	playsFor	Buxton_F.C.
Tomáš_Necid	playsFor	PFC_CSKA_Moscow
José_Galván	playsFor	Chacarita_Juniors
Bryan_Roy	wasBornIn	Amsterdam
Eduardo_Francisco_de_Silva_Neto	wasBornIn	Rio_de_Janeiro
Lúcio_Carlos_Cajueiro_Souza	playsFor	Sociedade_Esportiva_Palmeiras
Kevin_Watson	playsFor	Reading_F.C.
Thomas_Häßler	playsFor	1._FC_Köln
Isaac_Romo	playsFor	Querétaro_F.C.
Sercan_Güvenışık	playsFor	Denizlispor
Robbie_Winters	playsFor	Luton_Town_F.C.
Federico_Nieto	playsFor	Club_Atlético_Banfield
Edgar_Borges	playsFor	AS_Beauvais_Oise
Georgia_(country)	dealsWith	Turkey
Darius_Miceika	playsFor	FC_Zenit_Saint_Petersburg
Antonio_Nocerino	playsFor	Italy_national_under-20_football_team
Roy_O'Donovan	playsFor	Blackpool_F.C.
Fred_Jones_(footballer_born_1938)	playsFor	Hereford_United_F.C.
Tadas_Kijanskas	playsFor	Lithuania_national_football_team
Samuele_Dalla_Bona	playsFor	U.S._Lecce
Mario_Hieblinger	playsFor	Ergotelis_F.C.
Juan_Ramón_Fernández	playsFor	Borussia_Dortmund
Adam_Murray	wasBornIn	Birmingham
Kamil_Król	playsFor	KS_Polkowice
Salvatore_Masiello	wasBornIn	Naples
Alexandro_Alves_Ferreira	playsFor	Clube_Atlético_Juventus
Borislav_Mikhailov	playsFor	Bulgaria_national_football_team
Bert_Millard	wasBornIn	West_Bromwich
Lloyd_Opara	playsFor	Redbridge_F.C.
Gimhae_International_Airport	isConnectedTo	Jeju_International_Airport
Josef_Schneider_(footballer)	playsFor	Brooklyn_Hakoah
Rzeszów–Jasionka_Airport	isConnectedTo	Manchester_Airport
José_Clayton	playsFor	Étoile_du_Sahel
Skelley_Adu_Tutu	playsFor	Saba_Qom_F.C.
Wendel_Raul_Gonçalves_Gomes	playsFor	Guaratinguetá_Futebol
Jennison_Myrie-Williams	playsFor	Hereford_United_F.C.
Djamel_Mesbah	playsFor	FC_Aarau
Sylvano_Comvalius	playsFor	Birkirkara_F.C.
Exar_Rosales	playsFor	Unión_Huaral
Heinrich_Schönfeld	playsFor	Torino_F.C.
Mianyang_Nanjiao_Airport	isConnectedTo	Guiyang_Longdongbao_International_Airport
Michael_Agazzi	playsFor	Atalanta_B.C.
Incheon_International_Airport	isConnectedTo	Detroit_Metropolitan_Wayne_County_Airport
Andrei_Agius	playsFor	FK_Zemun
Stefano_Dall'Acqua	playsFor	A.C.D._Treviso_2013
Pisa_International_Airport	isConnectedTo	Barcelona–El_Prat_Airport
Palma_de_Mallorca_Airport	isConnectedTo	Gatwick_Airport
Ivan_Dragičević	playsFor	FK_Jagodina
Carsten_Jancker	playsFor	Udinese_Calcio
Mauricio_Castro	playsFor	F.C._Municipal_Valencia
Fergana_International_Airport	isConnectedTo	Kazan_International_Airport
James_Troisi	playsFor	Australia_national_association_football_team
Jackson_Mendy	playsFor	AJ_Auxerre
Fredy_Bareiro	playsFor	Club_León
Eliran_Elkayam	playsFor	Bnei_Yehuda_Tel_Aviv_F.C.
Dawid_Kucharski	playsFor	Poland_national_under-21_football_team
Steve_Book	playsFor	Tiverton_Town_F.C.
Gavin_Ward_(footballer)	playsFor	Gainsborough_Trinity_F.C.
Cristian_Săpunaru	playsFor	FC_Progresul_București
Daniele_Vantaggiato	playsFor	Torino_F.C.
Jesús_Rabanal	playsFor	Exeter_City_F.C.
Colin_Marshall_(footballer)	playsFor	Aston_Villa_F.C.
Wrocław–Copernicus_Airport	isConnectedTo	Charles_de_Gaulle_Airport
Stefano_Rossini	playsFor	U.S._Lecce
Austro-Prussian_War	happenedIn	Veneto
Jordan_Harvey	playsFor	Orange_County_Blue_Star
Guangzhou_Baiyun_International_Airport	isConnectedTo	Zhengzhou_Xinzheng_International_Airport
Darko_Djukič	wasBornIn	Ljubljana
Stephen_Dobbie	playsFor	Rangers_F.C.
Giovanni_Savarese	playsFor	New_York_Red_Bulls
Foeke_Booy	playsFor	SC_Cambuur
Chūbu_Centrair_International_Airport	isConnectedTo	Kuala_Lumpur_International_Airport
Pisa_International_Airport	isConnectedTo	Göteborg_City_Airport
Carlos_Castro_Borja	playsFor	Grazer_AK
Teresina_Airport	isConnectedTo	Santa_Genoveva_Airport
Ovidiu_Burcă	playsFor	Beijing_Guoan_F.C.
Bradley_International_Airport	isConnectedTo	Raleigh–Durham_International_Airport
Daniel_Marín	playsFor	Elche_CF
Shaun_Lowther	playsFor	Blyth_Spartans_A.F.C.
Mario_Gavranović	playsFor	Switzerland_national_under-19_football_team
Bonaventure_Kalou	playsFor	SC_Heerenveen
Gennady_Tumilovich	playsFor	FC_Dinamo_Brest
Hugo_Colace_(footballer)	playsFor	Estudiantes_de_La_Plata
Daniel_Theorin	playsFor	Gefle_IF
Víctor_Herrera_Piggott	playsFor	Sevilla_FC_Puerto_Rico
Moacir_Rodrigues_Santos	playsFor	Sport_Club_Corinthians_Paulista
Alyaksandr_Sulima	playsFor	FC_Neman_Grodno
Adrian_Ilie	playsFor	Deportivo_Alavés
Nathan_Koo-Boothe	playsFor	CD_Castellón
Reinaldo_Elias_da_Costa	playsFor	Operário_Ferroviário_Esporte_Clube
Floyd_Ayité	playsFor	Togo_national_football_team
Cristian_Stellini	playsFor	Novara_Calcio
Derek_Ferguson	playsFor	Raith_Rovers_F.C.
Euloge_Ahodikpe	playsFor	Diósgyőri_VTK
Kevin_Volland	playsFor	TSV_1860_München
Chris_Dangerfield	playsFor	California_Surf
Änis_Ben-Hatira	playsFor	Tunisia_national_football_team
Jonas_Salley	playsFor	Gold_Coast_United_FC
Mark_Boyd_(footballer)	playsFor	Workington_A.F.C.
Libya	dealsWith	Germany
Rory_Prendergast	playsFor	Goole_A.F.C.
Fernando_Macedo_da_Silva	playsFor	Cádiz_CF
Aliyudin_Ali	playsFor	Persikota_Tangerang
Gilberto_William_Fabbro	playsFor	Clube_Atlético_Paranaense
José_Aurelio_Gay	playsFor	Real_Madrid_Castilla
Lars_Leese	playsFor	Bayer_04_Leverkusen
Dubai_International_Airport	isConnectedTo	Kazan_International_Airport
Guangzhou_Baiyun_International_Airport	isConnectedTo	Sheremetyevo_International_Airport
Murcia–San_Javier_Airport	isConnectedTo	Blackpool_International_Airport
Dean_Leacock	playsFor	Leyton_Orient_F.C.
Mark_Burchill	playsFor	Dundee_F.C.
Alessandro_Faria	playsFor	Clube_15_de_Novembro
Edgars_Gauračs	playsFor	FC_Sheriff_Tiraspol
Derek_Statham	playsFor	Telford_United_F.C.
Neil_Pointon	playsFor	Hednesford_Town_F.C.
Eren_Şen	playsFor	1._FC_Magdeburg
John_Gregory_(footballer)	playsFor	Derby_County_F.C.
Mohammed_Sylla	playsFor	Le_Havre_AC
Bob_Bonthron	playsFor	Birmingham_City_F.C.
Nick_Platnauer	wasBornIn	Leicester
Mark_Docherty	playsFor	St._Mirren_F.C.
Heather_Mitts	wasBornIn	Cincinnati
Chris_Coleman_(footballer)	playsFor	Swansea_City_A.F.C.
Válber_Mendes_Ferreira	playsFor	Avaí_Futebol_Clube
Álvaro_Peña	playsFor	Bolivia_national_football_team
Ramón_Calderé	playsFor	RSD_Alcalá
Francisco_Valmerino_Neri	wasBornIn	Rio_de_Janeiro
Leongino_Unzaim	playsFor	FC_Girondins_de_Bordeaux
Enfidha_–_Hammamet_International_Airport	isConnectedTo	East_Midlands_Airport
David_Quiroz	playsFor	Ecuador_national_football_team
Micky_Evans	playsFor	Stourbridge_F.C.
Robin_Hulbert	playsFor	Port_Vale_F.C.
Sílvio_Carlos_de_Oliveira	playsFor	Santos_FC
Emmanuel_Krontiris	playsFor	SpVgg_Unterhaching
Celestine_Babayaro	playsFor	Newcastle_United_F.C.
César_Valoyes	playsFor	Independiente_Santa_Fe
Derek_McInnes	playsFor	Stockport_County_F.C.
Milan_Zahálka	playsFor	U.S._Poggibonsi
Kari_Ukkonen	playsFor	K.S.C._Lokeren_Oost-Vlaanderen
Jason_Minett	playsFor	Stocksbridge_Park_Steels_F.C.
Fousseni_Diawara	wasBornIn	Paris
Hernán_Crespo	playsFor	Argentina_national_under-23_football_team
Guy_Madjo	playsFor	Crawley_Town_F.C.
Stan_Fazackerley	playsFor	Derby_County_F.C.
Aco_Stojkov	playsFor	Debreceni_VSC
Irakli_Modebadze	playsFor	FC_Dinamo_Tbilisi
André_Luciano_da_Silva	playsFor	Al_Ahli_Club_(Dubai)
Kevin_McKeown	playsFor	Crusaders_F.C.
Raadhika_Sarathkumar	playsFor	Shrewsbury_Town_F.C.
Babis_Stefanidis	playsFor	Sweden_national_football_team
Ljubo_Miličević	playsFor	Australia_national_association_football_team
Nelson_Cuevas	playsFor	Sportivo_Luqueño
István_Ferenczi	playsFor	VfL_Osnabrück
Carl_Airey	playsFor	Bradford_City_A.F.C.
Jorge_Pellegrini	playsFor	Instituto_Atlético_Central_Córdoba
Ciro_De_Cesare	playsFor	Frosinone_Calcio
Cristian_Longobardi	playsFor	A.C._Bellaria_Igea_Marina
Krzysztof_Pilarz	playsFor	Korona_Kielce
Ivica_Jozić	playsFor	BV_Cloppenburg
Peter_Thorne_(footballer)	playsFor	Stoke_City_F.C.
Shanghai_Pudong_International_Airport	isConnectedTo	Nanchang_Changbei_International_Airport
Yevgeni_Smertin	playsFor	FC_Dynamo_Moscow
Dieudonné_Kalulika	playsFor	Lommel_United
Carlos_Roberto_de_Carvalho	playsFor	Fluminense_FC
László_Köteles	playsFor	FK_Grafičar_Beograd
Bruno_Ferraz_das_Neves	playsFor	Porto_Alegre_Futebol_Clube
Nuremberg_Airport	isConnectedTo	Palma_de_Mallorca_Airport
César_Carranza	playsFor	Club_Atlético_Nueva_Chicago
Tommy_Gaynor	playsFor	Athlone_Town_A.F.C.
Aleksandar_Živković_(footballer_born_1912)	playsFor	Croatia_national_football_team
Mauricio_Ramos	playsFor	New_England_Revolution
Francisco_Lojacono	playsFor	Club_de_Gimnasia_y_Esgrima_La_Plata
Andrey_Paryvaew	playsFor	Belarus_national_football_team
Montréal–Pierre_Elliott_Trudeau_International_Airport	isConnectedTo	Lyon–Saint_Exupéry_Airport
Lyman_Lemnitzer	hasWonPrize	Legion_of_Merit
David_Caldwell_(footballer)	playsFor	Swindon_Town_F.C.
José_Carlos_Fernández_(Bolivian_footballer)	playsFor	Club_Universitario
Giuseppe_Rossi	playsFor	Manchester_United_F.C.
Álvaro_Negredo	playsFor	Rayo_Vallecano
Harold_Keith_Johnson	hasWonPrize	National_Defense_Service_Medal
Alan_Davies_(footballer)	playsFor	Newcastle_United_F.C.
Serhiy_Husyev	playsFor	CS_Tiligul-Tiras_Tiraspol
Cristian_Zenoni	playsFor	Atalanta_B.C.
Abdoulay_Konko	playsFor	Sevilla_FC
Corentin_Martins	playsFor	Deportivo_de_La_Coruña
Federico_Peluso	playsFor	Atalanta_B.C.
Mark_Morris_(footballer_born_1962)	playsFor	Wimbledon_F.C.
Ian_McKellen	hasWonPrize	Annie_Award
Teruaki_Kurobe	playsFor	Avispa_Fukuoka
Kermit_Erasmus	playsFor	South_Africa_national_football_team
Luís_Alberto_Silva_dos_Santos	playsFor	C.D._Nacional
Douglas_Fairbanks,_Jr.	hasWonPrize	Silver_Star
Enco_Malindi	wasBornIn	Tirana
Düsseldorf_Airport	isConnectedTo	Birmingham_Airport
David_Ridler	playsFor	Leigh_Genesis_F.C.
Enfidha_–_Hammamet_International_Airport	isConnectedTo	Nantes_Atlantique_Airport
Raleigh–Durham_International_Airport	isConnectedTo	Lambert–St._Louis_International_Airport
Alex_Downie_(footballer)	playsFor	Manchester_United_F.C.
Denis_Popov	playsFor	PFC_CSKA_Moscow
Dimitar_Rangelov	playsFor	FC_Erzgebirge_Aue
Razak_Boukari	playsFor	LB_Châteauroux
Luis_Rodas	playsFor	F.C._Municipal_Valencia
Vincenzo_Italiano	playsFor	A.C._Chievo_Verona
Mohammad_Reza_Mahdavi	playsFor	Bahman_F.C.
Adam_Straith	wasBornIn	Victoria,_British_Columbia
Charles_de_Gaulle_Airport	isConnectedTo	Bremen_Airport
Costel_Mozacu	playsFor	FC_Petrolul_Ploiești
Francesco_Antonioli	playsFor	Italy_national_under-21_football_team
Ray_Harford	playsFor	Port_Vale_F.C.
Salvatore_Foti	playsFor	Italy_national_under-17_football_team
Matt_Green_(footballer)	playsFor	Birmingham_City_F.C.
Federico_Balzaretti	playsFor	U.S._Città_di_Palermo
Balázs_Rabóczki	playsFor	SV_Austria_Salzburg
Paul_Smith_(footballer_born_22_January_1976)	playsFor	Hartlepool_United_F.C.
Ardian_Kozniku	playsFor	Le_Havre_AC
Zoltán_Végh	playsFor	Hungary_national_football_team
Ian_Wilson_(footballer_born_1958)	playsFor	Everton_F.C.
Shanghai_Pudong_International_Airport	isConnectedTo	Zhanjiang_Airport
Shenzhen_Bao'an_International_Airport	isConnectedTo	Kuala_Lumpur_International_Airport
Mike_Conroy_(footballer_born_1965)	playsFor	Blackpool_F.C.
Stefán_Gíslason	playsFor	Grazer_AK
Paul_Hymans	hasWonPrize	Order_of_Vasa
Amílton_Jesus_dos_Santos	playsFor	Esporte_Clube_Democrata
Theo_Janssen	playsFor	K.R.C._Genk
Gary_Charles	playsFor	England_national_under-21_football_team
Skopje_\u0022Alexander_the_Great\u0022_Airport	isConnectedTo	Leonardo_da_Vinci–Fiumicino_Airport
Ricky_George	playsFor	Hereford_United_F.C.
Wilfried_Domoraud	playsFor	Weymouth_F.C.
Martin_Dimov_(footballer_born_1986)	playsFor	PFC_Botev_Plovdiv
Izzy_Iriekpen	playsFor	Leyton_Orient_F.C.
Nigel_Martyn	playsFor	Leeds_United_A.F.C.
Richard_Hodgson	playsFor	Blyth_Spartans_A.F.C.
Victor_Weisskopf	hasWonPrize	National_Medal_of_Science
Bjørnar_Holmvik	wasBornIn	Oslo
Fort_Lauderdale–Hollywood_International_Airport	isConnectedTo	Jacksonville_International_Airport
Derek_Niven	playsFor	Buxton_F.C.
Željko_Ljubenović	playsFor	OFK_Mladenovac
Gunter_Van_Handenhoven	playsFor	Belgium_national_under-21_football_team
Zvartnots_International_Airport	isConnectedTo	Surgut_International_Airport
Orly_Airport	isConnectedTo	Palma_de_Mallorca_Airport
Rachid_Rokki	playsFor	Fath_Union_Sport
Arnold_Dwarika	playsFor	East_Fife_F.C.
Shenyang_Taoxian_International_Airport	isConnectedTo	Zhengzhou_Xinzheng_International_Airport
Romik_Khachatryan	playsFor	FC_Banants
Rodney_Rowe	playsFor	Wakefield_F.C.
Cristian_Zaccardo	playsFor	U.S._Città_di_Palermo
Marcin_Robak	playsFor	Mersin_İdmanyurdu_SK
Mihăiță_Pleșan	playsFor	CS_Universitatea_Craiova_(football)
Evandro_Goebel	playsFor	Sociedade_Esportiva_Palmeiras
Gocha_Khojava	playsFor	Georgia_national_under-17_football_team
Stefan_Beinlich	playsFor	Aston_Villa_F.C.
Tony_Taylor_(footballer)	playsFor	Crystal_Palace_F.C.
Valentin_Filatov	playsFor	FC_Zenit_Saint_Petersburg
Raïs_M'Bolhi	wasBornIn	Paris
Igor_Dobrovolski	playsFor	Soviet_Union_national_football_team
César_Sampaio	playsFor	Santos_FC
Hasan_Gültang	playsFor	Mersin_İdmanyurdu_SK
Anderson_Alves_da_Silva	playsFor	Adap_Galo_Maringá_Football_Club
Peter_Ward_(footballer_born_1955)	playsFor	Vancouver_Whitecaps_(1974–84)
Aleh_Shkabara	playsFor	FC_Ural_Sverdlovsk_Oblast
Jonny_Hayes	wasBornIn	Dublin
Montréal–Pierre_Elliott_Trudeau_International_Airport	isConnectedTo	O'Hare_International_Airport
Nathaniel_Chalobah	wasBornIn	Freetown
Federico_Fellini_International_Airport	isConnectedTo	Tolmachevo_Airport
Adrián_Chávez	playsFor	Club_América
Neto_(footballer)	playsFor	Sport_Club_Corinthians_Paulista
Jeanne_Moreau	hasWonPrize	European_Film_Awards
So_Yiu_Man	playsFor	Eastern_AA
Ljubiša_Vukelja	playsFor	FK_Partizan
Vitaliy_Hoshkoderya	playsFor	Ukraine_national_under-18_football_team
Patrick_Ianni	playsFor	Houston_Dynamo
Dave_Gilbert_(footballer)	playsFor	Grantham_Town_F.C.
Tommy_Casey	playsFor	Leeds_United_A.F.C.
Niklas_Sandberg	playsFor	Sweden_national_football_team
Dramane_Coulibaly	playsFor	Nîmes_Olympique
Aminu_Sani	playsFor	Atalanta_B.C.
Ricardo_Vaz_Tê	playsFor	FK_Rīga
Narada_Bernard	playsFor	Torquay_United_F.C.
Detinho	playsFor	S.C._Campomaiorense
Terry_McDermott	playsFor	England_national_football_team
Nir_Nachum	playsFor	Bnei_Yehuda_Tel_Aviv_F.C.
Emil_Dică	playsFor	FC_Astana
Nenad_Vanić	playsFor	Albacete_Balompié
Incheon_International_Airport	isConnectedTo	Macau_International_Airport
Jürgen_Röber	playsFor	FC_Bayern_Munich
Incheon_International_Airport	isConnectedTo	Sydney_Airport
Alex_Pineda_Chacón	playsFor	New_England_Revolution
Junivan_Soares_de_Melo	playsFor	Turan-T_IK
Júlio_César_(footballer,_born_1963)	playsFor	Montpellier_HSC
Andrea_Silenzi	playsFor	Nottingham_Forest_F.C.
William_Maxwell_(footballer)	playsFor	Third_Lanark_A.C.
Davit_Bolkvadze	playsFor	FC_Metalurgi_Rustavi
Sieb_Dijkstra	playsFor	Queens_Park_Rangers_F.C.
Niki_Cross	playsFor	FC_Bayern_Munich_(women)
Tibor_Montvai	playsFor	Zalaegerszegi_TE
Éldis_Fernando_Damasio	playsFor	Associação_Desportiva_São_Caetano
Andriy_Novak	playsFor	FC_Karpaty-2_Lviv
Cristián_Suárez	playsFor	Chile_national_under-20_football_team
Republic_of_Macedonia	dealsWith	Kosovo
Barcelona–El_Prat_Airport	isConnectedTo	Nuremberg_Airport
Mihail_Venkov	playsFor	PFC_Litex_Lovech
Richard_Johnson_(footballer)	playsFor	Stoke_City_F.C.
Oleksiy_Cherednyk	playsFor	FC_Metalurh_Zaporizhya
Croatia	dealsWith	Slovenia
Admir_Aganović	playsFor	FK_Dinamo_Vranje
Viktor_Prokopenko	playsFor	FC_Krystal_Kherson
José_Antônio_Martins_Galvão	playsFor	Vila_Nova_Futebol_Clube
Rocco_Quinn	playsFor	Queen_of_the_South_F.C.
Igor_Simutenkov	playsFor	FC_Dynamo_Moscow
Ramón_Rodrigo_de_Freitas	wasBornIn	Belo_Horizonte
Martin_Petráš	playsFor	A.C.D._Treviso_2013
Abdullahi_Ishaka	playsFor	Shkumbini_Peqin
Martin_Aldridge	playsFor	Blackpool_F.C.
Rubén_González_Rocha	playsFor	Real_Madrid_Castilla
Mark_Bridge	playsFor	Australia_national_under-20_association_football_team
Everton_Costa	playsFor	Adap_Galo_Maringá_Football_Club
Diogo_Lézico_da_Silva	playsFor	FC_Gloria_Buzău
Jerzy_Brzęczek	playsFor	SK_Sturm_Graz
Nicolae_Constantin	playsFor	FC_Rapid_București
Richie_Williams	playsFor	United_States_men's_national_under-23_soccer_team
Oladapo_Olufemi	playsFor	Plateau_United_F.C.
Anapa_Airport	isConnectedTo	Kazan_International_Airport
Olivier_Dacourt	wasBornIn	Montreuil,_Seine-Saint-Denis
Luis_Carrero_Blanco	playsFor	Boston_Bulldogs_(soccer)
Ahmad_Momenzadeh	playsFor	Aluminium_Hormozgan_F.C.
Dušan_Đokić	playsFor	FK_Obilić
Scott_Bevan	playsFor	Ayr_United_F.C.
Steve_Laurie	playsFor	Oakleigh_Cannons_FC
Gabriele_Cioffi	playsFor	Torino_F.C.
Mohammed_Aliyu_Datti	playsFor	Ravenna_F.C.
Eimantas_Poderis	playsFor	FBK_Kaunas
János_Kovács	playsFor	BFC_Siófok
Jackie_Mooney	playsFor	Manchester_United_F.C.
Petr_Samec	playsFor	FC_Hradec_Králové
Fábio_Felício	playsFor	Rio_Ave_F.C.
André_Wetzel	playsFor	HFC_Haarlem
Ademar_Aparecido_Xavier_Júnior	playsFor	Londrina_Esporte_Clube
Miroslav_Stoch	playsFor	FC_Twente
Andy_O'Brien_(footballer)	playsFor	Portsmouth_F.C.
André_Leone	playsFor	Goiás_Esporte_Clube
Efraín_Herrera	playsFor	C.F._Pachuca
Paul_Brayson	playsFor	Northwich_Victoria_F.C.
Jerel_Ifil	playsFor	Watford_F.C.
Tommy_Spencer	playsFor	Celtic_F.C.
El_Salvador	dealsWith	China
Andrea_Poli	playsFor	A.C.D._Treviso_2013
Nolberto_Solano	playsFor	Aston_Villa_F.C.
Claude_Parfait_Ngon_A_Djam	playsFor	Skonto_FC
Ragnvald_Soma	playsFor	Lyngby_Boldklub
Edgar_Villamarín	playsFor	Peru_national_football_team
Alberto_Antônio_de_Paula	playsFor	Clube_Atlético_Hermann_Aichinger
Igors_Sļesarčuks	playsFor	Skonto_FC
Almaty_International_Airport	isConnectedTo	Kazan_International_Airport
Tomislav_Mišura	playsFor	NK_Kamen_Ingrad
José_Antonio_Castro	playsFor	Estudiantes_Tecos
Leonardo_Biagini	playsFor	CP_Mérida
Claudio_Gentile	playsFor	ACF_Fiorentina
Verona_Villafranca_Airport	isConnectedTo	Skiathos_Island_National_Airport
Ernest_Libérati	wasBornIn	Oran
Dan_Eggen	wasBornIn	Oslo
Graham_Mitchell_(English_footballer)	playsFor	Farsley_Celtic_A.F.C.
Joe_Devine	playsFor	Queens_Park_Rangers_F.C.
Daniele_Galloppa	playsFor	Italy_national_under-18_football_team
Sinan_Kaloğlu	playsFor	Kayseri_Erciyesspor
József_Dzurják	playsFor	Békéscsaba_1912_Előre_SE
Princess_Sophie_Antoinette_of_Brunswick-Wolfenbüttel	playsFor	Club_Atlético_Nueva_Chicago
David_Jones_(footballer_born_1984)	playsFor	Blackburn_Rovers_F.C.
Javi_Ruiz	playsFor	FC_Barcelona_B
Domenico_Morfeo	playsFor	Atalanta_B.C.
Clint_Marcelle	playsFor	Goole_A.F.C.
Michael_Connelly	hasWonPrize	Grand_Prix_de_Littérature_Policière
Alyaksandr_Oreshnikow	playsFor	FC_Neftekhimik_Nizhnekamsk
Jean-Philippe_Mendy	playsFor	NK_Maribor
Richard_Harris	wasBornIn	Limerick
Amin_Motevaselzadeh	playsFor	Pegah_F.C.
Sarajevo_International_Airport	isConnectedTo	Zagreb_Airport
Mwanza_Airport	isConnectedTo	Abeid_Amani_Karume_International_Airport
Aurélien_Collin	playsFor	Wrexham_F.C.
Andrej_Komac	playsFor	C.S._Marítimo
Gareth_Farrelly	wasBornIn	Dublin
Bernardo_Corradi	playsFor	Udinese_Calcio
Andre_McCollin	playsFor	Kingstonian_F.C.
Joe_Kendrick,_Jr.	playsFor	TSV_1860_München
Jeremy_Hall_(soccer)	playsFor	New_York_Red_Bulls
Adnan_Menderes_Airport	isConnectedTo	Lyon–Saint_Exupéry_Airport
Željko_Milinovič	playsFor	NK_Ljubljana
David_Pereira_da_Costa	playsFor	Atlético_Clube_de_Portugal
Iorlando_Pereira_Marques_Filho	playsFor	Avaí_Futebol_Clube
Franz_Joseph_I_of_Austria	hasWonPrize	Order_of_the_Black_Eagle
Pedro_Pineda	playsFor	Mexico_national_football_team
Julianne_Moore	playsFor	Eastleigh_F.C.
Ilian_Kiriakov	playsFor	F.C._Etar
Uwe_Rahn	playsFor	1._FC_Köln
David_Speedie	playsFor	Hendon_F.C.
Alan_Lee_(footballer)	playsFor	Aston_Villa_F.C.
Martin_O'Connor_(footballer)	playsFor	Shrewsbury_Town_F.C.
Venice_Marco_Polo_Airport	isConnectedTo	Geneva_International_Airport
Kevin_Sanasy	wasBornIn	Leeds
Ânderson_Lima	playsFor	Santos_FC
Jason_McAteer	playsFor	Blackburn_Rovers_F.C.
Adriano_Barbosa_Miranda_da_Luz	playsFor	Al-Arabi_SC_(Kuwait)
Steve_Bowey	playsFor	Bedlington_Terriers_F.C.
Sergio_Rodríguez_García	playsFor	FC_Spartak_Moscow
Shenzhen_Bao'an_International_Airport	isConnectedTo	Zhanjiang_Airport
Fred_Carreiro	playsFor	D.C._United
Juan_Arango	playsFor	C.F._Pachuca
Nassim_Banouas	playsFor	1._FC_Kaiserslautern
Samuel_Yeboah	playsFor	Ghana_national_football_team
Brad_Davis_(soccer)	playsFor	Houston_Dynamo
Martin_Amedick	playsFor	Arminia_Bielefeld
Willy_Sagnol	playsFor	FC_Bayern_Munich
Bristol_Airport	isConnectedTo	Girona–Costa_Brava_Airport
Cílio_André_Souza	playsFor	Goiás_Esporte_Clube
Kily_González	playsFor	Argentina_national_under-23_football_team
Zahari_Sirakov	playsFor	PFC_Levski_Sofia
Júnior_Negrão	playsFor	Beerschot_AC
Menno_Willems	wasBornIn	Amsterdam
Bill_Brown_(English_footballer)	playsFor	Dunstable_Town_F.C.
Vladimir_Chelomey	hasWonPrize	Order_of_Lenin
Thomas_Richter_(footballer_born_1970)	playsFor	Stuttgarter_Kickers
La_Rochelle_–_Île_de_Ré_Airport	isConnectedTo	East_Midlands_Airport
Sebastián_Nayar	playsFor	Aldosivi
Rinaldo_Francisco_de_Lima	wasBornIn	Recife
Mathias_Christen	playsFor	FC_Gossau
Alan_Hutton	playsFor	Rangers_F.C.
Daniel_Jungwirth	playsFor	FC_Ingolstadt_04
Jill_Oakes	playsFor	Vancouver_Whitecaps_FC_(women)
Diego_Tardelli	playsFor	Associação_Desportiva_São_Caetano
Christian_Callejas	wasBornIn	Montevideo
Élie_Kroupi	playsFor	Nîmes_Olympique
Steven_Masterton	playsFor	Kilmarnock_F.C.
Cameron_Watson_(footballer)	playsFor	Australia_national_under-17_association_football_team
Bernd_Patzke	playsFor	TSV_1860_München
David_Mendes_da_Silva	playsFor	Panathinaikos_F.C.
Yusuke_Kato	playsFor	Defensores_de_Belgrano
Enfidha_–_Hammamet_International_Airport	isConnectedTo	Košice_International_Airport
Joey_Kirk	playsFor	California_Kickers
Neale_Cooper	playsFor	Ross_County_F.C.
Andrey_Popoviç	playsFor	FC_Metalurh_Donetsk
Akande_Ajide	playsFor	F.B.C._Unione_Venezia
João_da_Rocha_Ribeiro	wasBornIn	Porto
Federico_Agliardi	playsFor	Bologna_F.C._1909
Suat_Türker	playsFor	SC_Freiburg
Mark_Hudson_(footballer,_born_1980)	playsFor	Chesterfield_F.C.
Catania–Fontanarossa_Airport	isConnectedTo	Zurich_Airport
Luís_Filipe_(Portuguese_footballer)	playsFor	Associação_Académica_de_Coimbra_–_O.A.F.
Vladimir_Voskoboinikov	playsFor	FC_Dinamo_Tbilisi
Treviso_Airport	isConnectedTo	Catania–Fontanarossa_Airport
Yip_Chi_Ho	playsFor	Yokohama_FC_Hong_Kong
Chris_Day	playsFor	Queens_Park_Rangers_F.C.
Pablo_Sánchez	playsFor	Feyenoord
Marcin_Folc	playsFor	Widzew_Łódź
Terry_Conroy	wasBornIn	Dublin
Dennis_Viollet	playsFor	England_national_football_team
Jean-Marc_Furlan	playsFor	FC_Girondins_de_Bordeaux
Chu_Siu_Kei	playsFor	Shatin_SA
Walter_Martínez_(footballer)	playsFor	Deportivo_Alavés
Governor_Francisco_Gabrielli_International_Airport	isConnectedTo	Ministro_Pistarini_International_Airport
Marquinhos_Paraná	playsFor	Avaí_Futebol_Clube
Theodor_Brinek,_Jr.	playsFor	Queensland_Lions_FC
Ion_Dumitru	playsFor	FC_Rapid_București
Magno_Vieira	playsFor	Crawley_Town_F.C.
Incheon_International_Airport	isConnectedTo	Shizuoka_Airport
Robert_Hopkins_(footballer)	playsFor	Birmingham_City_F.C.
Neil_Barrett_(footballer)	playsFor	Havant_&_Waterlooville_F.C.
Lounès_Gaouaoui	playsFor	WA_Tlemcen
Ade_Coker	playsFor	New_York_Arrows
Fort_Lauderdale–Hollywood_International_Airport	isConnectedTo	Buffalo_Niagara_International_Airport
Leung_Chi_Wing	playsFor	Kitchee_SC
Harry_Kewell	wasBornIn	Sydney
Alexandre_Luiz_Fernandes	playsFor	Avaí_Futebol_Clube
George_Friend	playsFor	Tiverton_Town_F.C.
Gabriel_Wüthrich	playsFor	FC_Lugano
Lee_Phillips_(footballer_born_1980)	playsFor	Exeter_City_F.C.
László_Köteles	playsFor	Dunakanyar-Vác_FC
Léo_Inácio	playsFor	Villa_Nova_Atlético_Clube
Mihail_Makowski	playsFor	Belarus_national_football_team
Jeff_Saibene	playsFor	FC_Aarau
José_Alfredo_Castillo	playsFor	Estudiantes_Tecos
Daniel_Sikorski	playsFor	Wisła_Kraków
Giovanni_Invernizzi_(footballer_born_1931)	playsFor	F.B.C._Unione_Venezia
Ray_Hankin	playsFor	Vancouver_Whitecaps_(1974–84)
Park_Chu-young	playsFor	South_Korea_national_football_team
Aluísio_da_Silva_Neves_Júnior	playsFor	Paysandu_Sport_Club
Diallo_Guidileye	playsFor	LB_Châteauroux
Milen_Radukanov	playsFor	Kastoria_F.C.
Owen_Madden_(footballer)	playsFor	Republic_of_Ireland_national_football_team
Battle_of_Lepanto	happenedIn	Papal_States
Paul_Stewart_(footballer_born_1964)	playsFor	Blackpool_F.C.
Shaun_Harrad	playsFor	Alfreton_Town_F.C.
Oliver_Cuadrado_Martín	playsFor	Real_Madrid_C.F.
Terry_Cochrane	playsFor	Eastern_AA
Aleksandar_Živković_(footballer_born_1977)	playsFor	FK_Partizan
Pascal_Borel	playsFor	RB_Leipzig
Tony_Scully	playsFor	Exeter_City_F.C.
Comodoro_Arturo_Merino_Benítez_International_Airport	isConnectedTo	El_Dorado_International_Airport
Newcastle_Airport	isConnectedTo	Lanzarote_Airport
Juanfran_(footballer,_born_1976)	playsFor	Levante_UD
Giovanni_Franken	playsFor	Feyenoord
Jozef_Majoroš	playsFor	FK_Drnovice
Cafuringa	playsFor	Bangu_Atlético_Clube
Albert_Pape	playsFor	Nelson_F.C.
Caetano_Calil	playsFor	A.S._Varese_1910
Mark_Lillis	playsFor	Stockport_County_F.C.
Bojan_Jorgačević	playsFor	Kayseri_Erciyesspor
Giovanni_Sio	playsFor	FC_Augsburg
Siniša_Janković	playsFor	Empoli_F.C.
Walter_Guglielmone	playsFor	Neftchi_Baku_PFK
Adriano_Barbosa_Miranda_da_Luz	playsFor	Cape_Verde_national_football_team
Roger_Nilsen	playsFor	1._FC_Köln
Bradley_International_Airport	isConnectedTo	Montréal–Pierre_Elliott_Trudeau_International_Airport
Nathan_Delfouneso	playsFor	Aston_Villa_F.C.
Jan_Koprivec	playsFor	Udinese_Calcio
Rafael_Jacques	playsFor	Canoas_Sport_Club
Vlatko_Marković	playsFor	Wiener_Sport-Club
Diego_Serna	playsFor	New_England_Revolution
Bülent_Ertuğrul	playsFor	Eskişehirspor
James_Obiorah	playsFor	Nigeria_national_football_team
Fa'a'ā_International_Airport	isConnectedTo	Charles_de_Gaulle_Airport
Wilson_Constantino_Novo_Estrela	playsFor	Angola_national_football_team
Fuat_Usta	wasBornIn	Samsun
Hamlet_Mkhitaryan	playsFor	FC_Ararat_Yerevan
Chukki_Eribenne	playsFor	Hinckley_United_F.C.
Aleksandr_Mostovoi	playsFor	FC_Spartak_Moscow
Kevin_Nicol	playsFor	Peterhead_F.C.
Diego_Capel	playsFor	Sevilla_FC
Frantz_Bertin	wasBornIn	Paris
Koltsovo_Airport	isConnectedTo	Tivat_Airport
Juan_Carlos_Chávez	playsFor	Mexico_national_football_team
Hakim_Saci	wasBornIn	Saint-Denis
Luis_Moreno_(footballer)	playsFor	Independiente_Santa_Fe
Ben_Alnwick	playsFor	England_national_under-17_football_team
Perm_International_Airport	isConnectedTo	Corfu_International_Airport
Theodor_Reimann	playsFor	1._FC_Tatran_Prešov
Sean_Murdoch	playsFor	Heart_of_Midlothian_F.C.
Ramón_Calderé	playsFor	Real_Betis
Taras_Ilnytskyi	playsFor	FC_Enerhetyk_Burshtyn
Michael_Lumb_(footballer)	playsFor	FC_Zenit_Saint_Petersburg
Craig_Davies_(footballer)	playsFor	Port_Vale_F.C.
Bobby_Russell_(footballer)	playsFor	Rangers_F.C.
Todor_Kolev_(footballer_born_1980)	playsFor	F.C._Etar
Bradley_International_Airport	isConnectedTo	Fort_Lauderdale–Hollywood_International_Airport
Marino_Defendi	playsFor	Italy_national_under-19_football_team
Allisson_Ricardo	playsFor	Sport_Club_Corinthians_Paulista
Iván_Alonso	playsFor	Club_Nacional_de_Football
Clarence_R._Huebner	hasWonPrize	Czechoslovak_War_Cross
Geoff_Horsfield	playsFor	Port_Vale_F.C.
João_Tomás	playsFor	Al_Sharjah_SC
Danny_Sonner	playsFor	Wrexham_F.C.
Khrabrovo_Airport	isConnectedTo	Minsk_National_Airport
Santa_Genoveva_Airport	isConnectedTo	Leite_Lopes_Airport
Vitali_Kutuzov	playsFor	Belarus_national_football_team
Oleksandr_Sevidov	playsFor	FC_Torpedo_Moscow
Palma_de_Mallorca_Airport	isConnectedTo	Nantes_Atlantique_Airport
Johnny_Haynes	playsFor	England_national_football_team
Johnny_Fullam	playsFor	Home_Farm_F.C.
Evan_Horwood	playsFor	Scunthorpe_United_F.C.
Gelson_Fernandes	playsFor	SC_Freiburg
Jair_García	playsFor	Cruz_Azul_Hidalgo
Pierluigi_Brivio	wasBornIn	Milan
Justin_Walker_(footballer)	playsFor	Ilkeston_F.C.
Adrián_Berbia	wasBornIn	Montevideo
Derek_Boateng	wasBornIn	Accra
Ronald_Raldes	playsFor	Rosario_Central
Héctor_Rodríguez_Peña	playsFor	Everton_de_Viña_del_Mar
Tony_Loska	playsFor	Stafford_Rangers_F.C.
Boulia_Airport	isConnectedTo	Bedourie_Airport
Massimo_Zappino	playsFor	Calcio_Como
Dionysius_Sebwe	playsFor	Minnesota_Thunder
Admir_Mehmedi	playsFor	Switzerland_national_under-19_football_team
Rade_Đokić	playsFor	SV_Ried
Justin_Fashanu	playsFor	Nottingham_Forest_F.C.
Kim_Pan-keun	playsFor	South_Korea_national_football_team
Peter_Beadle	playsFor	Port_Vale_F.C.
Michael_Essien	playsFor	Ghana_national_football_team
Dave_Mackay	playsFor	Derby_County_F.C.
Nino_Bule	playsFor	Croatia_national_football_team
Julianne_Moore	hasWonPrize	Independent_Spirit_Award_for_Best_Female_Lead
Araz_Abdullayev	wasBornIn	Baku
Robert_Hosie	playsFor	New_York_Field_Club
Phil_Stant	playsFor	Hinckley_United_F.C.
Carlos_Roberto_de_Carvalho	playsFor	Bangu_Atlético_Clube
Adis_Nurković	playsFor	NK_Čelik_Zenica
Charles_de_Gaulle_Airport	isConnectedTo	Los_Angeles_International_Airport
Richard_Logan_(footballer_born_1982)	playsFor	Torquay_United_F.C.
Federico_Nieto	playsFor	Barcelona_Sporting_Club
Rudis_Corrales	playsFor	C.D._Municipal_Limeño
Russell_Coughlin	playsFor	Swansea_City_A.F.C.
Hamdan_Al-Bishi	playsFor	Empoli_F.C.
Enrique_Wolff	playsFor	Real_Madrid_C.F.
Michal_Vorel	playsFor	SK_Sparta_Krč
David_Rocastle	playsFor	Leeds_United_A.F.C.
Steven_Kinniburgh	playsFor	Queen_of_the_South_F.C.
Natashquan_Airport	isConnectedTo	Québec_City_Jean_Lesage_International_Airport
Pálmi_Rafn_Pálmason	playsFor	Stabæk_Fotball
Nikolay_Pavlov_(footballer)	playsFor	PFC_Botev_Plovdiv
Akron–Canton_Airport	isConnectedTo	Philadelphia_International_Airport
Jóan_Símun_Edmundsson	playsFor	FC_Fredericia
Nii_Lamptey	playsFor	F.B.C._Unione_Venezia
Luke_Foster	playsFor	Alfreton_Town_F.C.
Richie_Purdy	wasBornIn	Dublin
Henrik_Larsen	playsFor	A.C._Pisa_1909
Paul_Bodin	playsFor	Crystal_Palace_F.C.
Paul_Hall_(footballer)	playsFor	Portsmouth_F.C.
Yaser_Yıldız	playsFor	Galatasaray_S.K.
Lai_Yiu_Cheong	playsFor	Tuen_Mun_SA
Dalian_Zhoushuizi_International_Airport	isConnectedTo	Nanchang_Changbei_International_Airport
Patrick_Battiston	playsFor	FC_Girondins_de_Bordeaux
Hervé_Kage	playsFor	Belgium_national_under-21_football_team
Alessandro_Beti_Rosa	playsFor	Sport_Club_do_Recife
Alex_Downie_(footballer)	playsFor	Swindon_Town_F.C.
Lars_Jacobsen	playsFor	Everton_F.C.
Hyun_Young-min	playsFor	South_Korea_national_football_team
Richard_Witschge	playsFor	FC_Barcelona
Amos_Mariani	playsFor	Empoli_F.C.
Sebastián_Eguren	playsFor	Montevideo_Wanderers_F.C.
Scott_McLaughlin_(footballer)	playsFor	Ayr_United_F.C.
Gabriel_Christoni_Leite	playsFor	Esporte_Clube_São_Bento
Ezechiel_N'Douassel	playsFor	FC_Terek_Grozny
Arkadiusz_Kubik	playsFor	Royal_Antwerp_F.C.
Beihai_Fucheng_Airport	isConnectedTo	Chongqing_Jiangbei_International_Airport
Saulo_Squarsone_Rodrigues_dos_Santos	playsFor	Esporte_Clube_Santo_André
Sharbel_Touma	playsFor	Iraklis_Thessaloniki_F.C.
Tibor_Selymes	playsFor	Debreceni_VSC
Miroslav_Kadlec	playsFor	FK_Drnovice
Dan_Stratford	playsFor	D.C._United
Sergei_Bendz	playsFor	FC_Rostov
Aleksandr_Shvetsov	playsFor	FC_Dynamo_Moscow
Jean_Beausejour	playsFor	O'Higgins_F.C.
José_Altafini	playsFor	Italy_national_football_team
Niall_Thompson	playsFor	Airdrieonians_F.C._(1878)
David_Button	playsFor	Shrewsbury_Town_F.C.
Belgrade_Nikola_Tesla_Airport	isConnectedTo	Catania–Fontanarossa_Airport
Yibin_Caiba_Airport	isConnectedTo	Hangzhou_Xiaoshan_International_Airport
Andrade_Antunes_Anderson	playsFor	Yokohama_FC
Alexander_III_of_Russia	hasWonPrize	Order_of_St._George
Siobhan_Chamberlain	playsFor	Vancouver_Whitecaps_FC_(women)
Arnar_Viðarsson	playsFor	Cercle_Brugge_K.S.V.
Strahil_Popov	playsFor	PFC_Litex_Lovech
Brian_Green_(footballer)	playsFor	Altrincham_F.C.
Mirko_Taccola	playsFor	F.C._Maia
Howard_Pritchard	playsFor	Yeovil_Town_F.C.
Otis_Roberts	playsFor	Barnet_F.C.
Mehmet_Batdal	playsFor	Altay_S.K.
Gabby_Gabreski	hasWonPrize	Silver_Star
Anselmo_Robbiati	playsFor	ACF_Fiorentina
Roland_Goriupp	playsFor	SK_Sturm_Graz
Vladyslav_Vashchuk	wasBornIn	Kiev
Anel_Džaka	playsFor	VfL_Osnabrück
Phil_Jackson_Ibarguen_Sanchez	playsFor	FK_Sloboda_Tuzla
Jos_Hooiveld	playsFor	PEC_Zwolle
Jésus_Sinisterra	playsFor	Arminia_Bielefeld
Miljan_Mrdaković	playsFor	Tampines_Rovers_FC
Jerzy_Podbrożny	playsFor	CD_Toledo
Andrejs_Prohorenkovs	playsFor	FC_Jūrmala
Benjamin_Imeh	playsFor	Polonia_Warsaw
Slaviša_Jokanović	playsFor	Deportivo_de_La_Coruña
Tom_Wilcox	playsFor	Blackpool_F.C.
Marko_Ilić	playsFor	PFC_Beroe_Stara_Zagora
Blake_Wagner	playsFor	United_States_men's_national_under-23_soccer_team
Antonio_Alzamendi	playsFor	Club_Nacional_de_Football
Vakhtang_Khvadagiani	wasBornIn	Tbilisi
George_Leandro_Abreu_de_Lima	playsFor	Associação_Desportiva_São_Caetano
Joe-Max_Moore	playsFor	New_England_Revolution
Baba_Adamu	playsFor	Ghana_national_football_team
Danny_Califf	playsFor	United_States_men's_national_under-17_soccer_team
Ivan_Bandalovski	playsFor	Bulgaria_national_football_team
Mark_Stein_(footballer)	playsFor	Luton_Town_F.C.
Alessandro_Bruno	playsFor	Benevento_Calcio
Amin_Motevaselzadeh	playsFor	PAS_Hamedan_F.C.
Nikolay_Shirshov	playsFor	FC_Rostov
Luís_Andrade	playsFor	Portugal_national_under-20_football_team
Pavel_Pogrebnyak	playsFor	FC_Baltika_Kaliningrad
Manuel_Martínez_(footballer)	playsFor	Club_León
Gary_Megson	playsFor	Nottingham_Forest_F.C.
Dadá_Maravilha	playsFor	Associação_Atlética_Ponte_Preta
Adrian_Madaschi	playsFor	A.S.D._Portogruaro
Monsef_Zerka	playsFor	Tanjong_Pagar_United_FC
Uğur_Yıldırım	playsFor	Gaziantepspor
Joan_Verdú	playsFor	FC_Barcelona_B
Perico_(Spanish_footballer)	playsFor	Elche_CF
Allan_Pearce	playsFor	Worksop_Town_F.C.
Riccardo_Colombo	playsFor	Torino_F.C.
Gabriel_Christoni_Leite	playsFor	Operário_Ferroviário_Esporte_Clube
Peter_Desmond	playsFor	Republic_of_Ireland_national_football_team
Damir_Šutevski	playsFor	Toronto_Blizzard_(1971–84)
Jun_Marques_Davidson	playsFor	Tokushima_Vortis
Sardar_Vallabhbhai_Patel_International_Airport	isConnectedTo	Pune_Airport
Luca_Lacrimini	playsFor	S.S._Chieti_Calcio
Gary_Hamilton_(footballer_born_1980)	playsFor	Raufoss_IL
Juanda_International_Airport	isConnectedTo	Kuala_Lumpur_International_Airport
Nanchang_Changbei_International_Airport	isConnectedTo	Guiyang_Longdongbao_International_Airport
Michał_Janota	playsFor	Feyenoord
Ismaël_Béko_Fofana	wasBornIn	Abidjan
José_Luis_Pochettino	playsFor	Aldosivi
Tomáš_Pešír	playsFor	Czech_Republic_national_under-21_football_team
Phil_Kite	playsFor	Stockport_County_F.C.
Jonathan_Forte	playsFor	Scunthorpe_United_F.C.
Jacob_Timpano	playsFor	Sydney_FC
James_Chambers_(English_footballer)	playsFor	Hereford_United_F.C.
Gabriel_de_Paulo_Limeira	playsFor	Malmö_FF
Walter_Nahún_López	playsFor	Cobán_Imperial
Barry_Cogan_(footballer)	playsFor	Crawley_Town_F.C.
Łukasz_Tumicz	playsFor	KS_Polkowice
Herbert_Burdenski	playsFor	SV_Werder_Bremen
Saša_Ćirić	playsFor	FC_Aarau
Jimmy_McCormick	playsFor	Sliema_Wanderers_F.C.
Dawda_Bah	playsFor	FC_Augsburg
Amadou_Konte	playsFor	Kalamata_F.C.
Aleksandr_Sheshukov	playsFor	FC_Rostov
Caleb_Folan	playsFor	Leeds_United_A.F.C.
Johnny_Ekström	playsFor	Dynamo_Dresden
German_Confederation	hasCapital	Frankfurt
Brussels_Airport	isConnectedTo	Valencia_Airport
Edward_Witten	hasWonPrize	Dannie_Heineman_Prize_for_Mathematical_Physics
Dušan_Brković	playsFor	Serbia_national_under-19_football_team
Paul_McGee_(footballer_born_1954)	playsFor	Athlone_Town_A.F.C.
Djibouti–Ambouli_International_Airport	isConnectedTo	Jomo_Kenyatta_International_Airport
Paulo_Assunção	playsFor	Sociedade_Esportiva_Palmeiras
Mick_Cooke_(football_manager)	playsFor	St_Patrick's_Athletic_F.C.
Frankie_Hejduk	playsFor	United_States_men's_national_under-23_soccer_team
Primož_Gliha	playsFor	Yokohama_Flügels
Lee_Roche_(Irish_footballer)	playsFor	Shelbourne_F.C.
Migjen_Basha	playsFor	A.C._Rimini_1912
Peter_Fear	playsFor	Sutton_United_F.C.
Roy_Contout	playsFor	Amiens_SC
Gary_Birch	wasBornIn	Birmingham
Hasim_Đoković	playsFor	FK_Budućnost_Podgorica
Bedourie_Airport	isConnectedTo	Boulia_Airport
Rafael_Scheidt	playsFor	Celtic_F.C.
Dean_Holdsworth	playsFor	Wimbledon_F.C.
Iván_Helguera	playsFor	Racing_de_Santander_B
Rubén_Capria	playsFor	Barcelona_Sporting_Club
Brussels_Airport	isConnectedTo	Mohammed_V_International_Airport
Grand_Duke_Konstantin_Nikolayevich_of_Russia	hasWonPrize	Order_of_St._George
Leandro_de_Oliveira_da_Luz	playsFor	Associação_Atlética_Ponte_Preta
Issawa_Singthong	playsFor	TDCS_Dong_Thap_F.C.
Newcastle_Airport	isConnectedTo	Varna_Airport
Paul_I_of_Russia	hasWonPrize	Order_of_St._Andrew
Sidney_Moraes	playsFor	Esporte_Clube_Santo_André
Luboš_Kubík	playsFor	Czechoslovakia_national_football_team
Pekka_Lagerblom	playsFor	FSV_Frankfurt
Martin_Gardner	wasBornIn	Tulsa,_Oklahoma
Eduard_Sergienko	playsFor	FC_Shakhter_Karagandy
Fabián_Estay	playsFor	C.F._Atlante
Matt_Carmichael_(footballer)	playsFor	Basingstoke_Town_F.C.
Mick_O'Brien_(footballer_born_1893)	playsFor	Blyth_Spartans_A.F.C.
Shanghai_Pudong_International_Airport	isConnectedTo	Macau_International_Airport
Marcelo_Carrera	playsFor	Columbus_Crew
John_Paul_II_International_Airport_Kraków–Balice	isConnectedTo	Brussels_Airport
Jörg_Sobiech	playsFor	Stuttgarter_Kickers
Richie_Alagich	playsFor	Adelaide_Raiders
Fernando_Screpis	playsFor	Defensores_de_Belgrano
Lisa_De_Vanna	playsFor	Melbourne_Victory_FC_W-League
Emmanuel_Krontiris	playsFor	Borussia_Dortmund
François_Endene	playsFor	Podbeskidzie_Bielsko-Biała
Lisandro_Sacripanti	playsFor	Cobreloa
Finland	dealsWith	China
Georges_Santos	playsFor	Chesterfield_F.C.
Maksat_Baizhanov	playsFor	FC_Shakhter_Karagandy
Orlando_Quintana	playsFor	Pontevedra_CF
Alejandro_Alpízar	playsFor	Club_Xelajú_MC
Charlie_MacDonald	playsFor	Leyton_Orient_F.C.
José_Carlos_Fernández_(Bolivian_footballer)	playsFor	Bolivia_national_football_team
Andrea_Lazzari	playsFor	ACF_Fiorentina
Evandro_Carlos_Escardalete	playsFor	Londrina_Esporte_Clube
Visakhapatnam_Airport	isConnectedTo	Chennai_International_Airport
David_Carlsson_(footballer)	playsFor	IK_Brage
Osmar_Aparecido_de_Azevedo	playsFor	Guaratinguetá_Futebol
Oliver_Cuadrado_Martín	playsFor	CD_Toledo
Vincenzo_Marruocco	playsFor	Foggia_Calcio
Richie_Byrne	playsFor	Hungerford_Town_F.C.
Óscar_Alcides_Mena	playsFor	Club_Olimpo
Kevin_Gallacher	playsFor	Newcastle_United_F.C.
Derek_Frye	playsFor	Ayr_United_F.C.
Fred_Barber	playsFor	Chesterfield_F.C.
Dubai_International_Airport	isConnectedTo	Pune_Airport
Ismael_Blanco	playsFor	AEK_Athens_F.C.
Damià_Abella	playsFor	Catalonia_national_football_team
Jimmy_Carter_(footballer)	playsFor	Portsmouth_F.C.
Linate_Airport	isConnectedTo	Frankfurt
Barry_Powell_(footballer)	playsFor	Derby_County_F.C.
Miguel_Ángel_Benítez	playsFor	Club_Guaraní
Australia	dealsWith	Japan
Dele_Ajiboye	playsFor	Pontevedra_CF
Jamie_Vincent	playsFor	Swindon_Town_F.C.
Peter_Vera	playsFor	San_Luis_de_Quillota
Simon_Johnson_(footballer)	playsFor	Blackpool_F.C.
Roel_van_Hemert	playsFor	Royal_Antwerp_F.C.
Vilnius_Airport	isConnectedTo	Leonardo_da_Vinci–Fiumicino_Airport
Leite_Lopes_Airport	isConnectedTo	Congonhas-São_Paulo_Airport
Robert_L._Eichelberger	hasWonPrize	Silver_Star
Jaroslav_Plašil	playsFor	US_Créteil-Lusitanos
Mario_Gjurovski	playsFor	FC_Metalurh_Donetsk
Luís_Eduardo_Schmidt	playsFor	Real_Betis
Fernando_Ricksen	playsFor	Rangers_F.C.
Hamdi_Salihi	playsFor	SV_Ried
Alan_Miller_(footballer)	playsFor	Middlesbrough_F.C.
Mustafa_Yücedağ	playsFor	PEC_Zwolle
David_Farrell_(footballer_born_1971)	wasBornIn	Birmingham
Alfred_G._Knudson	playsFor	Nottingham_Forest_F.C.
Josip_Broz_Tito	hasWonPrize	Order_of_Suvorov
Lewis_Thom	playsFor	Altrincham_F.C.
Ervin_Fakaj	playsFor	K.R.C._Genk
Rubén_Ferrer	playsFor	Aldosivi
Norbert_Tóth	playsFor	Zalaegerszegi_TE
Admir_Mehmedi	playsFor	Switzerland_national_under-17_football_team
Trevor_Ross	playsFor	Hyde_F.C.
Éverton_Cardoso_da_Silva	playsFor	Clube_Atlético_Paranaense
Wilson_Surubim	playsFor	Campinense_Clube
Moreno_Aoas_Vidal	playsFor	Udinese_Calcio
Goran_Stankovski	playsFor	Kitchee_SC
Adem_Büyük	playsFor	Turkey_national_football_team
Ömer_Kaner	playsFor	Turkey_national_football_team
Cristian_Stellini	playsFor	Calcio_Como
Tampa_International_Airport	isConnectedTo	Bradley_International_Airport
Marques_Batista_de_Abreu	playsFor	Yokohama_F._Marinos
Salvatore_Foti	playsFor	S.S.D._Piacenza_Calcio_1919
Verona_Villafranca_Airport	isConnectedTo	Amílcar_Cabral_International_Airport
Paulo_Monteiro	wasBornIn	Guimarães
Michael_Jefferson_Nascimento	playsFor	Avaí_Futebol_Clube
Martin_Amedick	playsFor	Borussia_Dortmund
Fraser_Forster	playsFor	Celtic_F.C.
Mark_Smyth	playsFor	Prestatyn_Town_F.C.
Christos_Kostis	playsFor	Iraklis_Thessaloniki_F.C.
Trevor_Hebberd	playsFor	Chesterfield_F.C.
Sebastião_Miranda_da_Silva_Filho	playsFor	América_Futebol_Clube_(SP)
Michael_Meaker	playsFor	Paulton_Rovers_F.C.
Mirosław_Trzeciak	playsFor	CA_Osasuna
Jody_Banim	playsFor	Altrincham_F.C.
Brussels_Airport	isConnectedTo	Málaga_Airport
Souza_(footballer)	playsFor	Clube_Atlético_Paranaense
Giuseppe_Cozzolino	playsFor	A.S.D._Città_di_Giulianova_1924
Jamie_Moralee	playsFor	Crystal_Palace_F.C.
Georgi_Kakalov_(footballer)	wasBornIn	Plovdiv
Fabinho_Capixaba	playsFor	São_Cristóvão_de_Futebol_e_Regatas
Michael_Helegbe	playsFor	Ghana_national_football_team
Anderson_Marcelo_da_Silva	playsFor	Al_Sharjah_SC
Shijiazhuang_Zhengding_International_Airport	isConnectedTo	Guiyang_Longdongbao_International_Airport
Fábio_Nunes_Fernandes	wasBornIn	Porto_Alegre
Rafael_Jacques	playsFor	Rayo_Vallecano
Justin_Fashanu	playsFor	Adelaide_City_FC
Gerry_Creaney	playsFor	Raith_Rovers_F.C.
François_Heutte	playsFor	Racing_Club_de_France_football_Colombes_92
John_Bramhall_(footballer)	playsFor	Hyde_F.C.
Nii_Lamptey	playsFor	R.S.C._Anderlecht
Harold_Pinter	hasWonPrize	Nobel_Prize_in_Literature
Jack_Wilshere	playsFor	Luton_Town_F.C.
Ilias_Stogiannis	playsFor	AC_Omonia
Balázs_Tóth_(footballer_born_1981)	playsFor	VVV-Venlo
Marcos_González	playsFor	Columbus_Crew
Julian_Alsford	playsFor	Dorchester_Town_F.C.
Tommaso_Rocchi	playsFor	Calcio_Como
Weeze_Airport	isConnectedTo	Riga_International_Airport
Macau_International_Airport	isConnectedTo	Hefei_Xinqiao_International_Airport
Fabrizio_Ferron	playsFor	Bologna_F.C._1909
Dwight_Pezzarossi	playsFor	Racing_de_Ferrol
Mohamed_Kallon	playsFor	FC_Lugano
Guido_Gorges	playsFor	SV_Wehen_Wiesbaden
Robert_Garrett_(footballer)	playsFor	Wrexham_F.C.
Horacio_Erpen	playsFor	F.B.C._Unione_Venezia
Josiel_da_Rocha	playsFor	Esporte_Clube_São_José
Luís_Miguel_Fontes_Martins	playsFor	Portugal_national_under-20_football_team
Ihor_Shukhovtsev	playsFor	FC_Illichivets-2_Mariupol
Bojan_Brnović	playsFor	FK_Zeta
Moudachirou_Amadou	playsFor	FC_Erzgebirge_Aue
Rainer_Ernst	playsFor	1._FC_Kaiserslautern
Rodrigo_Cordero	playsFor	Asociación_Deportiva_Carmelita
Roberto_Lopes_Nascimento	playsFor	Campinense_Clube
Christopher_Ohen	playsFor	Nigeria_national_football_team
Yehor_Luhachov	playsFor	FC_Arsenal_Kyiv
Jean-Pierre_Papin	hasWonPrize	Ballon_d'Or_(1956–2009)
Tony_Barras	playsFor	Hartlepool_United_F.C.
Seydou_Traoré	playsFor	Africa_Sports_d'Abidjan
Jonathan_Gould	playsFor	Bradford_City_A.F.C.
Are_Tronseth	playsFor	Hønefoss_BK
Vidak_Bratić	playsFor	PAOK_FC
Adam_Czerkas	playsFor	ŁKS_Łódź
Simon_Johnson_(footballer)	wasBornIn	West_Bromwich
Stuart_Green	playsFor	Crystal_Palace_F.C.
Zinedine_Zidane	hasWonPrize	Ballon_d'Or_(1956–2009)
Henri_Bergson	wasBornIn	Paris
Joe_Haverty	playsFor	St_Patrick's_Athletic_F.C.
Freddy_Grisales	playsFor	Barcelona_Sporting_Club
Málaga_Airport	isConnectedTo	Treviso_Airport
Henryk_Bałuszyński	playsFor	Górnik_Zabrze
Habib_Bellaïd	playsFor	US_Boulogne
Nourredine_Kourichi	playsFor	Lille_OSC
Eduard_Sergienko	playsFor	FC_Astana
Donetsk_International_Airport	isConnectedTo	Kyiv_International_Airport_(Zhuliany)
Genki_Nagasato	playsFor	Tokyo_Verdy
John_Shalikashvili	hasWonPrize	Distinguished_Service_Medal_(U.S._Army)
Denis_Wolf	playsFor	1._FC_Magdeburg
Edson_José_da_Silva	playsFor	Fortaleza_Esporte_Clube
Tosh_McKinlay	playsFor	Heart_of_Midlothian_F.C.
Arnór_Guðjohnsen	playsFor	R.S.C._Anderlecht
Fernando_Sánchez_Cipitria	playsFor	Real_Madrid_Castilla
Paul_Jones_(footballer,_born_1967)	playsFor	Watford_F.C.
Iván_Hernández_(footballer)	playsFor	Atlético_Madrid_C
Yao_Junior_Sènaya	playsFor	Togo_national_football_team
Tenerife_South_Airport	isConnectedTo	Bristol_Airport
Dimitri_Payet	playsFor	FC_Nantes
Andrei_Agius	playsFor	Malta_national_football_team
Paul_Agostino	playsFor	BSC_Young_Boys
Ludovic_Sylvestre	playsFor	Blackpool_F.C.
Chris_Coleman_(footballer)	playsFor	Crystal_Palace_F.C.
Elnatan_Salami	playsFor	Hapoel_Petah_Tikva_F.C.
Lajos_Détári	playsFor	Bologna_F.C._1909
José_Padrón	playsFor	Sevilla_FC
Walter_Pandiani	playsFor	CA_Osasuna
José_Mari_Bakero	playsFor	FC_Barcelona
Serdar_Kesimal	playsFor	1._FC_Köln
Don_Goodman	playsFor	Exeter_City_F.C.
Gunter_Thiebaut	playsFor	S.V._Zulte_Waregem
Ben_Hunt_(footballer)	playsFor	Lewes_F.C.
Will_Devey	playsFor	Aston_Villa_F.C.
Tomáš_Belic	playsFor	FC_Spartak_Trnava
Guillermo_Molins	playsFor	Malmö_FF
Jamie_Buchan	playsFor	Cove_Rangers_F.C.
Dejan_Karan	playsFor	FK_Mladost_Podgorica
Mamadou_Bagayoko	wasBornIn	Paris
Eddie_Youds	playsFor	Everton_F.C.
Katie_Hoyle	playsFor	Melbourne_Victory_FC_W-League
Sérgio_Luis_Gardino_da_Silva	playsFor	F.C._Vizela
Franco_Baldini	playsFor	A.S.D._Olimpia_Colligiana
Diego_Placente	playsFor	Bayer_04_Leverkusen
Dougie_Cameron	playsFor	Peterhead_F.C.
David_Weir_(Scottish_footballer)	playsFor	Everton_F.C.
Davor_Krznarić	playsFor	Borussia_Mönchengladbach_II
Alex_Burns_(footballer)	playsFor	Brechin_City_F.C.
Luuk_de_Jong	playsFor	FC_Twente
Mustapha_Yatabaré	playsFor	Villemomble_Sports
Bordeaux–Mérignac_Airport	isConnectedTo	Ajaccio_Napoleon_Bonaparte_Airport
Gocha_Trapaidze	playsFor	FC_Volyn_Lutsk
José_Semedo_(footballer,_born_1979)	playsFor	F.C._Barreirense
David_Bentley	playsFor	England_national_football_team
Kali_(footballer)	playsFor	Angola_national_football_team
Abiodun_Agunbiade	playsFor	Nigeria_national_football_team
Justin_Fashanu	playsFor	Southall_F.C.
Steve_Talboys	playsFor	Sutton_United_F.C.
Mehdi_Tartar	playsFor	Rah_Ahan_Sorinet_F.C.
Bradley_Johnson	playsFor	Leeds_United_A.F.C.
Yevhen_Kucherevskyi	playsFor	Tiverton_Town_F.C.
Ray_Brady	playsFor	St_Patrick's_Athletic_F.C.
Frank_Worthington	playsFor	Leeds_United_A.F.C.
Ben_Sedgemore	playsFor	Stamford_A.F.C.
Steve_Archibald	playsFor	Blackburn_Rovers_F.C.
China	dealsWith	Australia
Blue_Grass_Airport	isConnectedTo	Ronald_Reagan_Washington_National_Airport
Zhengzhou_Xinzheng_International_Airport	isConnectedTo	Mianyang_Nanjiao_Airport
Danny_Carlton	wasBornIn	Leeds
Vadym_Panas	playsFor	FC_Nyva_Ternopil
Giovane_Alves_da_Silva	playsFor	Clube_Atlético_Hermann_Aichinger
Nicky_Forster	playsFor	Birmingham_City_F.C.
Dmitri_Sychev	playsFor	FC_Spartak_Moscow
Monterrey_International_Airport	isConnectedTo	O'Hare_International_Airport
Boudewijn_Zenden	playsFor	Middlesbrough_F.C.
Christophe_Grondin	playsFor	Birmingham_City_F.C.
Darryl_Flahavan	playsFor	Leeds_United_A.F.C.
Mateja_Kežman	playsFor	FK_Partizan
Manuel_Fernandes_(footballer_born_1986)	playsFor	FC_Lokomotiv_Moscow
Ľuboš_Kamenár	playsFor	FC_Nantes
Frank_País_Airport	isConnectedTo	CFB_Bagotville
Fulvio_Collovati	playsFor	Italy_national_football_team
Dalaman_Airport	isConnectedTo	Bristol_Airport
Dejan_Joksimović	playsFor	Heidelberg_United_FC
Christian_Benítez	wasBornIn	Quito
Babis_Stefanidis	playsFor	Malmö_FF
Martin_Reeves	playsFor	Nuneaton_Town_F.C.
Onandi_Lowe	playsFor	Harbour_View_F.C.
Danny_Sleath	playsFor	Alfreton_Town_F.C.
Tom_Evans_(footballer,_born_1976)	playsFor	Crystal_Palace_F.C.
Lewis_Cook	playsFor	Weymouth_F.C.
Igor_Sypniewski	playsFor	IF_Limhamn_Bunkeflo
Collins_John	playsFor	N.E.C._(football_club)
Wilfried_Domoraud	playsFor	FC_Admira_Wacker_Mödling
Dragan_Jelić	playsFor	Slovenia_national_under-19_football_team
Dave_McEachran	playsFor	Boston_Soccer_Club
Paphos_International_Airport	isConnectedTo	Koltsovo_Airport
Wayne_Andrews_(footballer)	playsFor	Leeds_United_A.F.C.
Kauê_Caetano_da_Silva	playsFor	Treze_Futebol_Clube
Jinan_Yaoqiang_International_Airport	isConnectedTo	Hangzhou_Xiaoshan_International_Airport
Colin_McKee	playsFor	Bury_F.C.
Carlos_Bossio	playsFor	Querétaro_F.C.
Maurice_Doyle	playsFor	Queens_Park_Rangers_F.C.
Lanzarote_Airport	isConnectedTo	Brussels_Airport
Aykut_Öztürk	playsFor	SV_Sandhausen
Lamine_Diarra	playsFor	ASC_Jeanne_d'Arc
Rubén_Sosa	playsFor	Borussia_Dortmund
Frank_Munro	playsFor	Celtic_F.C.
Luigi_Martinelli	playsFor	A.C._Chievo_Verona
Enfidha_–_Hammamet_International_Airport	isConnectedTo	Manchester_Airport
Gavin_Cowan_(footballer)	playsFor	Nuneaton_Town_F.C.
Tarık_Daşgün	playsFor	Turkey_national_football_team
Serdar_Özkan	playsFor	Elazığspor
Apostolos_Tsianakas	playsFor	Aiolikos_F.C.
Selim_Teber	playsFor	Samsunspor
Austin_Hayes	playsFor	Republic_of_Ireland_national_football_team
Joe_Haverty	playsFor	Shelbourne_F.C.
John_McClelland_(footballer_born_1955)	playsFor	Yeovil_Town_F.C.
Luis_Carrero_Blanco	playsFor	New_England_Revolution
Simon_Mensing	playsFor	Stenhousemuir_F.C.
El_Dorado_International_Airport	isConnectedTo	Louisville_International_Airport
Justice_Christopher	playsFor	Royal_Antwerp_F.C.
Savvas_Exouzidis	playsFor	Aris_Limassol_F.C.
Paul_McGee_(footballer_born_1954)	playsFor	Preston_North_End_F.C.
Pajtim_Kasami	playsFor	Switzerland_national_under-21_football_team
Ray_Hankin	playsFor	Middlesbrough_F.C.
Jindřich_Skácel	playsFor	SC_Xaverov
Prussia	hasCapital	Königsberg
Klimenti_Tsitaishvili	playsFor	AEL_Limassol
Brian_Turner_(New_Zealand_footballer)	playsFor	Portsmouth_F.C.
Brima_Koroma	playsFor	Kalmar_FF
Georgi_Yartsev	playsFor	FC_Spartak_Moscow
Deividas_Česnauskis	playsFor	FC_Dynamo_Moscow
Wallyson	playsFor	São_Paulo_FC
Sergio_Marcon	playsFor	A.C._Chievo_Verona
Colin_McKee	playsFor	Manchester_United_F.C.
Romas_Dressler	playsFor	Hamburger_SV_II
Paolo_Vanoli	playsFor	Rangers_F.C.
Davy_Oyen	playsFor	Lommel_United
Genki_Nagasato	playsFor	Avispa_Fukuoka
Nick_Burton	playsFor	Crawley_Town_F.C.
Ivaylo_Andonov	playsFor	PFC_CSKA_Sofia
Fernando_Couto	playsFor	Associação_Académica_de_Coimbra_–_O.A.F.
José_Burtovoy	playsFor	Independiente_Santa_Fe
Ferdinand_Foch	hasWonPrize	Médaille_militaire
Dalaman_Airport	isConnectedTo	Košice_International_Airport
Dwane_Lee	playsFor	Hayes_&_Yeading_United_F.C.
Jock_Mulraney	playsFor	Shrewsbury_Town_F.C.
David_Prutton	playsFor	England_national_under-21_football_team
David_Theobald	playsFor	Swansea_City_A.F.C.
Matej_Mavrič	wasBornIn	Koper
James_Pritchett_(footballer)	playsFor	New_Zealand_national_football_team
Juan_Epitié_Dyowe	playsFor	Deportivo_Alavés
Fernando_Meneses	playsFor	Chile_national_under-20_football_team
Darran_Kempson	playsFor	Preston_North_End_F.C.
Alyaksey_Suchkow	playsFor	FC_Shakhtyor_Salihorsk
Steven_Weir	playsFor	Arbroath_F.C.
Calgary_International_Airport	isConnectedTo	John_C._Munro_Hamilton_International_Airport
Michal_Vorel	playsFor	FK_Ústí_nad_Labem
Marián_Dirnbach	playsFor	Skonto_FC
Muriqui_(footballer)	playsFor	Paysandu_Sport_Club
Dominique_Ndjeng	playsFor	SC_Preußen_Münster
Trevor_Ford	playsFor	Swansea_City_A.F.C.
Ahmed_Abou_Moslem	playsFor	Lierse_S.K.
David_Loria	playsFor	Enfield_City_FC
Carlos_Valderrama	playsFor	Colombia_national_football_team
Stanislav_Loban	playsFor	PFC_Hebar_Pazardzhik
Tiago_Treichel	playsFor	Ceará_Sporting_Club
Alhassane_Issoufou	playsFor	Rail_Club_du_Kadiogo
Michel_van_Oostrum	playsFor	SC_Telstar
Ricardo_Páez	playsFor	Universidad_de_Los_Andes_FC
Georgi_Kipiani	playsFor	FC_Metalurgi_Rustavi
Tampa_International_Airport	isConnectedTo	Philadelphia_International_Airport
Nana_Attakora	playsFor	Canada_men's_national_youth_soccer_teams
Felipe_Nery_Franco	playsFor	Cerro_Porteño
Wellington_Silva_(footballer_born_1993)	wasBornIn	Rio_de_Janeiro
Ramón_Rodrigo_de_Freitas	playsFor	Goiás_Esporte_Clube
Frederick_Law_Olmsted	playsFor	Deportivo_Alavés
Grzegorz_Kaliciak	playsFor	Wisła_Kraków
Shenzhen_Bao'an_International_Airport	isConnectedTo	Fuzhou_Changle_International_Airport
Gavin_Ward_(footballer)	playsFor	Bradford_City_A.F.C.
Brian_Howard_(footballer)	playsFor	Portsmouth_F.C.
Franco_Brienza	playsFor	Foggia_Calcio
Richard_Rose_(footballer)	playsFor	Whitehawk_F.C.
Kermanshah_Airport	isConnectedTo	Dubai_International_Airport
Éamon_Zayed	wasBornIn	Dublin
Ernest_Akouassaga	playsFor	Le_Havre_AC
Andriy_Kruhlyak	playsFor	FC_Arsenal-Kyivshchyna_Bila_Tserkva
Gerry_Harrison_(footballer)	playsFor	Luton_Town_F.C.
Germán_Denis	playsFor	Atalanta_B.C.
Max_Thompson_(footballer)	playsFor	Baltimore_Blast_(1980–92)
Ferdinand_Coly	playsFor	Poitiers_FC
Vincent_Ehouman	playsFor	US_Boulogne
Giora_Spiegel	playsFor	Beitar_Tel_Aviv_F.C.
Onandi_Lowe	wasBornIn	Kingston,_Jamaica
Tomislav_Kaloperović	playsFor	Wiener_Sport-Club
David_Mehew	playsFor	Exeter_City_F.C.
Øyvind_Leonhardsen	playsFor	Molde_FK
Emin_Quliyev	playsFor	PFC_Litex_Lovech
Siniša_Linić	playsFor	NK_Istra_1961
Ricardo_Pinto_(footballer)	playsFor	Fluminense_FC
Nenad_Grozdić	playsFor	Racing_de_Ferrol
Justo_Villar	playsFor	Club_Sol_de_América
Battle_of_Lepanto	happenedIn	Republic_of_Venice
John_Woodward_(footballer_born_1947)	playsFor	Aston_Villa_F.C.
Paul_Newe	playsFor	Shelbourne_F.C.
Willie_Reid_(footballer)	playsFor	Rangers_F.C.
Lorenzo_Staelens	playsFor	R.S.C._Anderlecht
Angelo_Zimmerman	playsFor	SC_Cambuur
Teslim_Fatusi	playsFor	Espérance_de_Tunis
Válber_Mendes_Ferreira	playsFor	Santa_Cruz_Futebol_Clube
Lasse_Qvist	playsFor	Næstved_BK
Jancarlos_de_Oliveira_Barros	playsFor	Volta_Redonda_Futebol_Clube
Jofre_Mateu	playsFor	FC_Barcelona_B
Ondřej_Mazuch	playsFor	ACF_Fiorentina
Maurício_Fernandes	playsFor	Fluminense_FC
Paul_Ronald	playsFor	Happy_Valley_AA
Rajinikanth	hasWonPrize	Padma_Bhushan
Miljenko_Mumlek	playsFor	Croatia_national_under-21_football_team
Vietnam_War	happenedIn	Cambodia
Cleavon_Frendo	playsFor	Qormi_F.C.
Éverton_Cardoso_da_Silva	playsFor	Desportivo_Brasil
Răzvan_Neagu	playsFor	FCM_Bacău
Benina_International_Airport	isConnectedTo	Khartoum_International_Airport
Robert_Hosie	playsFor	Third_Lanark_A.C.
Republic_of_Macedonia	dealsWith	Bulgaria
Monterrey_International_Airport	isConnectedTo	Detroit_Metropolitan_Wayne_County_Airport
Yannick_Kakoko	playsFor	1._FC_Saarbrücken
Natale_Gonnella	playsFor	Italy_national_under-19_football_team
Robert_Walker_(footballer_born_1987)	playsFor	Jönköpings_Södra_IF
Jaime_Bragança	playsFor	Chonburi_F.C.
Zoran_Vujović	playsFor	FC_Girondins_de_Bordeaux
Max_Tonetto	playsFor	Empoli_F.C.
José_Daniel_Ponce	playsFor	Atlético_Tucumán
Mauro_Rosales	playsFor	Seattle_Sounders_FC
Niger	dealsWith	China
Dito_(Portuguese_footballer)	playsFor	S.C._Espinho
Alfred_Phiri	playsFor	Moroka_Swallows_F.C.
Jonathan_Sesma	playsFor	Cádiz_CF
Albert_Yagüe_Jiménez	playsFor	Cultural_y_Deportiva_Leonesa
Uwe_Rösler	playsFor	SpVgg_Unterhaching
Avgerinos_Katranas	playsFor	Vyzas_F.C.
Eddy_Lord_Dombraye	playsFor	Nigeria_national_under-20_football_team
Shanghai_Pudong_International_Airport	isConnectedTo	Mianyang_Nanjiao_Airport
Robert_Hopkins_(footballer)	playsFor	Shrewsbury_Town_F.C.
Gaspar_Azevedo	playsFor	Rio_Ave_F.C.
Netinho	playsFor	Al_Ahli_SC_(Doha)
Greg_Lincoln	playsFor	Aveley_F.C.
Peter_Cormack	playsFor	Nottingham_Forest_F.C.
Russell_Coughlin	playsFor	Blackpool_F.C.
Danny_Maye	playsFor	Taunton_Town_F.C.
Fernando_Guerrero_(footballer)	playsFor	Villarreal_CF_B
Edward_Cocherari	playsFor	Deportivo_Petapa
Aleksandr_Laktionov_(footballer)	playsFor	FC_Spartak_Moscow
Petar_Divić	playsFor	CD_Toledo
Lee_Hendrie	playsFor	England_national_football_team
Danny_Williams_(footballer_born_1981)	playsFor	Northwich_Victoria_F.C.
Martín_Barlocco	playsFor	El_Tanque_Sisley
Ferdi_Elmas	playsFor	Baku_FC
Jack_Cork	playsFor	England_national_under-16_football_team
Ádám_Hrepka	playsFor	Hungary_national_football_team
Ben_Alnwick	playsFor	Leyton_Orient_F.C.
Martin_Spanring	playsFor	Freiburger_FC
Bart_Van_Den_Eede	playsFor	FC_Eindhoven
So_Yiu_Man	playsFor	Happy_Valley_AA
Dmitriy_Lyapkin	playsFor	FC_Astana
Valentin_Filatov	playsFor	FC_Rostov
Noel_King	wasBornIn	Dublin
Matthew_Amoah	playsFor	SC_Heerenveen
Wayne_A._Downing	hasWonPrize	Defense_Meritorious_Service_Medal
Sid_Binks	playsFor	Portsmouth_F.C.
Tomáš_Ujfaluši	playsFor	ACF_Fiorentina
Frank_Jurić	playsFor	Bayer_04_Leverkusen
Ibrahim_Tall	playsFor	FC_Nantes
Paulo_Futre	playsFor	C.D._Montijo
Bordeaux–Mérignac_Airport	isConnectedTo	Birmingham_Airport
Pedro_Paulo_de_Oliveira	playsFor	Sociedade_Esportiva_Palmeiras
Berkant_Göktan	playsFor	1._FC_Kaiserslautern
Mourad_Bounoua	playsFor	Goslarer_SC_08
José_Ernesto_Sosa	playsFor	Estudiantes_de_La_Plata
Andrew_Barisić	playsFor	Gold_Coast_United_FC
John_Filan	playsFor	South_Coast_Wolves_FC
Heydar_Aliyev_International_Airport	isConnectedTo	Tivat_Airport
Dennis_Wise	playsFor	England_national_under-21_football_team
Joe_Kendrick,_Jr.	playsFor	Newcastle_Blue_Star_F.C.
Brian_Jackson_(footballer_born_1933)	playsFor	Leyton_Orient_F.C.
James_Wesolowski	playsFor	Shrewsbury_Town_F.C.
Pedro_Beda	playsFor	SC_Heerenveen
Levan_Tskitishvili	wasBornIn	Tbilisi
Paul_Linz	playsFor	Freiburger_FC
Rijat_Shala	playsFor	FC_Schaffhausen
Michael_Wenczel	playsFor	FC_Ingolstadt_04
Felix_Healy	playsFor	Irish_League_representative_team
Margaret_Thatcher	playsFor	Greenock_Morton_F.C.
J._R._Reid	playsFor	Club_Aurora
Jacques_Songo'o	playsFor	Deportivo_de_La_Coruña
Djibouti–Ambouli_International_Airport	isConnectedTo	Aden_Adde_International_Airport
Antonio_Maceo_Airport	isConnectedTo	Toussaint_Louverture_International_Airport
Dirk_Caspers	playsFor	Borussia_Mönchengladbach_II
Indianapolis_International_Airport	isConnectedTo	Memphis_International_Airport
Ángel_Cuéllar	playsFor	Levante_UD
Curtis_Scaparrotti	playsFor	Morecambe_F.C.
Aidas_Preikšaitis	playsFor	Lithuania_national_football_team
Zoltán_Opata	playsFor	Lille_OSC
Ever_Palacios	playsFor	Shonan_Bellmare
Fraser_Digby	playsFor	Manchester_United_F.C.
David_Norris_(footballer)	playsFor	Portsmouth_F.C.
Venice_Marco_Polo_Airport	isConnectedTo	Split_Airport
Finidi_George	wasBornIn	Port_Harcourt
Péter_Andorka	playsFor	Hungary_national_under-19_football_team
Visakhapatnam_Airport	isConnectedTo	Kempegowda_International_Airport
Kris_Bright	playsFor	Shrewsbury_Town_F.C.
Kadala_Airport	isConnectedTo	Koltsovo_Airport
Gold_Coast_Airport	isConnectedTo	Sydney_Airport
East_Midlands_Airport	isConnectedTo	Chambéry_Airport
Rodrigo_José_Queiroz_Chagas	playsFor	Clube_de_Regatas_Brasil
Emile_M'Bouh	playsFor	Sport_Benfica_e_Castelo_Branco
Carlos_Carvalhal	playsFor	S.C._Espinho
Jorge_Higuaín	playsFor	Club_de_Gimnasia_y_Esgrima_La_Plata
Yuichiro_Nagai	playsFor	Urawa_Red_Diamonds
David_Norris_(footballer)	wasBornIn	Peterborough
Alberto_Méndez_(footballer)	playsFor	SV_Darmstadt_98
Zvonimir_Cimermančić	playsFor	Yugoslavia_national_football_team
Valdas_Trakys	playsFor	FC_Kuban_Krasnodar
Rinaldo_Santana_dos_Santos	playsFor	Sport_Club_do_Recife
Arminas_Narbekovas	playsFor	Wiener_Sport-Club
Giuseppe_Meazza	playsFor	Atalanta_B.C.
Edson_Zwaricz	playsFor	Estudiantes_Tecos
Stéphane_Noro	playsFor	Stade_de_Reims
Edison_Giménez	playsFor	Deportivo_Pereira
Boudewijn_de_Geer	playsFor	Molde_FK
Mark_Caughey	playsFor	Ards_F.C.
Samir_Ujkani	playsFor	U.S._Città_di_Palermo
Iván_Hernández_(footballer)	playsFor	Atlético_Malagueño
Eduard_Dubinski	playsFor	Soviet_Union_national_football_team
Pat_Fidelia	wasBornIn	Port-au-Prince
Tommy_Wright_(footballer,_born_1984)	playsFor	Blackpool_F.C.
Incheon_International_Airport	isConnectedTo	Vladivostok_International_Airport
Michael_Curcija	playsFor	Heidelberg_United_FC
David_Sauget	playsFor	Grenoble_Foot_38
Branislav_Vukomanović	playsFor	FK_Zeta
Norberto_Araujo	playsFor	Ecuador_national_football_team
Aleksandr_Shmarko	playsFor	FC_Rostov
Michael_Brough	playsFor	Guiseley_A.F.C.
Stephen_McPhee	playsFor	St._Mirren_F.C.
Marcelo_Carrusca	playsFor	Estudiantes_de_La_Plata
Dramane_Kamaté	playsFor	Ferencvárosi_TC
Dubai_International_Airport	isConnectedTo	Tolmachevo_Airport
Uli_Stielike	playsFor	Real_Madrid_C.F.
Johan_Walem	playsFor	Calcio_Catania
Incheon_International_Airport	isConnectedTo	Nadi_International_Airport
Eddie_McGoldrick	playsFor	Crystal_Palace_F.C.
David_Giubilato	playsFor	Ternana_Calcio
Mark_Gayle	playsFor	Blackpool_F.C.
Fred_Grgurev	playsFor	New_York_Arrows
Timo_Hildebrand	playsFor	Germany_national_football_team
Mohamed_Gouda	playsFor	FC_Aarau
Nemanja_Supić	playsFor	FK_Radnički_Obrenovac
Massimo_Murdocca	playsFor	Australia_national_under-17_association_football_team
Giampaolo_Pazzini	playsFor	Boca_Juniors
Jorge_Bolaño	playsFor	U.S._Lecce
Juan_Pablo_Ángel	playsFor	Colombia_national_football_team
Milko_Gjurovski	playsFor	Nîmes_Olympique
Paul_McGee_(footballer_born_1954)	playsFor	Republic_of_Ireland_national_football_team
Juan_Carlos_Arguedas	playsFor	Cobán_Imperial
Tenerife_South_Airport	isConnectedTo	Sheremetyevo_International_Airport
Chris_Bettney	playsFor	Retford_United_F.C.
Tony_Bird_(footballer_born_1974)	wasBornIn	Cardiff
Dario_Bodrušić	playsFor	NK_Istra_1961
Bernd_Hobsch	playsFor	FC_Sachsen_Leipzig
Rincón_(footballer_born_1987)	playsFor	São_Paulo_FC
Fredrik_Stenman	playsFor	Bayer_04_Leverkusen
John_Paul_II_International_Airport_Kraków–Balice	isConnectedTo	Leonardo_da_Vinci–Fiumicino_Airport
East_Midlands_Airport	isConnectedTo	Treviso_Airport
Brian_Diego_Fuentes	playsFor	Zamora_FC
Peter_Cormack_(footballer_born_1974)	playsFor	Newcastle_United_F.C.
Radislav_Sekulić	playsFor	FK_Mladost_Podgorica
Gary_Phillips_(footballer)	playsFor	Reading_F.C.
Hajrudin_Ćatić	playsFor	1._FC_Köln
Luciano_Zauri	playsFor	S.S._Lazio
Daniel_Oprița	playsFor	FC_Aarau
Armando_Husillos	playsFor	Cádiz_CF
Frank_Carrodus	playsFor	Wrexham_F.C.
Albert_Borzenkov	playsFor	FC_Avangard_Kursk
Erland_Johnsen	playsFor	Norway_national_under-19_football_team
Dario_Krešić	playsFor	VfB_Stuttgart_II
Markus_Babbel	playsFor	Germany_national_football_team
Ulugbek_Bakayev	playsFor	Uzbekistan_national_football_team
Marco_Carparelli	playsFor	A.C._Chievo_Verona
Eduardo_Godinho_Felipe_de_Souza	playsFor	S.C._Espinho
Luís_Augusto_Osório_Romão	playsFor	Santos_FC
Croatia	dealsWith	Russia
San_Jose_International_Airport	isConnectedTo	Salt_Lake_City_International_Airport
Edmilson_Gonçalves_Pimenta	playsFor	Sociedade_Esportiva_Palmeiras
Adam_Bartlett	playsFor	Hereford_United_F.C.
Nuno_Espírito_Santo	playsFor	FC_Dynamo_Moscow
Maciej_Iwański	playsFor	ŁKS_Łódź
Didier_Tholot	playsFor	AS_Saint-Étienne
Johnny_Haynes	playsFor	Durban_City_F.C._(1959)
Carmelo_González_(footballer)	playsFor	Buriram_United_F.C.
Matthias_Breitkreutz	playsFor	Arminia_Bielefeld
Luis_Yanes	playsFor	Independiente_Santa_Fe
Massamba_Sambou	playsFor	FC_Nantes
Vanja_Grubač	playsFor	Le_Havre_AC
Bedourie_Airport	isConnectedTo	Mount_Isa_Airport
Kujtim_Shala	playsFor	FK_Partizan
John_Ruddy	wasBornIn	Cambridge
Jimmy_Rooney	wasBornIn	Dundee
Joe_Bacuzzi	playsFor	Bury_F.C.
Pablo_Bezombe	playsFor	Deportivo_Petare
Tommy_Fitzgerald	playsFor	Republic_of_Ireland_national_under-21_football_team
Sarayoot_Chaikamdee	playsFor	Singhtarua_F.C.
Ben_Hinchliffe	playsFor	Preston_North_End_F.C.
Marcel_Maltritz	playsFor	Hamburger_SV_II
Leonardo_da_Vinci–Fiumicino_Airport	isConnectedTo	Zvartnots_International_Airport
Eusebio_Sacristán	playsFor	Real_Valladolid_B
Shahjalal_International_Airport	isConnectedTo	Kuala_Lumpur_International_Airport
Andrew_Gregor	playsFor	Columbus_Crew
Georgi_Adamia	playsFor	Neftchi_Baku_PFK
Wayne_Burnett	playsFor	Leyton_Orient_F.C.
Ron_Barnes_(footballer)	playsFor	Norwich_City_F.C.
Alex_Rodrigo_Dias_da_Costa	wasBornIn	Niterói
Linate_Airport	isConnectedTo	Heraklion_International_Airport
Richard_Pacquette	playsFor	Queens_Park_Rangers_F.C.
Linate_Airport	isConnectedTo	Amsterdam
Jérôme_Boateng	playsFor	Germany_national_youth_football_team
Dragan_Mladenović	playsFor	Real_Sociedad
Graham_Paddon	playsFor	Alfreton_Town_F.C.
Marcus_Fischer	playsFor	SC_Preußen_Münster
Benjamin_Totori	playsFor	Oakleigh_Cannons_FC
Garnik_Avalyan	playsFor	Armenia_national_football_team
Stuart_Elliott_(footballer,_born_1977)	playsFor	Hartlepool_United_F.C.
Ante_Rukavina	playsFor	Panathinaikos_F.C.
Neil_Roberts_(Welsh_footballer)	playsFor	Bradford_City_A.F.C.
Aleksandar_Madžar_(soccer)	playsFor	Floriana_F.C.
Yuri_Gazzaev	playsFor	FC_Dynamo_Moscow
Arkadiusz_Mysona	wasBornIn	Szczecin
Nino_Bule	playsFor	Croatia_national_under-21_football_team
Heraklion_International_Airport	isConnectedTo	Vienna_International_Airport
Slobodan_Lakićević	playsFor	SV_Wehen_Wiesbaden
Gilles_De_Bilde	playsFor	PSV_Eindhoven
Carsten_Keuler	playsFor	SV_Wehen_Wiesbaden
Michael_Ferrante	playsFor	Australia_national_under-20_association_football_team
Rolf_Landerl	playsFor	FK_DAC_1904_Dunajská_Streda
Martin_Adrian_Garcia	playsFor	C.S.D._Villa_Española
Monsef_Zerka	playsFor	Iraklis_Thessaloniki_F.C.
Iyenemi_Furo	playsFor	Royal_Antwerp_F.C.
Andriy_Proshyn	playsFor	FC_Khimik_Dzerzhinsk
David_Burnside_(footballer)	playsFor	England_national_football_team
Vardan_Khachatryan	playsFor	Armenia_national_football_team
Mick_O'Brien_(footballer_born_1893)	playsFor	Watford_F.C.
Milen_Radukanov	playsFor	PFC_Nesebar
Florence_Airport,_Peretola	isConnectedTo	Charles_de_Gaulle_Airport
Martin_Christensen	playsFor	Åtvidabergs_FF
Nantes_Atlantique_Airport	isConnectedTo	Djerba–Zarzis_International_Airport
Faustino_Asprilla	playsFor	Club_Universidad_de_Chile
Lárus_Guðmundsson	playsFor	Knattspyrnufélagið_Víkingur
Javier_Yacuzzi	playsFor	Tiro_Federal
Luca_Toni	playsFor	Empoli_F.C.
Detroit_Metropolitan_Wayne_County_Airport	isConnectedTo	Port_Columbus_International_Airport
Aleksei_Poliakov	playsFor	FC_Neftekhimik_Nizhnekamsk
Ian_Ormondroyd	playsFor	Derby_County_F.C.
Ats_Purje	wasBornIn	Tallinn
Adin_Brown	playsFor	Tampa_Bay_Mutiny
Paul_Tait_(footballer_born_1974)	playsFor	Everton_F.C.
Serigne_Diop	wasBornIn	Paris
Carlos_Eduardo_da_Silva	playsFor	C.S._Marítimo
Olivier_Karekezi	playsFor	Rwanda_national_football_team
Shenzhen_Bao'an_International_Airport	isConnectedTo	Guiyang_Longdongbao_International_Airport
Art_Welch	playsFor	Vancouver_Whitecaps_(1974–84)
Igor_Jovićević	playsFor	Shenyang_Dongjin_F.C.
Seven_Years'_War	happenedIn	Philippines
Ronnachai_Rangsiyo	wasBornIn	Bangkok
Carlos_Vela	playsFor	Real_Sociedad
Titus_Ozon	playsFor	FC_Progresul_București
Wrocław–Copernicus_Airport	isConnectedTo	Barcelona–El_Prat_Airport
Faysal_El_Idrissi	playsFor	1._FC_Saarbrücken
Braulio_Luna	playsFor	Estudiantes_Tecos
Sheremetyevo_International_Airport	isConnectedTo	Sharjah_International_Airport
Barbados	exports	wordnet_chemical_114806838
Marco_Zamboni	playsFor	Italy_national_under-21_football_team
Adrian_Falub	playsFor	FC_Unirea_Dej
Gocha_Khojava	wasBornIn	Tbilisi
Javi_Ruiz	playsFor	FC_Barcelona_C
Kezie_Ibe	playsFor	Weymouth_F.C.
Stian_Ohr	playsFor	Molde_FK
Wrocław–Copernicus_Airport	isConnectedTo	Monastir_Habib_Bourguiba_International_Airport
Andrey_Sherakow	playsFor	FC_Zvezda-BGU_Minsk
Willie_Ormond	wasBornIn	Falkirk
Héctor_Flores	playsFor	C.D.S._Vida
Dirk_Jan_Derksen	playsFor	SC_Cambuur
Velimir_Vidić	playsFor	FK_Sloboda_Tuzla
Oscar_(footballer,_born_1991)	playsFor	São_Paulo_FC
Chelyabinsk_Airport	isConnectedTo	Sheremetyevo_International_Airport
Reuven_Oved	playsFor	Hapoel_Nir_Ramat_HaSharon_F.C.
Nguyen_Viet_Thang	playsFor	F.C._Porto_B
Daniel_Bilos	playsFor	Club_América
Alharbi_El_Jadeyaoui	playsFor	Tours_FC
Titus_Ozon	playsFor	FC_Rapid_București
Maarten_Martens	playsFor	PAOK_FC
Bartosz_Iwan	playsFor	Piast_Gliwice
Youssef_Mokhtari	playsFor	SSV_Jahn_Regensburg
Robbie_Threlfall	playsFor	Bradford_City_A.F.C.
Maximilian_Heidenreich	playsFor	VfL_Wolfsburg
Igor_Smolnikov	playsFor	FC_Ural_Sverdlovsk_Oblast
Kasey_Wehrman	playsFor	Australia_national_under-20_association_football_team
Honore_Kabongo	playsFor	Armée_Patriotique_Rwandaise_F.C.
Sylvain_N'Diaye	playsFor	Stade_de_Reims
Colin_Stein	playsFor	Rangers_F.C.
Oleg_Belyakov	playsFor	FC_Bunyodkor
Chris_Humphrey	playsFor	Shrewsbury_Town_F.C.
Ürümqi_Diwopu_International_Airport	isConnectedTo	Mianyang_Nanjiao_Airport
Yohann_Lasimant	playsFor	Egri_FC
Abolfazl_Hajizadeh	wasBornIn	Tabriz
Vladimir_Koman	playsFor	FC_Ural_Sverdlovsk_Oblast
Paul_Crowley	playsFor	St_Patrick's_Athletic_F.C.
Marcin_Siedlarz	playsFor	Widzew_Łódź
Maria_Theresa_of_Austria_(1816–1867)	playsFor	Real_Betis
Viktor_Melnyk	playsFor	FC_Obolon_Kyiv
Wendel_Santana_Pereira_Santos	playsFor	Clube_Atlético_Juventus
Giorgi_Chelidze	playsFor	FC_Metalurgi_Rustavi
Stuart_Green	playsFor	Workington_A.F.C.
Garry_Brady	playsFor	Portsmouth_F.C.
Nathan_Tyson	playsFor	Blackpool_F.C.
Paul_Cook_(footballer)	playsFor	Marine_F.C.
T._S._Eliot	hasWonPrize	Order_of_Merit
Robert_Hopkins_(footballer)	playsFor	Aston_Villa_F.C.
Paul_Kinnaird	playsFor	Shrewsbury_Town_F.C.
Lárus_Guðmundsson	playsFor	1._FC_Kaiserslautern
Roberto_Di_Maio	playsFor	U.S._Castelnuovo_Garfagnana
Kyriacos_Pavlou	playsFor	Diagoras_F.C.
Ben_Thatcher	playsFor	Wimbledon_F.C.
Júlio_César_(footballer,_born_January_1983)	playsFor	Salgueiro_Atlético_Clube
David_Healy_(footballer)	playsFor	Norwich_City_F.C.
Rodolfo_Moya	playsFor	Deportes_La_Serena
Todi_Jónsson	playsFor	KÍ_Klaksvík
Raïs_M'Bolhi	playsFor	Heart_of_Midlothian_F.C.
Kwame_Ayew	playsFor	Kocaelispor
James_McNulty_(footballer)	playsFor	Bury_F.C.
Frazer_McHugh	playsFor	Swindon_Town_F.C.
Zlatan_Ibrahimović	wasBornIn	Malmö
Ireland_West_Airport_Knock	isConnectedTo	Birmingham_Airport
Sietes	playsFor	Real_Oviedo_Vetusta
Paul_Crichton	playsFor	Aston_Villa_F.C.
Grzegorz_Kaliciak	playsFor	Zagłębie_Sosnowiec
Dmytro_Topchiyev	playsFor	FC_Elektrometalurh-NZF_Nikopol
Obina	playsFor	América_Futebol_Clube_(MG)
Hangzhou_Xiaoshan_International_Airport	isConnectedTo	Tengchong_Tuofeng_Airport
Stijn_De_Smet	playsFor	Belgium_national_under-19_football_team
José_Carlos_Fernández_(Bolivian_footballer)	playsFor	Independiente_Santa_Fe
Borislav_Mikhailov	playsFor	PFC_Levski_Sofia
Francis_Crick	hasWonPrize	Albert_Lasker_Award_for_Basic_Medical_Research
Reinaldo_de_Souza	wasBornIn	Rio_de_Janeiro
Caetano_Calil	playsFor	Santos_FC
Fred_Hoyle	hasWonPrize	Royal_Medal
Bernard_Schuiteman	playsFor	SC_Cambuur
Surgut_International_Airport	isConnectedTo	Kazan_International_Airport
Luigi_Martinelli	playsFor	F.C._AlzanoCene_1909
Jock_Ferguson	playsFor	Bethlehem_Steel_F.C.
Ronald_Ramírez	wasBornIn	Montevideo
Niklas_Skoog	playsFor	Malmö_FF
Marc_Van_Der_Linden	playsFor	Hapoel_Rishon_LeZion_F.C.
David_Hodgson_(footballer)	playsFor	Swansea_City_A.F.C.
Bristol_Airport	isConnectedTo	Béziers_Cap_d'Agde_Airport
Marcin_Folc	playsFor	Piast_Gliwice
Hermes_Neves_Soares	playsFor	Widzew_Łódź
Matt_Hill_(footballer)	playsFor	Blackpool_F.C.
Stephan_El_Shaarawy	playsFor	Italy_national_under-18_football_team
Yulin_Yuyang_Airport	isConnectedTo	Dalian_Zhoushuizi_International_Airport
Paul_Tosh	playsFor	Raith_Rovers_F.C.
Andrija_Delibašić	playsFor	AEK_Athens_F.C.
Élder_Granja	playsFor	Associação_Desportiva_São_Caetano
Camille_Muzinga	playsFor	FC_Rapid_București
Selim_Benachour	playsFor	Tunisia_national_football_team
Marat_Dzakhmishev	playsFor	Turan-T_IK
Olof_Mellberg	playsFor	Sweden_national_football_team
Jerome_Watt	playsFor	Leigh_Genesis_F.C.
Tajikistan	dealsWith	Afghanistan
Luc_Nilis	playsFor	PSV_Eindhoven
Guiyang_Longdongbao_International_Airport	isConnectedTo	Kunming_Changshui_International_Airport
Eduard_Grosu	playsFor	FC_Metallurg-Kuzbass_Novokuznetsk
Anthony_Bancarel	playsFor	US_Créteil-Lusitanos
Laos	dealsWith	Thailand
Roberto_Di_Maio	playsFor	L'Aquila_Calcio_1927
Yash_Chopra	wasBornIn	Lahore
Lee_Steele	playsFor	Leyton_Orient_F.C.
Stefan_Malz	playsFor	VfR_Mannheim
Jörg_Sobiech	playsFor	FC_Twente
Tommy_Johnson_(footballer_born_1971)	playsFor	Celtic_F.C.
Stuart_Hicks	wasBornIn	Peterborough
Robert_E._Sherwood	wasBornIn	New_Rochelle,_New_York
Quique_Álvarez	playsFor	FC_Barcelona
Samed_Abdul_Awudu	playsFor	FC_Senec
Luke_Foster	playsFor	Matlock_Town_F.C.
Samuel_Boutal	playsFor	Tours_FC
Adrian_Mrowiec	playsFor	Heart_of_Midlothian_F.C.
Stefan_Bell	playsFor	Germany_national_youth_football_team
Bogdan_Milić	playsFor	FC_Krylia_Sovetov_Samara
Genoa_Cristoforo_Colombo_Airport	isConnectedTo	Manchester_Airport
Pablo_Sánchez	playsFor	Deportivo_Alavés
Younis_Mahmoud	playsFor	Al-Gharafa_Sports_Club
Alex_Wilkinson	playsFor	Manly_United_FC
Charles_de_Gaulle_Airport	isConnectedTo	Valencia_Airport
Mahir_Sağlık	playsFor	1._FC_Saarbrücken
Amílcar_Cabral_International_Airport	isConnectedTo	Göteborg_Landvetter_Airport
Junivan_Soares_de_Melo	playsFor	Kayseri_Erciyesspor
Craig_Easton	playsFor	Swindon_Town_F.C.
Dave_Halliday	playsFor	Dundee_F.C.
Markus_Münch_(footballer)	playsFor	Bayer_04_Leverkusen
Mabhuti_Khenyeza	playsFor	Lamontville_Golden_Arrows_F.C.
Stephen_Dobbie	playsFor	Crystal_Palace_F.C.
Attila_Katona	playsFor	Debreceni_VSC
Mario_Pérez_Zúñiga	playsFor	Club_América
Scott_Hiley	playsFor	Exeter_City_F.C.
Vladimir_Lebed	playsFor	PFC_CSKA_Moscow
Guiyang_Longdongbao_International_Airport	isConnectedTo	Shijiazhuang_Zhengding_International_Airport
Augustine_Simo	playsFor	FC_Zürich
Lee_Hills_(footballer)	playsFor	Crystal_Palace_F.C.
Eritrea	dealsWith	Germany
Walter_Pandiani	wasBornIn	Montevideo
Bülent_Uygun	wasBornIn	Adapazarı
Hipólito_Rincón	playsFor	Real_Betis
Emmanuel_Amuneke	hasWonPrize	African_Footballer_of_the_Year
Franz-Josef_Tenhagen	playsFor	Borussia_Dortmund
Klimenti_Tsitaishvili	playsFor	Hapoel_Tzafririm_Holon_F.C.
Koji_Yamase	playsFor	Urawa_Red_Diamonds
Roberto_Muzzi	playsFor	A.C._Pisa_1909
Dubai_International_Airport	isConnectedTo	Geneva_International_Airport
Aaran_Lines	playsFor	SV_Werder_Bremen
Alessandro_Alessandrì	playsFor	Gela_Calcio
Ángel_di_María	playsFor	Rosario_Central
Kanfory_Sylla	playsFor	Zakho_FC
Jason_Rowbotham	wasBornIn	Cardiff
Cristian_Rami	playsFor	Tiro_Federal
Dimitri_Mbuyu	playsFor	K.S.C._Lokeren_Oost-Vlaanderen
Youssef_Mokhtari	playsFor	SV_Wacker_Burghausen
Pat_Jennings	wasBornIn	Newry
Blackpool_International_Airport	isConnectedTo	Palma_de_Mallorca_Airport
Ľubomír_Luhový	playsFor	FC_Spartak_Trnava
Mohammad_Reza_Adelkhani	playsFor	Wuppertaler_SV
Wrocław–Copernicus_Airport	isConnectedTo	Lanzarote_Airport
José_Oscar_Flores	playsFor	Aldosivi
Sergey_Timofeev	playsFor	FC_Dynamo_Moscow
Eddie_Annand	playsFor	Greenock_Morton_F.C.
Dubai_International_Airport	isConnectedTo	Isfahan_International_Airport
Stephen_O'Flynn	playsFor	Wimbledon_F.C.
Dariusz_Kubicki	playsFor	Stal_Mielec
Astolpho_Junio_Lopes	playsFor	Bangu_Atlético_Clube
Damir_Memišević	playsFor	FC_Taraz
Hefei_Xinqiao_International_Airport	isConnectedTo	Nanchang_Changbei_International_Airport
Ian_Henderson_(footballer)	playsFor	Norwich_City_F.C.
Edmundo_Rodriguez	playsFor	Hershey_Wildcats
Lee_Richardson_(footballer)	playsFor	Stockport_County_F.C.
Pauleta	playsFor	FC_Girondins_de_Bordeaux
Derek_Brazil	playsFor	Republic_of_Ireland_national_under-21_football_team
Georgios_Kyriazis	playsFor	Iraklis_Thessaloniki_F.C.
William_Mocquet	playsFor	Bury_F.C.
Tony_Butler_(footballer)	playsFor	Blackpool_F.C.
Russell_Bradley	playsFor	Scunthorpe_United_F.C.
Bjørnar_Holmvik	playsFor	Sandnes_Ulf
Giorgi_Navalovski	playsFor	FC_Metalurgi_Rustavi
Aleksandar_Aranđelović	playsFor	Racing_Club_de_France_football_Colombes_92
Julio_César_Cortés	playsFor	Rosario_Central
Lewis_Cook	playsFor	Lewes_F.C.
Jones_Kusi-Asare	playsFor	Grazer_AK
Jerome_Watt	playsFor	Cercle_Brugge_K.S.V.
Andrea_Pazzagli	playsFor	Udinese_Calcio
Mihail_Venkov	playsFor	PFC_CSKA_Sofia
Sérgio_Luís_de_Araújo	playsFor	Sociedade_Esportiva_Palmeiras
Lorenz_Kindtner	playsFor	Richmond_SC
Rubén_Castro	playsFor	Albacete_Balompié
Detroit_Metropolitan_Wayne_County_Airport	isConnectedTo	O'Hare_International_Airport
Paulino_Martínez_Soria	playsFor	Albacete_Balompié_B
George_Leandro_Abreu_de_Lima	playsFor	Jeonnam_Dragons
Frederick_the_Great	hasWonPrize	Order_of_St._Andrew
Andreu_Guerao_Mayoral	playsFor	Polonia_Warsaw
Loïc_Loval	playsFor	Guadeloupe_national_football_team
Chūbu_Centrair_International_Airport	isConnectedTo	Detroit_Metropolitan_Wayne_County_Airport
Zlatko_Junuzović	playsFor	SV_Werder_Bremen
Kim_Shin-young	playsFor	Ventforet_Kofu
Fábio_do_Nascimento_Silva	wasBornIn	Recife
Carlos_Araujo	playsFor	Atlético_de_Rafaela
Cristiano_da_Silva_Santos	playsFor	Villa_Nova_Atlético_Clube
Christian_Nerlinger	playsFor	FC_Bayern_Munich
Mustapha_Yatabaré	playsFor	US_Boulogne
Grant_Smith_(footballer)	playsFor	Reading_F.C.
Waldemar_Ksienzyk	playsFor	1._FC_Union_Berlin
Ricardo_Bitancort	playsFor	Juventud_de_Las_Piedras
Andy_Dibble	playsFor	Middlesbrough_F.C.
Orly_Airport	isConnectedTo	Leonardo_da_Vinci–Fiumicino_Airport
Salim_Tuama	playsFor	AEL_1964_FC
Clark_Masters	playsFor	Havant_&_Waterlooville_F.C.
Abdoulie_Corr	playsFor	Vaasan_Palloseura
Sharbel_Touma	playsFor	Halmstads_BK
Dan_Connor_(footballer)	wasBornIn	Dublin
Paul_Raynor	playsFor	Gainsborough_Trinity_F.C.
Altin_Haxhi	playsFor	Iraklis_Thessaloniki_F.C.
Nicolás_Gianni	playsFor	Defensores_de_Belgrano
Domingos_Alexandre_Martins_Costa	playsFor	Moreirense_F.C.
John_Fashanu	playsFor	Wimbledon_F.C.
Julian_Dicks	playsFor	Birmingham_City_F.C.
Darren_Holloway	playsFor	Scunthorpe_United_F.C.
Chris_Barker	playsFor	Queens_Park_Rangers_F.C.
Eren_Şen	playsFor	Germany_national_youth_football_team
Bordeaux–Mérignac_Airport	isConnectedTo	Bristol_Airport
Christiaan_Pförtner	playsFor	Germany_national_youth_football_team
Luciano_de_Souza	playsFor	Santos_FC
Brian_Loftin	playsFor	Tampa_Bay_Mutiny
Máté_Tóth	playsFor	III._Kerületi_TUE
William_L._Kirk	hasWonPrize	Bronze_Star_Medal
Vítor_Hugo_Manique_de_Jesus	wasBornIn	Porto_Alegre
Bernardo_Fernandes_da_Silva	playsFor	Clube_Atlético_Paranaense
Vlada_Avramov	playsFor	A.C.D._Treviso_2013
Simón_Bolívar_International_Airport_(Venezuela)	isConnectedTo	El_Dorado_International_Airport
Ruslan_Levyha	playsFor	FC_Borysfen_Boryspil
Philipp_Lahm	playsFor	Germany_national_youth_football_team
Jacek_Wiśniewski	playsFor	Górnik_Zabrze
Eric_Obinna_Chukwunyelu	playsFor	1._FC_Kaiserslautern
Patrick_Ochs	playsFor	VfL_Wolfsburg
Montréal–Pierre_Elliott_Trudeau_International_Airport	isConnectedTo	Venice_Marco_Polo_Airport
Brussels_Airport	isConnectedTo	Amílcar_Cabral_International_Airport
Mark_Jackson_(footballer)	wasBornIn	Leeds
Macau_International_Airport	isConnectedTo	Zhengzhou_Xinzheng_International_Airport
Hoalid_Regragui	playsFor	Morocco_national_football_team
Arkadiusz_Czarnecki	playsFor	Lech_Poznań
Rafael_Jacques	playsFor	Real_Betis
Djerba–Zarzis_International_Airport	isConnectedTo	Sfax–Thyna_International_Airport
Tommy_Stark	playsFor	New_York_Field_Club
Leonel_Ríos	playsFor	Asteras_Tripoli_F.C.
Sheremetyevo_International_Airport	isConnectedTo	Almaty_International_Airport
Mario_Cáceres	playsFor	Lobos_de_la_BUAP
Rezart_Maho	playsFor	KS_Kastrioti
Stanton_Fredericks	playsFor	SuperSport_United_F.C.
Harutyun_Vardanyan	playsFor	BSC_Young_Boys
José_Manuel_Serrano	wasBornIn	Seville
Ufuk_Talay	playsFor	Sydney_FC
Martin_Hloušek	wasBornIn	Košice
Kermanshah_Airport	isConnectedTo	Mashhad_International_Airport
Marco_Gebhardt	playsFor	1._FC_Union_Berlin
Zagreb_Airport	isConnectedTo	Dubrovnik_Airport
Mike_Metcalf	playsFor	Rhyl_F.C.
Lumír_Sedláček	playsFor	FC_Hradec_Králové
Mustafa_Karim	playsFor	Baniyas_SC
Pasquale_Padalino	playsFor	Italy_national_football_team
Hasan_Gültang	playsFor	Gaziantepspor
Paulo_Roberto_da_Silva_Zaltron	playsFor	Sertãozinho_Futebol_Clube
Franklin_Vinosis_Webster	playsFor	C.D._Vista_Hermosa
Andrew_Durante	playsFor	Sydney_Olympic_FC
Michal_Bílek	playsFor	Real_Betis
Dimitar_Makriev	playsFor	PFC_Levski_Sofia
Jerel_Ifil	playsFor	Staines_Town_F.C.
Philadelphia_International_Airport	isConnectedTo	Gerald_R._Ford_International_Airport
Kris_Kelderman	playsFor	St._Louis_Ambush_(NPSL)
Kjell_Sture_Jensen	playsFor	FK_Haugesund
Santiago_Ostolaza	playsFor	Querétaro_F.C.
Itay_Shechter	playsFor	FC_Nantes
Francesco_Della_Rocca	playsFor	U.S._Città_di_Palermo
Ferrán_Tacón_Jiménez	playsFor	Cultural_y_Deportiva_Leonesa
Paul_Kinnaird	playsFor	St._Mirren_F.C.
Dave_Mooney	wasBornIn	Dublin
Michael_Pook	playsFor	Swindon_Town_F.C.
Eduard_Dubinski	playsFor	PFC_CSKA_Moscow
Leroy_Lita	playsFor	Birmingham_City_F.C.
Shenyang_Taoxian_International_Airport	isConnectedTo	Pyongyang_Sunan_International_Airport
Incheon_International_Airport	isConnectedTo	Nanchang_Changbei_International_Airport
José_Fernando_Viana_de_Santana	playsFor	Esporte_Clube_Democrata
Daniel_Sereinig	playsFor	FC_Schaffhausen
Joca	playsFor	AEL_Limassol
Miguel_Alfredo_Portillo	playsFor	FC_Vaduz
Patricio_Pérez	playsFor	Once_Caldas
Paolo_Frangipane	playsFor	Club_Atlético_Tigre
Yossi_Shivhon	playsFor	Hapoel_Petah_Tikva_F.C.
Pat_O'Toole_(footballer)	playsFor	Shelbourne_F.C.
Zbigniew_Kruszyński	playsFor	Kingstonian_F.C.
Walter_Guglielmone	playsFor	Club_Guaraní
Alessandro_Zamperini	playsFor	Ternana_Calcio
Les_Briley	playsFor	Wimbledon_F.C.
Victor_Mendy	playsFor	Senegal_national_football_team
Steve_Arnold_(footballer_born_1951)	playsFor	Dorchester_Town_F.C.
Gustavo_Victoria	playsFor	Deportes_Quindío
Jerome_Watt	playsFor	Morecambe_F.C.
Natale_Gonnella	playsFor	A.S._Gualdo_Casacastalda
Mazinho_Oliveira	playsFor	Santos_FC
Olivier_Occéan	playsFor	Southern_Connecticut_State_University
Allan_Brown_(footballer)	playsFor	Blackpool_F.C.
Mark_Viduka	playsFor	Middlesbrough_F.C.
Juanlu_(footballer_born_1980)	playsFor	CA_Osasuna
Shahjalal_International_Airport	isConnectedTo	Leonardo_da_Vinci–Fiumicino_Airport
Dmitry_Molosh	playsFor	FC_Krylia_Sovetov_Samara
Ben_Smith_(footballer_born_1986)	playsFor	Stockport_County_F.C.
Bradley_August	playsFor	Maritzburg_United_F.C.
Jordan_Opoku	playsFor	Feyenoord
Rodolfo_Dantas_Bispo	playsFor	Fluminense_FC
Bradley_International_Airport	isConnectedTo	Tampa_International_Airport
John_McGinlay	playsFor	North_Shore_United
Luigi_Pieroni	playsFor	FC_Nantes
War_of_the_Spanish_Succession	happenedIn	Portugal
Aleksandr_Dmitrijev	playsFor	Hønefoss_BK
Bernt_Haas	playsFor	FC_St._Gallen
Rogério_Oliveira_da_Costa	playsFor	FK_Vardar
David_Terrier	playsFor	US_Créteil-Lusitanos
Martin_Kushev	playsFor	1._FC_Saarbrücken
Nenad_Brnović	playsFor	Padideh_F.C.
Janko_Simović	playsFor	Montenegro_national_under-21_football_team
Carlos_Salazar_(Colombian_footballer)	playsFor	Deportivo_Pereira
Zhengzhou_Xinzheng_International_Airport	isConnectedTo	Yulin_Yuyang_Airport
Michael_Howard_(footballer)	wasBornIn	Birkenhead
Issa_Ba	playsFor	AJ_Auxerre
Kevin_Gallen	playsFor	Barnet_F.C.
David_Ellis_(footballer)	playsFor	Airdrieonians_F.C._(1878)
Pablo_Lenci	playsFor	Coquimbo_Unido
Márkó_Futács	playsFor	Hungary_national_under-19_football_team
Matías_Fernández	playsFor	Chile_national_under-20_football_team
Matt_Carbon	playsFor	England_national_under-21_football_team
Gennaro_Delvecchio	playsFor	Italy_national_football_team
Ron_Newman_(footballer)	playsFor	Leyton_Orient_F.C.
David_Castedo	playsFor	Sevilla_FC
Jonathan_Forte	playsFor	England_national_under-17_football_team
Saint-Augustin_Airport	isConnectedTo	Chevery_Airport
Sammy_Cox	playsFor	Dundee_F.C.
Jimmy_Smith_(footballer_born_1987)	playsFor	Norwich_City_F.C.
Iain_Russell	playsFor	Queen_of_the_South_F.C.
Barry_Silkman	playsFor	Barnet_F.C.
Charles_de_Gaulle_Airport	isConnectedTo	Düsseldorf_Airport
Nicola_Ventola	playsFor	Crystal_Palace_F.C.
Artyom_Voronkin	playsFor	FC_Terek_Grozny
Christian_Hanson_(footballer)	playsFor	Port_Vale_F.C.
Yevgeni_Kuznetsov_(footballer_born_1983)	playsFor	FC_Baltika_Kaliningrad
Niklas_Sandberg	playsFor	FK_Haugesund
Jack_Stewart_(soccer)	playsFor	Fort_Lauderdale_Strikers
Sergio_Leal	playsFor	Ergotelis_F.C.
Marco_Caligiuri	playsFor	VfB_Stuttgart_II
Altin_Haxhi	playsFor	PFC_Litex_Lovech
Ricardo_Vaz_Tê	playsFor	FC_Baltika_Kaliningrad
Eddie_Bailham	playsFor	Republic_of_Ireland_national_football_team
Lloyd_Kerry	playsFor	Chesterfield_F.C.
Luis_Fernando_Mosquera	playsFor	Independiente_Medellín
Habib_Habibou	playsFor	S.V._Zulte_Waregem
Eduardo_Allax	playsFor	Bangu_Atlético_Clube
New_Zealand	dealsWith	Singapore
Mads_Laudrup	wasBornIn	Milan
Tim_Flowers	playsFor	England_national_football_team
Kenneth_Brylle_Larsen	playsFor	PSV_Eindhoven
Michael_Guevara	playsFor	Peru_national_football_team
Marko_Kopilas	playsFor	Stuttgarter_Kickers
Mwanza_Airport	isConnectedTo	Julius_Nyerere_International_Airport
Neil_Cox_(footballer)	playsFor	Watford_F.C.
Georgi_Bizhev	playsFor	FC_Sportist_Svoge
Enfidha_–_Hammamet_International_Airport	isConnectedTo	Brno–Tuřany_Airport
Markus_Kreuz	playsFor	1._FC_Köln
Fábio_Braz	playsFor	Guaratinguetá_Futebol
