concept_politicianus_rudy_giuliani	concept:politicianrepresentslocation	concept_stateorprovince_new_york
concept_televisionstation_kvie	concept:agentcollaborateswithagent	concept_company_pbs
concept_beverage_beer	concept:beveragemadefrombeverage	concept_beverage_juices
concept_mammal_mammals	concept:animalpreyson	concept_mammal_rats
concept_shoppingmall_asheville	concept:locationlocatedwithinlocation	concept_website_description
concept_governmentorganization_office	concept:agentparticipatedinevent	concept_eventoutcome_result
concept_person_bill	concept:persongraduatedschool	concept_university_high_school
concept_stateorprovince_value	concept:agentparticipatedinevent	concept_eventoutcome_result
concept_person_barry	concept:persongraduatedschool	concept_university_state_university
concept_terroristorganization_money	concept:agentcollaborateswithagent	concept_terroristorganization_state
concept_company_samsung	concept:headquarteredin	concept_city_seoul
concept_person_martin	concept:persongraduatedschool	concept_university_state_university
concept_website_change	concept:agentparticipatedinevent	concept_eventoutcome_result
concept_person_adam001	concept:personmovedtostateorprovince	concept_stateorprovince_california
concept_musicartist_american	concept:agentactsinlocation	concept_city_spring_valley
concept_athlete_tony_romo	concept:athleteplaysinleague	concept_sportsleague_nfl
concept_university_national	concept:agentactsinlocation	concept_stateorprovince_afternoon
concept_musicartist_television	concept:agentcollaborateswithagent	concept_journalist_walter_cronkite
concept_city_newark	concept:locationlocatedwithinlocation	concept_stateorprovince_new_jersey
concept_athlete_ryan_theriot	concept:athleteplaysinleague	concept_sportsleague_mlb
concept_furniture_wardrobes	concept:furniturefoundinroom	concept_room_area
concept_stateorprovince_iowa	concept:stateorprovinceisborderedbystateorprovince	concept_stateorprovince_california
concept_mammal_deer	concept:mammalsuchasmammal	concept_mammal_sheep
concept_musicartist_american	concept:agentactsinlocation	concept_county_manhattan
concept_person_anderson	concept:personchargedwithcrime	concept_crimeorcharge_murder
concept_sportsteam_eagles	concept:teamplaysincity	concept_city_philadelphia
concept_sportsteam_bengals	concept:agentcollaborateswithagent	concept_athlete_lorenzen_wright
concept_city_edmonton	concept:citylocatedincountry	concept_country_canada_canada
concept_monarch_property	concept:agentparticipatedinevent	concept_eventoutcome_result
concept_animal_creatures	concept:animalpreyson	concept_arthropod_spiders
concept_stateorprovince_hawaii	concept:statelocatedincountry	concept_country_usa
concept_agriculturalproduct_products	concept:agriculturalproductincludingagriculturalproduct	concept_food_fiber
concept_city_saigon	concept:cityliesonriver	concept_river_mekong
concept_city_denver	concept:cityliesonriver	concept_attraction_grand
concept_personus_orlando_hudson	concept:athleteplaysinleague	concept_sportsleague_mlb
concept_musicartist_american	concept:agentactsinlocation	concept_county_new_mexico
concept_bank_citizens	concept:agentactsinlocation	concept_country_south_africa
concept_stateorprovince_minnesota	concept:statelocatedincountry	concept_country_us
concept_person_stephen	concept:agentcollaborateswithagent	concept_male_world
concept_city_washington_d_c	concept:locationlocatedwithinlocation	concept_country_us
concept_mammal_animals	concept:animalpreyson	concept_mammal_tigers
concept_animal_individuals	concept:agentparticipatedinevent	concept_eventoutcome_result
concept_agriculturalproduct_products	concept:agriculturalproductincludingagriculturalproduct	concept_food_tomatoes
concept_stateorprovince_west_virginia	concept:stateorprovinceisborderedbystateorprovince	concept_stateorprovince_pennsylvania
concept_meat_sausage	concept:agriculturalproductcutintogeometricshape	concept_geometricshape_bits
concept_person_butler001	concept:agentcollaborateswithagent	concept_personus_thomas_steen
concept_person_scott001	concept:personmovedtostateorprovince	concept_stateorprovince_new_york
concept_athlete_pujols	concept:athleteplaysinleague	concept_sportsleague_mlb
concept_city_santiago	concept:citylocatedincountry	concept_country_chile
concept_stateorprovince_idaho	concept:statelocatedincountry	concept_country_us
concept_mammal_big_cats	concept:animalpreyson	concept_mammal_tigers
concept_athlete_lebron	concept:athleteplaysinleague	concept_sportsleague_nba
concept_lake_new	concept:locationlocatedwithinlocation	concept_city_florida
concept_city_la_habra	concept:citylocatedinstate	concept_stateorprovince_california
concept_city_warren	concept:cityliesonriver	concept_attraction_grand
concept_agriculturalproduct_livestock	concept:agriculturalproductincludingagriculturalproduct	concept_mammal_hogs
concept_city_philadelphia	concept:cityliesonriver	concept_river_schuylkill
concept_male_world	concept:agentcollaborateswithagent	concept_person_stephen
concept_stateorprovince_georgia	concept:agentparticipatedinevent	concept_eventoutcome_result
concept_landscapefeatures_states	concept:locationlocatedwithinlocation	concept_website_east
concept_furniture_beds	concept:furniturefoundinroom	concept_room_style
concept_athlete_brad_ausmus_gg	concept:athleteplaysinleague	concept_sportsleague_mlb
concept_food_foliage	concept:plantincludeplant	concept_plant_pine
concept_personaustralia_smith	concept:agentcollaborateswithagent	concept_animal_head
concept_politicianus_president_bill_clinton	concept:politicianrepresentslocation	concept_country_u_s_
concept_furniture_beds	concept:furniturefoundinroom	concept_room_separate_lounge
concept_beverage_soft_drinks	concept:beveragemadefrombeverage	concept_beverage_juice
concept_drug_cymbalta	concept:drugworkedonbyagent	concept_biotechcompany_lilly
concept_city_orange	concept:citylocatedinstate	concept_stateorprovince_california
concept_city_greenwood	concept:citylocatedinstate	concept_stateorprovince_kansas
concept_lake_new	concept:locationlocatedwithinlocation	concept_blog_globe
concept_city_moscow	concept:citylocatedinstate	concept_stateorprovince_idaho
concept_athlete_chuck_james	concept:athleteplaysinleague	concept_sportsleague_mlb
concept_athlete_sidney_ponson	concept:athleteplaysinleague	concept_sportsleague_mlb
concept_person_jason	concept:persongraduatedschool	concept_university_state_university
concept_politicianus_lyndon_johnson	concept:politicianrepresentslocation	concept_country_u_s_
concept_agriculturalproduct_products	concept:agriculturalproductincludingagriculturalproduct	concept_agriculturalproduct_cheeses
concept_musicartist_american	concept:agentactsinlocation	concept_visualizablescene_dana_point
concept_city_taylor	concept:citylocatedinstate	concept_stateorprovince_iowa
concept_landscapefeatures_states	concept:locationlocatedwithinlocation	concept_city_texas
concept_company_daily_news001	concept:agentactsinlocation	concept_geopoliticallocation_the_new_york
concept_athlete_rajon_rondo	concept:athleteplaysinleague	concept_sportsleague_nba
concept_person_mark001	concept:personmovedtostateorprovince	concept_stateorprovince_illinois
concept_sportsteam_michigan_state	concept:teamplaysincity	concept_city_east_lansing
concept_male_gerald_ford	concept:politicianrepresentslocation	concept_country_u_s_
concept_athlete_o__j__simpson	concept:athleteplaysinleague	concept_sportsleague_nba
concept_coach_urban_meyer	concept:coachesteam	concept_sportsteam_florida_gators
concept_mammal_predators	concept:animalpreyson	concept_mammal_wolves
concept_city_duluth	concept:cityliesonriver	concept_attraction_grand
concept_mammal_rabbits	concept:animalpreyson	concept_animal_creatures
concept_agriculturalproduct_cotton	concept:agriculturalproductgrowinginstateorprovince	concept_stateorprovince_mississippi
concept_person_bill	concept:topmemberoforganization	concept_biotechcompany_microsoft_corp
concept_coach_j_j__hardy	concept:athleteplaysinleague	concept_sportsleague_mlb
concept_politician_jobs	concept:agentcollaborateswithagent	concept_actor_today
concept_lake_new	concept:locationlocatedwithinlocation	concept_country_left_parties
concept_animal_herbivores	concept:animalpreyson	concept_agriculturalproduct_pigs
concept_furniture_chairs	concept:furniturefoundinroom	concept_room_back
concept_musicartist_american	concept:agentactsinlocation	concept_stateorprovince_ardmore
concept_city_bulgaria	concept:locationlocatedwithinlocation	concept_country_countries
concept_politicianus_mr__bush	concept:politicianrepresentslocation	concept_stateorprovince_states
concept_furniture_beds	concept:furniturefoundinroom	concept_room_rest
concept_sportsteam_buccaneers	concept:teamplaysincity	concept_city_tampa_bay
concept_agriculturalproduct_livestock	concept:animalpreyson	concept_agriculturalproduct_goats
concept_company_post	concept:agentactsinlocation	concept_stateorprovince_the_washington
concept_city_pasco	concept:citylocatedinstate	concept_stateorprovince_florida
concept_ceo_john_chambers	concept:topmemberoforganization	concept_biotechcompany_cisco
concept_politicianus_harry_truman	concept:politicianrepresentslocation	concept_river_american
concept_person_scott001	concept:personmovedtostateorprovince	concept_stateorprovince_wisconsin
concept_country_zimbabwe	concept:agentparticipatedinevent	concept_eventoutcome_result
concept_sportsteam_ravens	concept:agentcollaborateswithagent	concept_athlete_joe_flacco
concept_sportsteam_los_angeles_lakers	concept:teamplaysincity	concept_city_boston
concept_politician_jobs	concept:personmovedtostateorprovince	concept_stateorprovince_oklahoma
concept_mammal_wolves	concept:animalpreyson	concept_mammal_predators
concept_mammal_small_animals	concept:animalpreyson	concept_agriculturalproduct_goats
concept_mammal_small_animals	concept:animalpreyson	concept_reptile_snakes
concept_city_san_clemente	concept:locationlocatedwithinlocation	concept_stateorprovince_california
concept_stateorprovince_arkansas	concept:statelocatedincountry	concept_country_usa
concept_bird_condor	concept:agentactsinlocation	concept_city_madrid
concept_animal_pet	concept:animalpreyson	concept_mammal_animals
concept_coach_document	concept:agentparticipatedinevent	concept_eventoutcome_result
concept_mammal_pets	concept:animalpreyson	concept_mammal_small_animals
concept_agriculturalproduct_products	concept:agriculturalproductincludingagriculturalproduct	concept_food_meal
concept_governmentorganization_government	concept:agentparticipatedinevent	concept_eventoutcome_result
concept_athlete_matt_murton	concept:athleteplaysinleague	concept_sportsleague_mlb
concept_furniture_sofa_bed	concept:furniturefoundinroom	concept_officebuildingroom_living_rooms
concept_city_birmingham	concept:citylocatedinstate	concept_stateorprovince_alabama
concept_automobilemaker_toyota	concept:automobilemakerdealersincity	concept_city_tucson
concept_politicianus_george_h_w__bush	concept:politicianrepresentslocation	concept_country_u_s_
concept_lake_new	concept:locationlocatedwithinlocation	concept_stateorprovince_alabama
concept_animal_head	concept:agentcollaborateswithagent	concept_personaustralia_smith
concept_website_fox_news	concept:newspaperincity	concept_city_washington_d_c
concept_mammal_horse	concept:animalpreyson	concept_mammal_horses
concept_river_arts	concept:locationlocatedwithinlocation	concept_county_york_city
concept_city_center	concept:locationlocatedwithinlocation	concept_stateorprovince_new_york
concept_politicianus_hillary_rodham_clinton	concept:politicianrepresentslocation	concept_stateorprovince_states
concept_politicianus_franklin_d__roosevelt	concept:politicianrepresentslocation	concept_country_u_s_
concept_company_nokia	concept:headquarteredin	concept_city_espoo
concept_nut_hypertension	concept:foodcancausedisease	concept_disease_hypertension
concept_company_national	concept:agentactsinlocation	concept_county_florence
concept_animal_birds002	concept:animalpreyson	concept_reptile_pets
concept_personus_jackie_robinson	concept:athleteplaysinleague	concept_sportsleague_mlb
concept_animal_organisms	concept:animalpreyson	concept_animal_humans
concept_musicartist_american	concept:agentactsinlocation	concept_aquarium_louis
concept_sportsteam_tampa_bay_rays	concept:teamplaysincity	concept_city_boston
concept_politicianus_palin	concept:agentcollaborateswithagent	concept_personnorthamerica_john_mccain
concept_bird_mammals	concept:animalpreyson	concept_reptile_pets
concept_furniture_double_beds	concept:furniturefoundinroom	concept_visualizablething_master_bedroom
concept_musicartist_american	concept:agentactsinlocation	concept_city_alpharetta
concept_politician_reagan	concept:politicianrepresentslocation	concept_country_usa
concept_stateorprovince_vermont	concept:stateorprovinceisborderedbystateorprovince	concept_stateorprovince_new_hampshire
concept_person_terry	concept:persongraduatedschool	concept_university_state_university
concept_lake_new	concept:locationlocatedwithinlocation	concept_geopoliticallocation_agencies
concept_stateorprovince_new_mexico	concept:stateorprovinceisborderedbystateorprovince	concept_stateorprovince_oklahoma
concept_ceo_mark_v__hurd	concept:topmemberoforganization	concept_company_hp
concept_city_new_york	concept:cityliesonriver	concept_river_columbia
concept_animal_head	concept:agentcollaborateswithagent	concept_person_davis
concept_company_disney	concept:acquired	concept_company_pixar
concept_automobilemaker_honda	concept:automobilemakerdealersincity	concept_city_milwaukee
concept_coach_dave_winfield	concept:athleteplaysinleague	concept_sportsleague_mlb
concept_athlete_chase_utley	concept:athleteplaysinleague	concept_sportsleague_mlb
concept_musicartist_news	concept:agentactsinlocation	concept_country_croatia
concept_country_honduras	concept:locationlocatedwithinlocation	concept_country_countries
concept_animal_hamsters	concept:animalpreyson	concept_mammal_animals
concept_person_moses	concept:persongraduatedschool	concept_university_college
concept_lake_new	concept:locationlocatedwithinlocation	concept_country_thailand
concept_wine_white_wine	concept:beveragemadefrombeverage	concept_beverage_juice
concept_agriculturalproduct_chocolate	concept:agriculturalproductcutintogeometricshape	concept_geometricshape_piece
concept_mammal_predators	concept:animalpreyson	concept_reptile_lizards
concept_drug_zyprexa	concept:drugworkedonbyagent	concept_biotechcompany_eli_lilly
concept_weapon_weapons	concept:weaponssuchasweapons	concept_weapon_nuclear_missile
concept_governmentorganization_clients	concept:agentparticipatedinevent	concept_crimeorcharge_offences
concept_governmentorganization_department	concept:agentcollaborateswithagent	concept_person_state
concept_biotechcompany_dow_chemical	concept:headquarteredin	concept_city_midland
concept_furniture_beds	concept:furniturefoundinroom	concept_visualizablething_master_suite
concept_university_national	concept:agentactsinlocation	concept_stateorprovince_georgia
concept_newspaper_herald	concept:newspaperincity	concept_city_boston
concept_company_national	concept:agentactsinlocation	concept_city_saint_louis
concept_city_birmingham	concept:cityliesonriver	concept_attraction_grand
concept_sportsteam_miami_dolphins	concept:teamplaysincity	concept_city_miami
concept_sportsteam_ncaa_youth_kids	concept:agentactsinlocation	concept_stadiumoreventvenue_spartan_stadium
concept_furniture_sofa_bed	concept:furniturefoundinroom	concept_officebuildingroom_living_room
concept_sportsteam_new_york_mets	concept:agentcollaborateswithagent	concept_athlete_carlos_beltran
concept_person_bill	concept:agentcollaborateswithagent	concept_company_clinton
