concept_profession_practitioners	concept:professionistypeofprofession	concept_profession_workers
concept_personasia_coup	concept:atdate	concept_dateliteral_n1980
concept_website_market	concept:atdate	concept_year_n1991
concept_mammal_bats	concept:specializationof	concept_mammal_animals
concept_academicfield_sociology	concept:academicprogramatuniversity	concept_university_state_university
concept_politicianus_rudy	concept:personbornincity	concept_city_york
concept_personus_earnest	concept:atdate	concept_date_n2003
concept_book_years	concept:atdate	concept_year_n1991
concept_physicalaction_production	concept:atdate	concept_date_n1944
concept_physicalaction_flight	concept:atdate	concept_dateliteral_n1936
concept_radiostation_wfyi	concept:agentbelongstoorganization	concept_televisionnetwork_pbs
concept_bathroomitem_closet	concept:itemfoundinroom	concept_officebuildingroom_spacious_master_bedroom
concept_island_operations	concept:atdate	concept_year_n1960
concept_island_head	concept:atdate	concept_dateliteral_n2006
concept_country_sierra_leone	concept:agentbelongstoorganization	concept_sportsleague_mls
concept_musicalbum_decades	concept:atlocation	concept_building_west
concept_weapon_national	concept:atlocation	concept_city_englewood
concept_person_aaron_brooks	concept:personborninlocation	concept_city_york
concept_beverage_coffee	concept:agriculturalproductcontainchemical	concept_chemical_antioxidants
concept_physicsterm_current_position	concept:atdate	concept_date_n2003
concept_athlete_jose_reyes	concept:athleteledsportsteam	concept_sportsteam_new_york_mets
concept_governmentorganization_launch	concept:atdate	concept_year_n1986
concept_city_roanoke	concept:proxyfor	concept_stateorprovince_virginia
concept_coach_marshall_faulk	concept:athleteplaysforteam	concept_sportsteam_rams
concept_physicalaction_position	concept:atdate	concept_year_n1984
concept_sociopolitical_war	concept:atdate	concept_dateliteral_n1812
concept_sport_football	concept:sportfansincountry	concept_country_netherlands
concept_politicalparty_parliament	concept:atdate	concept_date_n1993
concept_athlete_derrick_turnbow	concept:athleteplayssportsteamposition	concept_sportsteamposition_right_field
concept_food_eggs	concept:agriculturalproductcookedwithagriculturalproduct	concept_food_tomatoes
concept_physicalaction_position	concept:atdate	concept_dateliteral_n1990
concept_beverage_new	concept:atlocation	concept_stadiumoreventvenue_madison_square_garden
concept_crimeorcharge_petition	concept:atdate	concept_date_n2001
concept_male_gerald_green	concept:athleteplayssport	concept_sport_basketball
concept_mammal_predators	concept:animalsuchasinsect	concept_insect_lady_beetles
concept_athlete_print	concept:agentbelongstoorganization	concept_city_download
concept_coach_bob_bradley	concept:worksfor	concept_country_us
concept_stateorprovince_virginia	concept:statelocatedingeopoliticallocation	concept_country_u_s_
concept_furniture_size_bed	concept:itemfoundinroom	concept_room_lounge
concept_musicalbum_flood	concept:atdate	concept_year_n1997
concept_stateorprovince_states	concept:statelocatedingeopoliticallocation	concept_city_home
concept_weapon_national	concept:atlocation	concept_city_bossier_city
concept_company_microsoft	concept:agentinvolvedwithitem	concept_buildingfeature_window
concept_person_barry	concept:persongraduatedfromuniversity	concept_university_state_university
concept_personmexico_jose_molina	concept:athletehomestadium	concept_stadiumoreventvenue_yankee_stadium
concept_musicalbum_wedding	concept:atdate	concept_dateliteral_n2002
concept_city_troy	concept:atlocation	concept_stateorprovince_ohio
concept_mammal_elephants	concept:specializationof	concept_mammal_animals
concept_animal_children	concept:animaldevelopdisease	concept_disease_allergies
concept_bathroomitem_tubs	concept:itemfoundinroom	concept_officebuildingroom_deluxe_suites
concept_publication_ontario	concept:atdate	concept_year_n1992
concept_city_new_orleans	concept:atdate	concept_date_n2004
concept_academicfield_law	concept:academicprogramatuniversity	concept_university_college
concept_stateorprovince_states	concept:statelocatedingeopoliticallocation	concept_stateorprovince_massachusetts
concept_coach_chad_pennington	concept:athleteplayssport	concept_sport_football
concept_furniture_size_bed	concept:itemfoundinroom	concept_officebuildingroom_third_bedroom
concept_buildingfeature_american	concept:atlocation	concept_city_newark
concept_musicsong_night	concept:atdate	concept_date_n1962
concept_governmentorganization_governors	concept:proxyfor	concept_coach_new
concept_date_n2000	concept:proxyfor	concept_city_florida
concept_food_eggs	concept:agriculturalproductcamefromcountry	concept_country_germany
concept_athlete_hank_aaron	concept:athleteledsportsteam	concept_sportsteam_milwaukee_braves
concept_chemical_water	concept:chemicalistypeofchemical	concept_chemical_carbon_monoxide
concept_city_place	concept:atdate	concept_date_n1939
concept_journalist_maureen_dowd	concept:worksfor	concept_website_the_new_york_times
concept_male_christ_jesus	concept:personhasjobposition	concept_jobposition_lord
concept_governmentorganization_nation	concept:atdate	concept_date_n2003
concept_personmexico_adrian_gonzalez	concept:personbelongstoorganization	concept_company_new_york
concept_geopoliticallocation_national	concept:atlocation	concept_city_irvine
concept_city_washington_d_c	concept:proxyfor	concept_aquarium_u__s_
concept_city_father	concept:atdate	concept_date_n2004
concept_beverage_tea	concept:agriculturalproductcamefromcountry	concept_country_japan
concept_sport_cycling	concept:sportusesequipment	concept_tool_accessories
concept_furniture_sleeper_sofa	concept:itemfoundinroom	concept_room_area
concept_mammal_shrews	concept:animalsuchasinvertebrate	concept_animal_mammals001
concept_musicalbum_baby	concept:atdate	concept_date_n2003
concept_buildingfeature_american	concept:atlocation	concept_city_birmingham
concept_bank_hsbc	concept:bankbankincountry	concept_country_kuwait
concept_country_tanzania	concept:countrylocatedingeopoliticallocation	concept_stateorprovince_states
concept_country_egypt	concept:atdate	concept_date_n2009
concept_artery_ventricle	concept:bodypartcontainsbodypart	concept_bodypart_valve
concept_politicianus_president_reagan	concept:politicianusendorsedbypoliticianus	concept_politicianus_bush
concept_governmentorganization_commission	concept:atdate	concept_dateliteral_n2006
concept_politicaloffice_governor	concept:atdate	concept_dateliteral_n2005
concept_politicianus_palin	concept:politicianusendorsedbypoliticianus	concept_politicianus_senator_john_mccain
concept_person_david	concept:persongraduatedfromuniversity	concept_university_mit
concept_programminglanguage_pa	concept:atdate	concept_dateliteral_n2002
concept_company_missouri	concept:companyeconomicsector	concept_economicsector_insurance
concept_charactertrait_actions	concept:atdate	concept_dateliteral_n2008
concept_newspaper_winner	concept:atdate	concept_dateliteral_n2005
concept_musician_john	concept:musicianplaysinstrument	concept_musicinstrument_electric_guitar
concept_country_spain	concept:countrylocatedingeopoliticallocation	concept_geopoliticallocation_destinations
concept_physicalaction_back	concept:atdate	concept_date_n2000
concept_company_air_india	concept:hasofficeincity	concept_city_birmingham
concept_biotechcompany_cisco	concept:companyalsoknownas	concept_company_csco
concept_cognitiveactions_studies	concept:atdate	concept_dateliteral_n2006
concept_profession_members	concept:professionistypeofprofession	concept_profession_physicians
concept_insect_fly	concept:synonymfor	concept_insect_mosquito
concept_company_pakistan	concept:organizationhiredperson	concept_personmexico_ryan_whitney
concept_furniture_bathroom	concept:itemfoundinroom	concept_officebuildingroom_large_master
concept_profession_staff	concept:professionistypeofprofession	concept_profession_associates
concept_geometricshape_effect	concept:atdate	concept_date_n2004
concept_city_service	concept:atdate	concept_dateliteral_n1945
concept_chemical_compounds	concept:chemicalistypeofchemical	concept_chemical_sulfur
concept_sportsteam_cleveland_indians_organization	concept:teamplaysinleague	concept_sportsleague_mlb
concept_politician_jobs	concept:agentcontrols	concept_company_pixar
concept_emotion_appeal	concept:atdate	concept_date_n2001
concept_politicsissue_elections	concept:atdate	concept_year_n1989
concept_country_united_states	concept:atdate	concept_date_n1964
concept_comedian_day	concept:atdate	concept_year_n1919
concept_fish_swordfish	concept:fishservedwithfood	concept_bakedgood_butter
concept_governmentorganization_united_nations	concept:atdate	concept_dateliteral_n1947
concept_buildingfeature_american	concept:atlocation	concept_city_mission_viejo
concept_sport_soccer	concept:sportusesequipment	concept_sportsequipment_gear
concept_furniture_beds	concept:itemfoundinroom	concept_visualizablething_kitchen_area
concept_governmentorganization_testimony	concept:atdate	concept_dateliteral_n2005
concept_city_capital	concept:atdate	concept_date_n1993
concept_newspaper_la_times	concept:companyeconomicsector	concept_academicfield_media
concept_athlete_coco_crisp	concept:athleteplayssport	concept_sport_baseball
concept_city_covington	concept:atlocation	concept_stateorprovince_kentucky
concept_bathroomitem_toilet	concept:itemfoundinroom	concept_room_suite
concept_musicsong_two_weeks	concept:atdate	concept_dateliteral_n2007
concept_athlete_tiki_barber	concept:athleteplaysforteam	concept_sportsteam_new_york_giants
concept_company_national	concept:hasofficeincity	concept_city_littleton
concept_politicianus_joe_biden	concept:politicianusholdsoffice	concept_politicaloffice_vice_president
concept_chemical_silver	concept:chemicalistypeofchemical	concept_chemical_water
concept_profession_staff	concept:professionistypeofprofession	concept_profession_dancers
concept_athlete_andruw_jones	concept:athleteplayssport	concept_sport_baseball
concept_person_president	concept:personborninlocation	concept_county_york_city
concept_city_discussion	concept:atdate	concept_date_n2000
concept_athlete_rich_hill	concept:athletehomestadium	concept_stadiumoreventvenue_wrigley_field
concept_coach_jose_guillen	concept:coachwontrophy	concept_awardtrophytournament_world_series
concept_bakedgood_cookies	concept:bakedgoodservedwithbeverage	concept_beverage_soft_drinks
concept_sportsteam_new_york_jets	concept:organizationhiredperson	concept_person_edwards
concept_politicsissue_students	concept:atdate	concept_year_n1998
concept_athlete_beltran	concept:athleteplayssport	concept_sport_baseball
concept_city_augusta	concept:atlocation	concept_stateorprovince_kansas
concept_vegetable_green_beans	concept:agriculturalproductcookedwithagriculturalproduct	concept_food_peppers
concept_insect_ants	concept:invertebratefeedonfood	concept_plant_trees
concept_profession_teachers	concept:professionistypeofprofession	concept_profession_workers
concept_profession_prices	concept:professionusestool	concept_tool_supplements
concept_language_english	concept:languageofcountry	concept_country_barbados
concept_athlete_josh_fogg	concept:athleteplaysforteam	concept_sportsteam_rockies
concept_sportsteam_minnesota_vikings	concept:teamalsoknownas	concept_sportsteam_falcons
concept_buildingfeature_doors	concept:buildingfeaturemadefrombuildingmaterial	concept_buildingmaterial_oak
concept_person_karzai	concept:personleadsgeopoliticalorganization	concept_country_us
concept_bathroomitem_toilet	concept:itemfoundinroom	concept_officebuildingroom_suites
concept_geometricshape_peak	concept:atdate	concept_date_n2001
concept_person_marquis_daniels	concept:personalsoknownas	concept_person_eric_williams
concept_academicfield_science	concept:academicfieldsuchasacademicfield	concept_academicfield_microbiology
concept_country_japan	concept:atdate	concept_dateliteral_n2007
concept_weapon_national	concept:atlocation	concept_transportation_santa_barbara
concept_profession_professionals	concept:professionistypeofprofession	concept_profession_workers
concept_city_reviews	concept:atdate	concept_date_n1999
concept_musicalbum_suit	concept:atdate	concept_year_n1994
concept_politician_clinton	concept:politicianusendorsedbypoliticianus	concept_politicianus_senator_clinton
concept_academicfield_sciences	concept:academicprogramatuniversity	concept_university_institute
concept_animal_links	concept:agentinvolvedwithitem	concept_buildingfeature_window
concept_city_team	concept:agentcreated	concept_scientificterm_more_information_contact
concept_musicartist_king_crimson	concept:musicartistgenre	concept_musicgenre_rock
concept_country_oman	concept:countrylocatedingeopoliticallocation	concept_country_south_africa
concept_country_turkey	concept:atdate	concept_dateliteral_n2007
concept_arthropod_females	concept:invertebratefeedonfood	concept_beverage_nectar
concept_person_jonathan	concept:persongraduatedfromuniversity	concept_university_college
concept_food_oil	concept:agriculturalproductcookedwithagriculturalproduct	concept_meat_ham
concept_athlete_rajai_davis	concept:athletehomestadium	concept_stadiumoreventvenue_fenway
concept_book_services	concept:synonymfor	concept_politicaloffice_office
concept_academicfield_version	concept:atdate	concept_date_n2001
concept_politicianus_governor_sarah_palin	concept:politicianusendorsedbypoliticianus	concept_politicianus_mccain
concept_profession_dentists	concept:professionistypeofprofession	concept_profession_providers
concept_vehicle_states	concept:atlocation	concept_city_central
concept_journalist_nicholas_kristof	concept:journalistwritesforpublication	concept_newspaper_times
concept_athlete_randy_johnson	concept:coachwontrophy	concept_awardtrophytournament_world_series
concept_book_friends	concept:atdate	concept_dateliteral_n2008
concept_eventoutcome_establishment	concept:proxyfor	concept_book_new
concept_musicartist_white_stripes	concept:musicartistgenre	concept_musicgenre_garage
concept_wine_white_wine	concept:agriculturalproductcookedwithagriculturalproduct	concept_agriculturalproduct_salt
concept_athlete_matt_garza	concept:athleteplaysforteam	concept_sportsteam_tampa_bay_devil_rays
concept_city_middletown	concept:proxyfor	concept_stateorprovince_newjersey
concept_visualizablescene_apartment	concept:proxyfor	concept_politicaloffice_new
concept_city_calgary	concept:proxyfor	concept_stateorprovince_alberta
concept_bathroomitem_tubs	concept:itemfoundinroom	concept_room_bath
concept_programminglanguage_command	concept:atdate	concept_date_n1941
concept_programminglanguage_stores	concept:atdate	concept_date_n2001
concept_weapon_national	concept:atlocation	concept_city_chester
concept_insect_mites	concept:animalsuchasinsect	concept_arthropod_arthropods
concept_profession_lecturers	concept:professionistypeofprofession	concept_profession_experts
concept_male_faculty	concept:atdate	concept_date_n2009
concept_governmentorganization_applications	concept:atdate	concept_dateliteral_n2005
concept_city_plymouth	concept:proxyfor	concept_country_england
concept_bedroomitem_bed	concept:itemfoundinroom	concept_room_way
concept_profession_lawyers	concept:professionistypeofprofession	concept_profession_leaders
concept_jobposition_treasurer	concept:atdate	concept_dateliteral_n2008
concept_person_davis	concept:personbornincity	concept_city_york
concept_person_randy001	concept:personbelongstoorganization	concept_sportsteam_state_university
concept_website_men	concept:atdate	concept_date_n1999
concept_journalist_seymour_hersh	concept:journalistwritesforpublication	concept_politicsblog_new_times
concept_sport_skiing	concept:sportschoolincountry	concept_country_sweden
concept_automobilemaker_contact	concept:agentcreated	concept_website_download
concept_animal_dog001	concept:animaldevelopdisease	concept_disease_lyme_disease
concept_visualizablething_loan	concept:atdate	concept_dateliteral_n2002
concept_celebrity_service_contact	concept:agentcreated	concept_website_information
concept_politicianus_kerry	concept:politicianusendorsedbypoliticianus	concept_politicianus_al_gore
concept_country_malaysia	concept:countrylocatedingeopoliticallocation	concept_stateorprovince_states
concept_city_home	concept:atdate	concept_dateliteral_n2008
concept_room_dates	concept:atdate	concept_dateliteral_n2007
concept_athlete_freddy_sanchez	concept:athleteledsportsteam	concept_sportsteam_new_york_mets
concept_musician_agencies	concept:agentbelongstoorganization	concept_governmentorganization_us_department
concept_awardtrophytournament_world_series	concept:atdate	concept_date_n1993
concept_charactertrait_opening	concept:atdate	concept_dateliteral_n2002
concept_stadiumoreventvenue_honda_center	concept:stadiumlocatedincity	concept_city_anaheim
concept_transportation_final_report	concept:atdate	concept_date_n2001
concept_buildingfeature_locations	concept:atdate	concept_dateliteral_n2007
concept_olympics_implementation	concept:atdate	concept_dateliteral_n2007
concept_agriculturalproduct_fruits	concept:agriculturalproductcontainchemical	concept_chemical_acids
concept_island_iceland	concept:atdate	concept_dateliteral_n2008
concept_sportsteam_astros	concept:teamplayssport	concept_sport_baseball
concept_celebrity_season	concept:atdate	concept_dayofweek_thursday
concept_person_beth	concept:personbelongstoorganization	concept_sportsteam_state_university
concept_city_service	concept:atdate	concept_date_n1939
concept_coach_seneca_wallace	concept:coachwontrophy	concept_awardtrophytournament_super_bowl_xlii
concept_city_team	concept:agentcreated	concept_website_telephone
concept_agriculturalproduct_black_pepper	concept:agriculturalproductcookedwithagriculturalproduct	concept_vegetable_rosemary
concept_coach_brandon_braboy	concept:athleteplaysforteam	concept_sportsteam_cleveland_browns
concept_coach_randor_bierd	concept:athleteflyouttosportsteamposition	concept_sportsteamposition_center
concept_company_campus	concept:atdate	concept_date_n1999
concept_personus_portland	concept:atdate	concept_date_n1996
concept_university_message	concept:agentinvolvedwithitem	concept_buildingfeature_window
concept_academicfield_technology	concept:academicfieldsuchasacademicfield	concept_academicfield_information_technology
concept_attraction_academy	concept:atdate	concept_dateliteral_n2007
concept_country___america	concept:countrylocatedingeopoliticallocation	concept_country_countries
concept_clothing_positions	concept:atdate	concept_dateliteral_n2007
concept_chemical_dioxides	concept:chemicalistypeofchemical	concept_chemical_pollutants
concept_emotion_charity	concept:atdate	concept_date_n2003
concept_perceptionaction_hearing	concept:atdate	concept_date_n1993
concept_personmexico_brendan_harris	concept:athleteplayssport	concept_sport_baseball
concept_personus_administrator	concept:atdate	concept_dateliteral_n2002
concept_company_national	concept:hasofficeincity	concept_city_gardena
concept_athlete_brian_schneider	concept:athleteplaysforteam	concept_sportsteam_new_york_mets
concept_company_adobe	concept:agentcreated	concept_vehicle_view
concept_animal_organisms	concept:animalsuchasinsect	concept_insect_flies
concept_agriculturalproduct_beets	concept:agriculturalproductcookedwithagriculturalproduct	concept_vegetable_pepper
concept_country_left_parties	concept:atdate	concept_dateliteral_n2008
concept_agriculturalproduct_flowers	concept:agriculturalproductcamefromcountry	concept_country_taiwan
concept_profession_massage_therapists	concept:professionistypeofprofession	concept_profession_staff
concept_vertebrate_herds	concept:ismultipleof	concept_mammal_elephants
concept_company_money	concept:agentbelongstoorganization	concept_country_united_states
concept_city_madrid	concept:atdate	concept_dateliteral_n2007
concept_academicfield_arts	concept:academicfieldsuchasacademicfield	concept_academicfield_economics
concept_musicalbum_picture	concept:atdate	concept_date_n2004
concept_jobposition_partner	concept:atdate	concept_dateliteral_n2007
concept_vegetable_pepper	concept:agriculturalproductcookedwithagriculturalproduct	concept_food_bell_peppers
concept_food_tomatoes	concept:agriculturalproductcookedwithagriculturalproduct	concept_vegetable_vinegar
concept_profession_providers	concept:professionistypeofprofession	concept_profession_massage_therapists
concept_profession_educators	concept:professionusestool	concept_tool_tools
concept_sport_sailing	concept:sportfansincountry	concept_country___america
concept_artery_brain	concept:bodypartcontainsbodypart	concept_bodypart_injury
concept_company_national	concept:hasofficeincity	concept_city_fresno
concept_city_caldwell	concept:atlocation	concept_stateorprovince_idaho
concept_visualartist_warhol	concept:personborninlocation	concept_city_york
concept_website_clients	concept:atdate	concept_dateliteral_n2005
concept_chemical_carbon	concept:chemicalistypeofchemical	concept_chemical_dust
concept_city_article	concept:atdate	concept_date_n2001
concept_city_pictures	concept:proxyfor	concept_politicaloffice_new
concept_city_home	concept:atdate	concept_date_n2001
concept_athlete_deltha_o_neal	concept:athleteplaysforteam	concept_sportsteam_suns
concept_beverage_new	concept:atlocation	concept_visualizablething_residence
concept_chemical_chemicals	concept:chemicalistypeofchemical	concept_chemical_substances
concept_geopoliticalorganization_policies	concept:organizationhiredperson	concept_personmexico_ryan_whitney
concept_governmentorganization_ways	concept:proxyfor	concept_coach_new
concept_buildingfeature_doors	concept:atdate	concept_year_n1981
concept_beverage_buttermilk	concept:beveragecontainsprotein	concept_protein_ingredients
concept_person_republican	concept:personhasresidenceingeopoliticallocation	concept_county_san_diego
concept_jobposition_treasurer	concept:proxyfor	concept_book_new
concept_person_charles001	concept:personhascitizenship	concept_country_norway
concept_musician_eddie	concept:musicianplaysinstrument	concept_musicinstrument_drums
concept_mountain_expedition	concept:atdate	concept_dateliteral_n2007
concept_geopoliticalorganization_customers	concept:proxyfor	concept_book_new
concept_weapon_national	concept:atlocation	concept_airport_juneau
concept_personaustralia_smith	concept:athleteplayssportsteamposition	concept_sportsteamposition_left_center
concept_city_children	concept:atdate	concept_date_n2001
concept_book_guests	concept:atdate	concept_date_n2003
concept_hotel_royal	concept:atlocation	concept_country_canada_canada
concept_stadiumoreventvenue_rogers_centre	concept:stadiumlocatedincity	concept_city_toronto
concept_musicgenre_rock	concept:musicgenressuchasmusicgenres	concept_musicgenre_folk
concept_profession_workers	concept:professionistypeofprofession	concept_profession_doctors
concept_election_northern_ireland	concept:atdate	concept_date_n2000
concept_person_partner	concept:atdate	concept_date_n2004
concept_comedian_day	concept:atdate	concept_dateliteral_n2010
concept_governmentorganization_print	concept:atdate	concept_date_n2009
concept_country_united_states	concept:atdate	concept_year_n1948
concept_country_honduras	concept:atdate	concept_year_n1998
concept_chemical_nitrogen	concept:chemicalistypeofchemical	concept_chemical_materials
concept_perceptionaction_retirement	concept:atdate	concept_year_n1997
concept_hobby_activities	concept:hobbiessuchashobbies	concept_sport_hunting
concept_city_prague	concept:atdate	concept_dateliteral_n2008
concept_company_easyjet	concept:hasofficeincity	concept_city_uk
concept_profession_workers	concept:professionistypeofprofession	concept_profession_care_professionals
concept_sportsteam_steelers	concept:teamwontrophy	concept_awardtrophytournament_super_bowl_xlii
concept_museum_pbs	concept:atdate	concept_date_n2004
concept_male_constantine	concept:personhasjobposition	concept_jobposition_king
concept_color_sky	concept:thinghascolor	concept_color_green
concept_athlete_playoff	concept:atdate	concept_year_n1998
concept_company_jetblue	concept:hasofficeincity	concept_city_oakland
concept_country_poland	concept:atdate	concept_dateliteral_n2006
concept_politicianus_president_george_w__bush	concept:politicianusendorsedbypoliticianus	concept_politicianus_bill_clinton
concept_athlete_troy_tulowitzki	concept:athleteplaysforteam	concept_sportsteam_rockies
concept_book_evening	concept:atdate	concept_date_n2004
concept_person_edward001	concept:personhascitizenship	concept_country_england
concept_celebrity_lawsuit	concept:atdate	concept_dateliteral_n2002
concept_company_national	concept:hasofficeincity	concept_city_downers_grove
concept_furniture_beds	concept:itemfoundinroom	concept_officebuildingroom_accommodations
concept_coach_matt_holiday	concept:athleteplayssport	concept_sport_baseball
concept_book_film	concept:atdate	concept_dateliteral_n2008
concept_musicartist_policy	concept:agentcontrols	concept_clothing_white
concept_wallitem_beginning	concept:atdate	concept_year_n1997
concept_sociopolitical_war	concept:atdate	concept_year_n1861
concept_visualizablething_loan	concept:atdate	concept_dateliteral_n2008
concept_politicianus_presidential_election	concept:atdate	concept_date_n2009
concept_bodypart_pancreas	concept:bodypartcontainsbodypart	concept_bodypart_immune_system
concept_coach_evgeni_malkin	concept:coachwontrophy	concept_awardtrophytournament_stanley_cup_finals
concept_book_release	concept:atdate	concept_date_n1972
concept_weapon_national	concept:atlocation	concept_city_poway
concept_profession_education	concept:professionistypeofprofession	concept_profession_specialists
concept_book_years	concept:proxyfor	concept_politicaloffice_central
concept_sportsteam_miami_dolphins	concept:organizationhiredperson	concept_person_don_shula
concept_city_orlando	concept:atdate	concept_date_n2003
concept_scientist_assistant_professor	concept:atdate	concept_dateliteral_n2008
concept_academicfield_engineering	concept:academicprogramatuniversity	concept_university_institute
concept_building_west	concept:atdate	concept_dateliteral_n2005
concept_bathroomitem_tub_shower	concept:itemfoundinroom	concept_officebuildingroom_rooms
concept_county_utah	concept:organizationhiredperson	concept_coach_urban_meyer
concept_sportsteam_packers	concept:teamwontrophy	concept_awardtrophytournament_division
concept_journalist_dana_priest	concept:journalistwritesforpublication	concept_website_washington_post
concept_book_amsterdam	concept:atdate	concept_date_n2004
concept_invertebrate_teens	concept:animaldevelopdisease	concept_disease_spectrum_disorders
concept_politicalparty_league	concept:atdate	concept_year_n1997
concept_person_kim	concept:personbornincity	concept_city_york
concept_profession_professionals	concept:professionistypeofprofession	concept_profession_representatives
concept_vegetable_onion	concept:agriculturalproductcookedwithagriculturalproduct	concept_vegetable_onions
concept_newspaper_chief_executive_officer	concept:atdate	concept_dateliteral_n2007
concept_politicianus_dick_cheney	concept:worksfor	concept_retailstore_halliburton
concept_company_national	concept:hasofficeincity	concept_city_belmont
concept_software_deployment	concept:atdate	concept_date_n2001
concept_coach_carlos_marmol	concept:athleteplayssportsteamposition	concept_sportsteamposition_right_center
concept_musicsong_jerusalem	concept:atdate	concept_date_n2004
concept_sportsteam_steelers	concept:teamwontrophy	concept_awardtrophytournament_division
concept_tradeunion_congress	concept:organizationhiredperson	concept_personmexico_ryan_whitney
concept_emotion_pains	concept:emotionassociatedwithdisease	concept_disease_symptoms
concept_mammal_animals	concept:specializationof	concept_mammal_sheep
concept_food_cilantro	concept:agriculturalproductcookedwithagriculturalproduct	concept_food_peppers
concept_profession_professionals	concept:professionistypeofprofession	concept_jobposition_doctor
concept_visualizablething_settlement	concept:atdate	concept_date_n2004
concept_insect_aphids	concept:invertebratefeedonfood	concept_food_foliage
concept_profession_staff	concept:professionistypeofprofession	concept_profession_health_care_professionals
concept_bodypart_tissue001	concept:bodypartcontainsbodypart	concept_artery_brain
concept_book_forum	concept:atdate	concept_dateliteral_n2007
concept_city_pittsburgh	concept:proxyfor	concept_stateorprovince_pennsylvania
concept_politicianus_introduced	concept:atdate	concept_dateliteral_n2007
concept_journalist_dana_milbank	concept:journalistwritesforpublication	concept_website_washington_post
concept_building_times	concept:atlocation	concept_city_central
concept_crimeorcharge_arrest	concept:atdate	concept_year_n1997
concept_athlete_joba_chamberlain	concept:athleteflyouttosportsteamposition	concept_sportsteamposition_center
concept_meat_pork	concept:agriculturalproductcookedwithagriculturalproduct	concept_vegetable_cabbage
concept_city_newsletter	concept:atdate	concept_dateliteral_n2002
concept_profession_health_professionals	concept:professionistypeofprofession	concept_profession_workers
concept_monument_troops	concept:atdate	concept_date_n2003
concept_sportsteam_expos	concept:teamplayssport	concept_sport_baseball
concept_musicalbum_suit	concept:atdate	concept_date_n1996
concept_buildingfeature_windows	concept:buildingfeaturemadefrombuildingmaterial	concept_buildingmaterial_metal
concept_bodypart_tube	concept:itemfoundinroom	concept_visualizablething_bathrooms
concept_country_ethiopia	concept:atdate	concept_date_n2004
concept_personus_officials	concept:agentbelongstoorganization	concept_terroristorganization_state
concept_geopoliticallocation_corporation	concept:atdate	concept_dateliteral_n2006
concept_chemical_oil	concept:chemicalistypeofchemical	concept_chemical_hydrocarbons
concept_person_david004	concept:worksfor	concept_musicartist_times
concept_company_canada	concept:atdate	concept_year_n1992
concept_stateorprovince_california	concept:atdate	concept_year_n1967
concept_insect_insects	concept:arthropodandotherarthropod	concept_insect_wasps
concept_insect_beneficial_insects	concept:arthropodandotherarthropod	concept_insect_beetles
concept_city_team	concept:agentcontrols	concept_clothing_white
concept_profession_consultants	concept:professionistypeofprofession	concept_profession_leaders
concept_island_operations	concept:atdate	concept_date_n1977
concept_country_thailand	concept:countrylocatedingeopoliticallocation	concept_city_members
concept_person_prince	concept:agentinvolvedwithitem	concept_musicinstrument_guitar
concept_country_finland	concept:atdate	concept_year_n1994
concept_county_bedford	concept:proxyfor	concept_coach_new
concept_city_carson	concept:proxyfor	concept_stateorprovince_california
concept_politician_jobs	concept:personbelongstoorganization	concept_university_oracle
concept_perceptionaction_last_meeting	concept:atdate	concept_date_n2004
concept_athlete_marvin_harrison	concept:athleteplaysforteam	concept_sportsteam_colts
concept_person_eric_williams	concept:personalsoknownas	concept_personus_brent_barry
concept_city_orange	concept:proxyfor	concept_stateorprovince_california
concept_comedian_day	concept:atdate	concept_year_n1865
concept_male_adam	concept:musicianplaysinstrument	concept_musicinstrument_guitar
concept_language_russian	concept:languageofuniversity	concept_university_harvard
concept_athlete_clay_buchholz	concept:athletehomestadium	concept_stadiumoreventvenue_fenway
concept_politicsissue_requirements	concept:atdate	concept_dateliteral_n2005
concept_city_stuttgart	concept:atlocation	concept_stateorprovince_arkansas
concept_personus_fema	concept:agentcontrols	concept_person_mike_widomski
concept_academicfield_business	concept:academicfieldsuchasacademicfield	concept_academicfield_business_administration
concept_biotechcompany_boeing_commercial_airplanes	concept:organizationheadquarteredincity	concept_city_chicago
concept_chemical_carbon	concept:chemicalistypeofchemical	concept_chemical_inert_gas
concept_university_state_university	concept:organizationalsoknownas	concept_university_kansas_state
concept_nondiseasecondition_period	concept:atdate	concept_dateliteral_n2008
concept_sport_baseball	concept:sportusesequipment	concept_sportsequipment_apparel
concept_person_sri_lanka	concept:atdate	concept_dateliteral_n2007
concept_buildingfeature_american	concept:atlocation	concept_city_huntington_beach
concept_jobposition_economist	concept:atdate	concept_dateliteral_n2005
concept_transportation_santa_barbara	concept:touristattractionsuchastouristattraction	concept_attraction_temple_of_the_reclining_buddha
concept_city_construction	concept:atdate	concept_dateliteral_n2005
concept_governmentorganization_house	concept:atdate	concept_date_n1968
concept_director_one_day	concept:atdate	concept_year_n1983
concept_stateorprovince_states	concept:statelocatedingeopoliticallocation	concept_city_beijing
concept_city_library	concept:atdate	concept_dateliteral_n2007
concept_female_yankees	concept:agentbelongstoorganization	concept_sportsleague_mlb
concept_sportsequipment_tours	concept:proxyfor	concept_book_new
concept_geopoliticallocation_show	concept:atdate	concept_year_n1997
concept_musicsong_two_weeks	concept:atdate	concept_year_n1997
concept_musicalbum_reality	concept:atdate	concept_date_n2000
concept_governmentorganization_fire	concept:atdate	concept_year_n1865
concept_athlete_vinny_del_negro	concept:coachesinleague	concept_sportsleague_nba
concept_chemical_methane	concept:chemicalistypeofchemical	concept_chemical_greenhouse_gases
concept_profession_staff	concept:professionusestool	concept_tool_tools
concept_sportsteam_raptors	concept:teamplaysinleague	concept_sportsleague_nba
concept_sport_skiing	concept:proxyfor	concept_book_new
concept_country_west_indies	concept:atdate	concept_date_n2004
concept_athlete_herman_edwards	concept:worksfor	concept_sportsteam_kansas_city_chiefs
concept_coach_mike_sherman	concept:worksfor	concept_city_green_bay
concept_profession_division	concept:atdate	concept_date_n2004
concept_food_eggs	concept:agriculturalproductcomingfromvertebrate	concept_bird_falcons
concept_language_english	concept:languageofcountry	concept_country_jamaica
concept_profession_providers	concept:professionistypeofprofession	concept_profession_physical_therapists
concept_city_taipei	concept:proxyfor	concept_city_taiwan
concept_politicsissue_programs	concept:atdate	concept_date_n2003
concept_insect_termites	concept:arthropodandotherarthropod	concept_insect_pests
concept_person_queen	concept:personhascitizenship	concept_country_australia
concept_food_eggs	concept:agriculturalproductcomingfromvertebrate	concept_animal_fowl
concept_transportation_operation	concept:atdate	concept_date_n1979
concept_musicalbum_luxembourg	concept:atdate	concept_dateliteral_n2005
concept_city_home	concept:atdate	concept_dateliteral_n2006
concept_city_place	concept:atdate	concept_date_n1962
concept_physicsterm_current_position	concept:atdate	concept_date_n2000
concept_politicianus_harry_s__truman	concept:politicianusholdsoffice	concept_politicaloffice_president
concept_politicianus_john	concept:politicianusholdsoffice	concept_politicaloffice_president
concept_governmentorganization_federal_register	concept:atdate	concept_dateliteral_n2002
concept_musicsong_resignation	concept:atdate	concept_year_n1997
concept_nerve_muscles	concept:bodypartcontainsbodypart	concept_bodypart_system002
concept_academicfield_association	concept:atdate	concept_dateliteral_n2007
concept_visualizablething_use	concept:organizationhiredperson	concept_personmexico_ryan_whitney
concept_country_united_states	concept:atdate	concept_date_n1962
concept_visualizablething_alturas	concept:proxyfor	concept_stateorprovince_california
concept_person_craig	concept:persongraduatedfromuniversity	concept_university_college
concept_scientificterm_random_variables	concept:conceptprerequisiteof	concept_scientificterm_hidden_markov_models
concept_bathroomitem_closet	concept:itemfoundinroom	concept_officebuildingroom_master_bath
concept_year_n1998	concept:proxyfor	concept_stateorprovince_oregon
concept_bathroomitem_separate_shower	concept:itemfoundinroom	concept_officebuildingroom_marble_bathrooms
concept_personmexico_ryan_whitney	concept:worksfor	concept_nongovorganization_gop
concept_stateorprovince_states	concept:statelocatedingeopoliticallocation	concept_country_republic_of_nicaragua
concept_country_usa	concept:atdate	concept_date_n2004
concept_room_coast	concept:atdate	concept_date_n2003
concept_person_don	concept:personhascitizenship	concept_country_republic_of_austria
concept_vegetable_pepper	concept:agriculturalproductcookedwithagriculturalproduct	concept_agriculturalproduct_salt
concept_perceptionaction_last_meeting	concept:atdate	concept_date_n2001
concept_country_sierra_leone	concept:atdate	concept_dateliteral_n2007
concept_sportsgame_two_days	concept:atdate	concept_dateliteral_n2002
concept_governmentorganization_department	concept:synonymfor	concept_university_state_university
concept_city_jakarta	concept:atdate	concept_dateliteral_n2007
concept_building_first_time	concept:atdate	concept_dateliteral_n1953
concept_city_challenge	concept:istallerthan	concept_publication_people_
concept_city_home	concept:organizationheadquarteredincity	concept_city_la
concept_book_release	concept:atdate	concept_date_n1944
concept_musician_agencies	concept:agentbelongstoorganization	concept_governmentorganization_government
concept_city_budapest	concept:atdate	concept_dateliteral_n2007
concept_mammal_dogs	concept:animaldevelopdisease	concept_disease_problems
concept_personmexico_zach_duke	concept:athleteplayssport	concept_sport_baseball
concept_politicsissue_public_policy	concept:academicprogramatuniversity	concept_university_institute
concept_governmentorganization_navy	concept:atdate	concept_dateliteral_n2007
concept_visualizablething_call	concept:atdate	concept_dateliteral_n2006
concept_sport_football	concept:sportfansincountry	concept_country_uk
concept_televisionshow_flight	concept:atdate	concept_dayofweek_saturday
concept_governmentorganization_governments	concept:atdate	concept_date_n1999
concept_city_avon	concept:atlocation	concept_stateorprovince_indiana
concept_country_algeria	concept:countrylocatedingeopoliticallocation	concept_stateorprovince_states
concept_personus_jeremy_shockey	concept:athleteplayssport	concept_sport_football
concept_athlete_cliff_floyd	concept:athleteledsportsteam	concept_sportsteam_tampa_bay_devil_rays
concept_physicalaction_programme	concept:atdate	concept_date_n2003
concept_politicsissue_students	concept:atdate	concept_dateliteral_n2002
concept_company_air_berlin	concept:hasofficeincity	concept_city_copenhagen
concept_drug_avastin	concept:drugpossiblytreatsphysiologicalcondition	concept_disease_breast_cancer
concept_agriculturalproduct_asparagus	concept:agriculturalproductcookedwithagriculturalproduct	concept_vegetable_pepper
concept_retailstore_clinic	concept:atdate	concept_year_n1997
concept_person_republican	concept:personhasresidenceingeopoliticallocation	concept_stateorprovince_new_jersey
concept_emotion_approval	concept:atdate	concept_date_n2003
concept_profession_consultants	concept:professionistypeofprofession	concept_profession_specialists
concept_charactertrait_agreement	concept:atdate	concept_year_n1995
concept_geopoliticalorganization_telephone	concept:atdate	concept_dateliteral_n2005
concept_city_decatur	concept:proxyfor	concept_stateorprovince_alabama
concept_coach_manny_diaz	concept:worksfor	concept_county_miami
concept_sportsteam_new_orleans_saints	concept:teamplaysinleague	concept_sportsleague_nfl
concept_food_heart	concept:fooddecreasestheriskofdisease	concept_disease_illness
concept_politicsissue_public	concept:atdate	concept_date_n2003
concept_website_introduction	concept:atdate	concept_dateliteral_n2008
concept_biotechcompany_cisco	concept:organizationalsoknownas	concept_company_csco
concept_animal_links	concept:agentinvolvedwithitem	concept_product_tab
concept_chemical_water	concept:chemicalistypeofchemical	concept_chemical_sugars
concept_animal_children	concept:animaldevelopdisease	concept_disease_cancer
concept_athlete_mike_lowell	concept:personbelongstoorganization	concept_sportsteam_red_sox
concept_person_clark	concept:persongraduatedfromuniversity	concept_university_state_university
concept_animal_freshwater_fish	concept:animalsuchasfish	concept_fish_bass
concept_geopoliticallocation_kuwait	concept:atdate	concept_year_n1991
concept_athlete_vernon_wells	concept:athleteflyouttosportsteamposition	concept_sportsteamposition_center
concept_governmentorganization_resolution	concept:atdate	concept_date_n2003
concept_weapon_swords	concept:weaponmadeincountry	concept_country_japan
concept_governmentorganization_capitol	concept:organizationhiredperson	concept_personmexico_ryan_whitney
concept_chemical_nitrous_oxide	concept:chemicalistypeofchemical	concept_chemical_chemicals
concept_athlete_phil_rizzuto	concept:athletehomestadium	concept_stadiumoreventvenue_yankee_stadium
concept_coach_georgetown	concept:atlocation	concept_skiarea_kentucky
concept_geometricshape_effect	concept:atdate	concept_year_n1998
concept_disease_breast_cancer	concept:atdate	concept_date_n2001
concept_musicartist_problems	concept:agentinvolvedwithitem	concept_beverage_win
concept_visualizablething_naples	concept:atdate	concept_dateliteral_n2002
concept_city_sao_paulo	concept:synonymfor	concept_city_rio
concept_county_manhattan	concept:proxyfor	concept_creditunion_kansas
concept_chemical_oxygen	concept:chemicalistypeofchemical	concept_chemical_chlorine
concept_company_nbc	concept:agentcontrols	concept_televisionstation_ktvb_tv
concept_weapon_national	concept:atlocation	concept_city_stockbridge
concept_city_home	concept:atdate	concept_date_n1972
concept_athlete_carl_yastrzemski	concept:athleteplaysforteam	concept_sportsteam_red_sox
concept_weapon_national	concept:atlocation	concept_city_cranford
concept_politicianus_palin	concept:personleadsorganization	concept_musicartist_town
concept_musicsong_suicide	concept:atdate	concept_date_n2000
concept_coach_p_j__carlesimo	concept:personalsoknownas	concept_person_p_j__brown
concept_ceo_alan_greenspan	concept:personleadsorganization	concept_bank_federal_reserve
concept_vegetable_pepper	concept:agriculturalproductcookedwithagriculturalproduct	concept_agriculturalproduct_herbs
concept_visualizablething_appointment	concept:atdate	concept_date_n2009
concept_museum_franklin	concept:atlocation	concept_attraction_louisiana
concept_politicalparty_senate	concept:organizationhiredperson	concept_personus_democratic
concept_programminglanguage_the_new	concept:proxyfor	concept_weapon_weeks
concept_city_ridgefield	concept:proxyfor	concept_stateorprovince_new_jersey
concept_landscapefeatures_file	concept:atdate	concept_date_n2003
concept_person_susan	concept:persongraduatedfromuniversity	concept_university_college
concept_bacteria_salmonella	concept:bacteriaisthecausativeagentofphysiologicalcondition	concept_disease_illnesses
concept_ceo_carly_fiorina	concept:ceoof	concept_biotechcompany_hewlett__packard
concept_politicianus_senator_obama	concept:politicianusendorsedbypoliticianus	concept_politicianus_mccain
concept_country_australia	concept:atdate	concept_year_n1975
concept_sportsteam_state_university	concept:teamplaysinleague	concept_sportsleague_international
concept_physicalaction_work	concept:atdate	concept_dateliteral_n2007
concept_physicalaction_women	concept:atdate	concept_dateliteral_n2007
concept_governmentorganization_payment	concept:agentinvolvedwithitem	concept_buildingfeature_window
concept_geometricshape_percent	concept:atdate	concept_dateliteral_n2008
concept_athlete_frank	concept:athleteplayssport	concept_sport_basketball
concept_geometricshape_earth	concept:atdate	concept_year_n1997
concept_country_djibouti	concept:countrycurrency	concept_currency_francs
concept_chemical_hydrogen_sulfide	concept:chemicalistypeofchemical	concept_chemical_carbon
concept_sportsgame_postseason	concept:atdate	concept_date_n2001
concept_perceptionaction_hearings	concept:atdate	concept_date_n1999
concept_academicfield_technology	concept:academicfieldsuchasacademicfield	concept_academicfield_biomedical_engineering
concept_country_israel	concept:atdate	concept_year_n1992
concept_city_purchase	concept:atdate	concept_date_n2009
concept_language_english	concept:languageofcountry	concept_country_england
concept_jobposition_group	concept:professionistypeofprofession	concept_profession_attorneys
concept_athlete_reggie_wayne	concept:coachesinleague	concept_sportsleague_nfl
concept_nongovorganization_council	concept:atdate	concept_year_n1988
concept_book_inception	concept:atdate	concept_year_n1992
concept_sport_football	concept:sportfansincountry	concept_country_spain
concept_musicgenre_prog	concept:musicgenressuchasmusicgenres	concept_musicgenre_rock
concept_university_google	concept:atdate	concept_dateliteral_n2006
concept_geometricshape_southern_california	concept:atdate	concept_dateliteral_n2008
concept_profession_workers	concept:professionistypeofprofession	concept_profession_educators
concept_physicsterm_current_position	concept:atdate	concept_dateliteral_n2008
concept_physicalaction_position	concept:atdate	concept_year_n1992
concept_charactertrait_heart_attack	concept:atdate	concept_date_n2000
concept_academicfield_industrial_engineering	concept:academicprogramatuniversity	concept_university_college
concept_chemical_oxide	concept:chemicalistypeofchemical	concept_chemical_substances
concept_person_king	concept:personhascitizenship	concept_country_republic_of_austria
concept_bathroomitem_tubs	concept:itemfoundinroom	concept_visualizablething_bedrooms
concept_nondiseasecondition_policy	concept:atdate	concept_year_n1994
concept_chemical_uranium	concept:chemicalistypeofchemical	concept_chemical_minerals
concept_nondiseasecondition_controversy	concept:atdate	concept_date_n1999
concept_profession_consultants	concept:professionistypeofprofession	concept_profession_nurses
concept_buildingfeature_doors	concept:atdate	concept_year_n1985
concept_eventoutcome_establishment	concept:atdate	concept_year_n1992
concept_fish_pike	concept:fishservedwithfood	concept_bakedgood_sauce
concept_street_public_meeting	concept:atdate	concept_dateliteral_n2006
concept_governmentorganization_resolution	concept:atdate	concept_dateliteral_n2002
concept_meat_salmon	concept:agriculturalproductcookedwithagriculturalproduct	concept_vegetable_pepper
concept_governmentorganization_governors	concept:atdate	concept_dateliteral_n2005
concept_athlete_andre_agassi_and_steffi_graf	concept:athletebeatathlete	concept_athlete_pete_sampras
concept_bodypart_healthy_tissue	concept:bodypartcontainsbodypart	concept_bodypart_system001
concept_bathroomitem_separate_shower	concept:itemfoundinroom	concept_visualizablething_bathroom
concept_politician_clinton	concept:politicianusendorsedbypoliticianus	concept_politicianus_senator_barack_obama
concept_chemical_coo	concept:atdate	concept_date_n2001
concept_musicartist_television	concept:atdate	concept_dateliteral_n2007
concept_personmexico_ryan_whitney	concept:worksfor	concept_company_press
concept_politician_clinton	concept:politicianusendorsedbypoliticianus	concept_politicianus_fdr
concept_arthropod_pollinators	concept:animalsuchasinsect	concept_insect_moths
concept_vehicle_states	concept:atlocation	concept_publication_atlantic
concept_comedian_day	concept:atdate	concept_date_n1941
concept_country_czech_republic	concept:atdate	concept_dateliteral_n2005
concept_transportation_operation	concept:atdate	concept_dateliteral_n1980
concept_lymphnode_lymph_nodes	concept:bodypartcontainsbodypart	concept_bodypart_system001
concept_coach_ncaa_tournament	concept:atdate	concept_year_n1984
concept_website_tour	concept:atdate	concept_month_october
concept_person_barbara001	concept:personbornincity	concept_city_orleans
concept_biotechcompany_merck___co	concept:synonymfor	concept_company_mrk
concept_vegetable_pepper	concept:agriculturalproductcookedwithagriculturalproduct	concept_food_eggs
concept_person_ed_whitacre	concept:worksfor	concept_company_american_management_systems
concept_bodypart_tract001	concept:bodypartcontainsbodypart	concept_bodypart_system001
concept_geometricshape_ship	concept:atdate	concept_dateliteral_n2002
concept_academicfield_technology	concept:academicfieldsuchasacademicfield	concept_politicsissue_education
concept_country_tunisia	concept:atdate	concept_dateliteral_n2007
concept_celebrity_venice	concept:proxyfor	concept_country_italy
concept_musicalbum_days	concept:atdate	concept_year_n1995
concept_personus_d__h__lawrence	concept:agentcontributedtocreativework	concept_book_the_rainbow
concept_chemical_benzene	concept:chemicalistypeofchemical	concept_chemical_compounds
concept_sport_basketball	concept:sportusesstadium	concept_stadiumoreventvenue_time_warner_cable_arena
concept_coach_vince_young	concept:athleteplayssport	concept_sport_football
concept_insect_insects	concept:animalsuchasinsect	concept_arthropod_mantis
concept_mldataset__	concept:atdate	concept_date_n1999
concept_person_sam	concept:personborninlocation	concept_city_york
concept_company_case	concept:atdate	concept_year_n1995
concept_bodypart_immune_system	concept:bodypartcontainsbodypart	concept_bodypart_system001
concept_insect_pests	concept:arthropodandotherarthropod	concept_insect_grasshoppers
concept_personaustralia_smith	concept:athleteplaysforteam	concept_sportsteam_florida_international
concept_sportsteam_tampa_bay_devil_rays	concept:teamwontrophy	concept_awardtrophytournament_pennant
