concept_city_bar	concept:mutualproxyfor	concept_beverage_new
concept_sport_ski	concept:sportfansincountry	concept_country_spain
concept_company_post	concept:agentactsinlocation	concept_country_republic_of_austria
concept_programminglanguage_presentation	concept:atdate	concept_year_n1998
concept_emotion_part	concept:atdate	concept_year_n1998
concept_profession_professors	concept:professionistypeofprofession	concept_profession_members
concept_company_west001	concept:hasofficeincountry	concept_country_south_africa
concept_governmentorganization_cabinet	concept:atdate	concept_date_n2001
concept_politicaloffice_central	concept:atlocation	concept_building_years
concept_bathroomitem_bath_tub	concept:itemfoundinroom	concept_officebuildingroom_modern_bathroom
concept_profession_meetings	concept:mutualproxyfor	concept_sportsequipment_new
concept_book_terms	concept:atdate	concept_dateliteral_n2006
concept_vegetable_peas	concept:agriculturalproductcookedwithagriculturalproduct	concept_vegetable_potatoes
concept_publication_people_	concept:atdate	concept_year_n1997
concept_buildingfeature_doors	concept:atdate	concept_dateliteral_n2007
concept_city_home	concept:atdate	concept_date_dec_
concept_country_croatia	concept:countrylocatedingeopoliticallocation	concept_country_countries
concept_person_ruth	concept:persongraduatedfromuniversity	concept_university_college
concept_nongovorganization_general_assembly	concept:atdate	concept_date_n2004
concept_animal_carnivores	concept:animalthatfeedoninsect	concept_insect_insects
concept_vegetable_spinach	concept:agriculturalproductcontainchemical	concept_chemical_iron
concept_musicalbum_baby	concept:atdate	concept_dateliteral_n2006
concept_book_morning	concept:atdate	concept_dateliteral_n2005
concept_terroristorganization_force	concept:atdate	concept_date_n2001
concept_chemical_coo	concept:atdate	concept_dateliteral_n2007
concept_country_qatar	concept:countrylocatedingeopoliticallocation	concept_country_south_africa
concept_company_new_york	concept:companyeconomicsector	concept_economicsector_insurance
concept_city_contract	concept:atdate	concept_date_n2003
concept_city_library	concept:atdate	concept_year_n1992
concept_musicalbum_fame	concept:atdate	concept_year_n1991
concept_physicalaction_formation	concept:atdate	concept_dateliteral_n2005
concept_musician_david	concept:musicianplaysinstrument	concept_musicinstrument_vocals
concept_politicianus_harry_reid	concept:politicianusendorsedbypoliticianus	concept_politician_clinton
concept_muscle_heart	concept:bodypartcontainsbodypart	concept_artery_pulmonary_artery
concept_agriculturalproduct_pigs	concept:animalpreyson	concept_mammal_small_animals
concept_newspaper_record	concept:organizationheadquarteredincity	concept_city_new_york
concept_city_york	concept:atlocation	concept_stateorprovince_new_york
concept_mammal_small_animals	concept:animalistypeofanimal	concept_mammal_raccoons
concept_nongovorganization_forces	concept:atdate	concept_date_n2003
concept_sociopolitical_war	concept:atdate	concept_dateliteral_n2005
concept_food_heart	concept:fooddecreasestheriskofdisease	concept_disease_heart_attack
concept_country_republic_of_india	concept:atdate	concept_date_n1999
concept_sportsteam_dallas_mavericks	concept:teamhomestadium	concept_stadiumoreventvenue_american_airlines_center
concept_person_taylor	concept:personbelongstoorganization	concept_sportsteam_state_university
concept_person_john003	concept:persongraduatedschool	concept_school_oxford
concept_visualizableobject_camera001	concept:atdate	concept_dateliteral_n2006
concept_biotechcompany_micron_technology	concept:hasofficeincity	concept_city_boise
concept_mammal_cats	concept:animalistypeofanimal	concept_mammal_rabbits
concept_profession_staff	concept:professionistypeofprofession	concept_profession_programmers
concept_animal_birds002	concept:animaleatfood	concept_food_crop
concept_insect_insect_pests	concept:invertebratefeedonfood	concept_plant_trees
concept_city_orlando	concept:citylocatedingeopoliticallocation	concept_city_florida
concept_mammal_mice	concept:mammalsuchasmammal	concept_mammal_deer
concept_musicartist_journal	concept:agentactsinlocation	concept_city_washington_d_c
concept_city_place	concept:atdate	concept_year_n1948
concept_company_post	concept:agentinvolvedwithitem	concept_buildingfeature_window
concept_candy_tea	concept:fooddecreasestheriskofdisease	concept_disease_cancer
concept_furniture_size_bed	concept:itemfoundinroom	concept_room_large_room
concept_automobilemaker_nissan	concept:companyeconomicsector	concept_economicsector_auto
concept_vehicle_research	concept:atdate	concept_dateliteral_n2006
concept_country_turkey	concept:atdate	concept_dateliteral_n2005
concept_furniture_size_bed	concept:itemfoundinroom	concept_visualizablething_bungalow
concept_politician_jobs	concept:agentcollaborateswithagent	concept_person_macintosh
concept_legume_soy	concept:fooddecreasestheriskofdisease	concept_disease_colon_cancer
concept_website_men	concept:atdate	concept_dateliteral_n2007
concept_plant_evergreens	concept:plantincludeplant	concept_plant_plants
concept_insect_pests	concept:animalthatfeedoninsect	concept_insect_beetle
concept_bedroomitem_car	concept:atdate	concept_date_n2001
concept_geopoliticalorganization_weather	concept:atdate	concept_dateliteral_n2007
concept_island_manhattan	concept:citylocatedingeopoliticallocation	concept_geopoliticallocation_national
concept_physicalaction_women	concept:atdate	concept_date_n2001
concept_person_chris	concept:persongraduatedfromuniversity	concept_university_state_university
concept_stateorprovince_indiana	concept:mutualproxyfor	concept_city_richmond
concept_sportsgame_playoffs	concept:sportsgameteam	concept_sportsteam_utah_jazz
concept_website_politics	concept:atdate	concept_dateliteral_n2005
concept_fruit_vegetables	concept:fooddecreasestheriskofdisease	concept_disease_prostate_cancer
concept_animal_children	concept:animaleatfood	concept_beverage_milk
concept_politicalparty_parliament	concept:atdate	concept_date_n2000
concept_book_new	concept:mutualproxyfor	concept_restaurant_melting_pot
concept_country_republic_of_guatemala	concept:atdate	concept_date_n2004
concept_city_augusta	concept:atlocation	concept_stateorprovince_kansas
concept_website_license	concept:atdate	concept_dateliteral_n2005
concept_governmentorganization_chief_financial_officer	concept:atdate	concept_date_n2004
concept_arthropod_invertebrates	concept:animalsuchasinvertebrate	concept_agriculturalproduct_shrimps
concept_website_experience	concept:organizationdissolvedatdate	concept_month_december
concept_musicalbum_subject	concept:atdate	concept_date_n1999
concept_politicianus_hillary_clinton	concept:politicianusendorsedbypoliticianus	concept_politicianus_lieberman
concept_city_title	concept:atdate	concept_year_n1998
concept_televisionshow_mission	concept:atdate	concept_dateliteral_n2007
concept_academicfield_control	concept:atdate	concept_date_n2003
concept_landscapefeatures_firm	concept:atdate	concept_dateliteral_n2008
concept_furniture_bed	concept:furniturefoundinroom	concept_visualizablething_studio_apartment
concept_profession_professionals	concept:professionistypeofprofession	concept_profession_nutritionists
concept_profession_education	concept:professionistypeofprofession	concept_profession_practitioners
concept_company_american_airlines001	concept:atlocation	concept_stateorprovince_new_york
concept_profession_professionals	concept:professionistypeofprofession	concept_profession_administrators
concept_website_tour	concept:atdate	concept_month_october
concept_politicianus_bob	concept:persongraduatedschool	concept_university_state_university
concept_musicalbum_idea	concept:atdate	concept_dateliteral_n2006
concept_bodypart_appearance	concept:atdate	concept_date_n2004
concept_profession_development	concept:professionistypeofprofession	concept_profession_professionals
concept_personus_roger_smith	concept:personbelongstoorganization	concept_stateorprovince_general_motors
concept_book_inception	concept:atdate	concept_year_n1997
concept_governmentorganization_authority	concept:atdate	concept_dateliteral_n2005
concept_bank_hsbc	concept:hasofficeincountry	concept_country_taiwan
concept_emotion_major_depression	concept:emotionassociatedwithdisease	concept_disease_illness
concept_politicianus_palin	concept:politicianholdsoffice	concept_politicaloffice_mayor
concept_politicsissue_violence	concept:atdate	concept_date_n1999
concept_crustacean_crab	concept:arthropodcalledarthropod	concept_crustacean_scallops
concept_musician_bach	concept:musicianplaysinstrument	concept_musicinstrument_guitar
concept_crustacean_lobster	concept:animaleatvegetable	concept_vegetable_rice
concept_person_mike	concept:personbelongstoorganization	concept_sportsteam_state_university
concept_sportsgame_league	concept:atdate	concept_month_september
concept_mammal_dogs	concept:animalistypeofanimal	concept_animal_house_pets
concept_insect_mosquitos	concept:arthropodandotherarthropod	concept_insect_bugs
concept_profession_care_professionals	concept:professionistypeofprofession	concept_profession_physicians
concept_politicianus_mr__obama	concept:politicianusendorsedbypoliticianus	concept_politicianus_mccain
concept_city_ashland	concept:atlocation	concept_stateorprovince_oregon
concept_musicgenre_rock	concept:musicgenressuchasmusicgenres	concept_musicgenre_heavy_metal
concept_crimeorcharge_prison	concept:atdate	concept_date_n2001
concept_food_oil	concept:agriculturalproductcookedwithagriculturalproduct	concept_vegetable_carrots
concept_bodypart_kidneys	concept:bodypartcontainsbodypart	concept_artery_arteries
concept_female_hillary	concept:agentcollaborateswithagent	concept_person_mccain
concept_musicalbum_cd	concept:atdate	concept_date_n2003
concept_island_proposal	concept:atdate	concept_date_n1996
concept_crimeorcharge_custody	concept:atdate	concept_date_n2000
concept_mammal_small_pets	concept:animalistypeofanimal	concept_mammal_small_dogs
concept_city_nature	concept:agentparticipatedinevent	concept_eventoutcome_result
concept_furniture_canopy_bed	concept:furniturefoundinroom	concept_visualizablescene_bedroom
concept_profession_teaching_staff	concept:professionistypeofprofession	concept_profession_experts
concept_sportsteam_anaheim_ducks	concept:teamplaysinleague	concept_sportsleague_nhl
concept_writer_greenspan	concept:personbelongstoorganization	concept_governmentorganization_fed
concept_city_fort_worth	concept:citylocatedinstate	concept_stateorprovince_texas
concept_city_madison	concept:atlocation	concept_stateorprovince_indiana
concept_bathroomitem_bathtubs	concept:itemfoundinroom	concept_visualizablething_bathrooms
concept_musicsong_night	concept:atdate	concept_date_n1966
concept_website_market	concept:atdate	concept_dateliteral_n1990
concept_food_fiber	concept:fooddecreasestheriskofdisease	concept_disease_breast_cancer
concept_island_recommendation	concept:atdate	concept_year_n1998
concept_mlauthor_alan_schwartz	concept:personleadsorganization	concept_bank_bear_stearns_companies
concept_charactertrait_opening	concept:atdate	concept_year_n1995
concept_company_npr	concept:companyeconomicsector	concept_academicfield_media
concept_weapon_national	concept:atlocation	concept_airport_juneau
concept_weapon_national	concept:atlocation	concept_country_philippines
concept_politicsissue_graduate	concept:atdate	concept_dateliteral_n2005
concept_musicartist_south	concept:agentactsinlocation	concept_blog_globe
concept_televisionnetwork_cbs	concept:agentcollaborateswithagent	concept_journalist_dan
concept_sport_fitness	concept:sportusesequipment	concept_sportsequipment_products
concept_city_part_time	concept:agentcontrols	concept_physicalaction_position
concept_country_japan	concept:countrylocatedingeopoliticallocation	concept_country_countries
concept_athlete_ryan	concept:personbelongstoorganization	concept_sportsteam_state_university
concept_musicartist_session	concept:atdate	concept_date_n1996
concept_animal_chicken001	concept:animaleatvegetable	concept_vegetable_veggies
concept_mlalgorithm_speech	concept:atdate	concept_year_n1997
concept_website_amazon	concept:hasofficeincountry	concept_country___america
concept_weapon_arms	concept:weaponmadeincountry	concept_country_colombia
concept_emotion_series	concept:atdate	concept_date_n2009
concept_company_services	concept:organizationalsoknownas	concept_governmentorganization_departments
concept_physicalaction_assembly	concept:atdate	concept_date_n1999
concept_reptile_invertebrates	concept:animalsuchasinvertebrate	concept_crustacean_larvae
concept_city_greenville	concept:citylocatedinstate	concept_stateorprovince_south_carolina
concept_city_murdoch	concept:agentcontrols	concept_company_news_corp001
concept_country_republic_of_india	concept:atdate	concept_year_n1984
concept_governmentorganization_panel	concept:atdate	concept_dateliteral_n2006
concept_musicartist_george	concept:atlocation	concept_city_washington_d_c
concept_governmentorganization_commission	concept:atdate	concept_date_n2001
concept_politician_clinton	concept:politicianusendorsedbypoliticianus	concept_politicianus_george_washington
concept_country_qatar	concept:atdate	concept_dateliteral_n2008
concept_female_hillary	concept:politicianusendorsedbypoliticianus	concept_politicianus_mccain
concept_city_st___petersburg	concept:atdate	concept_date_n2004
concept_country_france_france	concept:atdate	concept_year_n1997
concept_furniture_four_poster_bed	concept:furniturefoundinroom	concept_visualizablescene_bedroom
concept_musician_john	concept:musicianplaysinstrument	concept_musicinstrument_mandolin
concept_book_new	concept:mutualproxyfor	concept_year_ny
concept_animal_manatees	concept:animalistypeofanimal	concept_vertebrate_marine_mammals
concept_book_new	concept:atlocation	concept_continent_africa
concept_book_nashville	concept:atdate	concept_year_n1998
concept_automobilemaker_acura	concept:automobilemakerdealersincity	concept_city_dallas
concept_person_barry	concept:personbornincity	concept_city_york
concept_governmentorganization_launch	concept:atdate	concept_year_n1998
concept_musicalbum_debut	concept:atdate	concept_dateliteral_n1990
concept_physicalaction_label	concept:atdate	concept_dateliteral_n2007
concept_university_ohio	concept:mutualproxyfor	concept_county_columbus
concept_mammal_feral_cats	concept:animalpreyson	concept_mammal_predators
concept_city_bucharest	concept:atdate	concept_dateliteral_n2008
concept_furniture_size_bed	concept:itemfoundinroom	concept_visualizablething_second_level
concept_politicsissue_commons	concept:atdate	concept_dateliteral_n2008
concept_mammal_jaguars	concept:animalistypeofanimal	concept_mammal_mammals
concept_sportsgame_title	concept:sportsgameteam	concept_sportsteam_spurs
concept_city_winnipeg	concept:atdate	concept_dateliteral_n2005
concept_biotechcompany_portugal	concept:atdate	concept_date_n2001
concept_city_members	concept:istallerthan	concept_publication_people_
concept_animal_animals001	concept:animalpreyson	concept_fish_parrots
concept_geopoliticalorganization_western	concept:atlocation	concept_continent_africa
concept_mammal_pets	concept:animalpreyson	concept_mammal_wild_animals
concept_mammal_squirrels	concept:animalistypeofanimal	concept_vertebrate_small_game
concept_vegetable_virgin_olive_oil	concept:agriculturalproductcookedwithagriculturalproduct	concept_vegetable_pepper
concept_city_norwalk	concept:atlocation	concept_stateorprovince_connecticut
concept_dateliteral_n1980	concept:mutualproxyfor	concept_stateorprovince_new_york
concept_building_first_time	concept:atdate	concept_date_n1939
concept_country_australia	concept:atdate	concept_date_n2001
concept_vegetable_pepper	concept:agriculturalproductcookedwithagriculturalproduct	concept_agriculturalproduct_bell_pepper
concept_sportsgame_championship	concept:sportsgameteam	concept_sportsteam_white_sox
concept_bedroomitem_bed	concept:itemfoundinroom	concept_officebuildingroom_junior_suites
concept_company_national	concept:agentactsinlocation	concept_geopoliticallocation_form
concept_city_evanston	concept:atlocation	concept_stateorprovince_wyoming
concept_politicsblog_tribune_com	concept:atlocation	concept_city_london_city
concept_fish_sharks	concept:animalistypeofanimal	concept_mammal_animals
concept_animal_poultry	concept:animalistypeofanimal	concept_mammal_farm_animals
concept_year_new	concept:mutualproxyfor	concept_city_pictures
concept_disease_illnesses	concept:ismultipleof	concept_publication_people_
concept_physicalaction_study	concept:atdate	concept_year_n1998
concept_geopoliticalorganization_schedule	concept:organizationdissolvedatdate	concept_month_september
concept_mammal_deer	concept:animalistypeofanimal	concept_animal_big_game
concept_sportsgame_games	concept:sportsgameteam	concept_sportsteam_nashville_predators
concept_physicalaction_charges	concept:atdate	concept_date_n2001
concept_city_manchester	concept:citylocatedinstate	concept_stateorprovince_new_hampshire
concept_country_fiji	concept:countrylocatedingeopoliticallocation	concept_country_countries
concept_athlete_kurt_warner	concept:coachwontrophy	concept_awardtrophytournament_super_bowl
concept_country_italy	concept:atdate	concept_date_n2001
concept_sportsteam_falcons	concept:teamwontrophy	concept_awardtrophytournament_super_bowl_xlii
concept_mammal_animals	concept:animalpreyson	concept_animal_leopards
concept_island_staff	concept:atdate	concept_dateliteral_n2006
concept_country_ghana	concept:atdate	concept_dateliteral_n2006
concept_musicalbum_review	concept:atdate	concept_date_n2009
concept_newspaper_chief_executive_officer	concept:atdate	concept_date_n1996
concept_governmentorganization_payment	concept:atdate	concept_dateliteral_n2005
concept_stateorprovince_colorado	concept:stateorprovinceisborderedbystateorprovince	concept_stateorprovince_nebraska
concept_personmexico_ncaa	concept:agentcontrols	concept_sportsteam_penn_state_nittany_lions
concept_governmentorganization_action	concept:agentparticipatedinevent	concept_sportsgame_series
concept_nongovorganization_guide	concept:organizationdissolvedatdate	concept_month_april
concept_mammal_cougars	concept:animalpreyson	concept_animal_large_predators
concept_reptile_pets	concept:animalistypeofanimal	concept_animal_animals002
concept_city_internet	concept:atdate	concept_date_n2001
concept_profession_installers	concept:professionistypeofprofession	concept_profession_professionals
concept_personasia_rick_ankiel	concept:personbelongstoorganization	concept_sportsteam_louisville_cardinals
concept_jobposition_commissioner	concept:atdate	concept_date_n2000
concept_country_italy	concept:atdate	concept_year_n1998
concept_mammal_puppies	concept:animalistypeofanimal	concept_animal_creatures
concept_furniture_log_bed	concept:furniturefoundinroom	concept_visualizablething_master_bedroom
concept_televisionstation_wpxi_tv	concept:televisionstationaffiliatedwith	concept_televisionnetwork_nbc_universal
concept_bathroomitem_shower	concept:itemfoundinroom	concept_officebuildingroom_large_rooms
concept_animal_birds002	concept:animalpreyson	concept_mammal_cats
concept_city_place	concept:atdate	concept_date_n1914
concept_furniture_size_bed	concept:itemfoundinroom	concept_officebuildingroom_guestrooms
concept_governmentorganization_house	concept:atdate	concept_year_n1992
concept_landscapefeatures_states	concept:locationlocatedwithinlocation	concept_country_russian_federation
concept_mammal_gorillas	concept:animalistypeofanimal	concept_animal_creatures
concept_perceptionaction_first_meeting	concept:atdate	concept_date_n2001
concept_magazine_lot	concept:organizationheadquarteredincity	concept_city_warsaw
concept_book_the_american	concept:atlocation	concept_city_washington_d_c
concept_musicartist_american	concept:agentactsinlocation	concept_city_englewood
concept_eventoutcome_report	concept:atdate	concept_year_n1988
concept_sport_soccer	concept:sportfansincountry	concept_country_china
concept_female_scene	concept:atdate	concept_dateliteral_n2006
concept_physicalaction_charges	concept:atdate	concept_date_n1999
concept_eventoutcome_treatment	concept:atdate	concept_date_n2003
concept_bodypart_atrium	concept:bodypartcontainsbodypart	concept_artery_blood_flow
concept_person_david002	concept:persongraduatedfromuniversity	concept_university_state_university
concept_lake_new	concept:mutualproxyfor	concept_month_march
concept_book_new	concept:mutualproxyfor	concept_book_adventure
concept_language_english	concept:languageofcountry	concept_country_puerto_rico
concept_sportsteam_philadelphia_flyers	concept:organizationheadquarteredinstateorprovince	concept_stateorprovince_new_york
concept_book_items	concept:mutualproxyfor	concept_book_new
concept_geometricshape_sector	concept:atdate	concept_dateliteral_n2006
concept_profession_physicians	concept:professionistypeofprofession	concept_profession_staff
concept_bank_aetna	concept:companyeconomicsector	concept_academicfield_health
concept_agriculturalproduct_zucchini	concept:agriculturalproductcookedwithagriculturalproduct	concept_vegetable_pepper
concept_book_stay	concept:atdate	concept_month_july
concept_sport_rugby	concept:sportfansincountry	concept_country___america
concept_nongovorganization_general_assembly	concept:atdate	concept_year_n1995
concept_kitchenitem_dishwasher	concept:itemfoundinroom	concept_room_kitchen
concept_company_berkshire_hathaway	concept:agentcollaborateswithagent	concept_personus_warren_buffet
concept_arthropod_external_parasites	concept:animalthatfeedoninsect	concept_insect_fleas
concept_city_cincinnati	concept:cityliesonriver	concept_attraction_grand
concept_profession_teachers	concept:atdate	concept_dateliteral_n2008
concept_city_service	concept:atdate	concept_dateliteral_n1918
concept_weapon_national	concept:atlocation	concept_country_new_zealand
concept_insect_beetles	concept:arthropodandotherarthropod	concept_insect_insects
concept_city_amherst	concept:citylocatedinstate	concept_stateorprovince_colorado
concept_politicsissue_violence	concept:atdate	concept_date_n1996
concept_city_hong_kong_island	concept:locationlocatedwithinlocation	concept_country_hong_kong
concept_geometricshape_effect	concept:atdate	concept_dateliteral_n1987
concept_vegetable_corn	concept:agriculturalproducttoattractinsect	concept_insect_caterpillars
concept_creditunion_michigan	concept:mutualproxyfor	concept_beverage_new
concept_country_republic_of_lithuania	concept:atdate	concept_dateliteral_n2007
concept_mammal_mammals	concept:animalistypeofanimal	concept_mammal_hares
concept_person_howard001	concept:persongraduatedschool	concept_university_state_university
concept_physicalaction_work	concept:atdate	concept_date_n1996
concept_visualartmovement_sciences	concept:atdate	concept_date_n2003
concept_museum_facilities	concept:atdate	concept_dateliteral_n2006
concept_company_pbs	concept:agentcontrols	concept_televisionstation_wekw_tv
concept_sport_softball	concept:sportusesequipment	concept_sportsequipment_ball
concept_academicfield_sciences	concept:academicfieldsuchasacademicfield	concept_academicfield_psychology
concept_city_bridgeport	concept:cityliesonriver	concept_river_columbia
concept_country_pakistan	concept:countrylocatedingeopoliticallocation	concept_continent_asia
concept_journalist_thomas_friedman	concept:journalistwritesforpublication	concept_newspaper_times
concept_weapon_national	concept:atlocation	concept_city_college_park
concept_mammal_dogs	concept:animalpreyson	concept_animal_carnivores
concept_country_belarus	concept:countrylocatedingeopoliticallocation	concept_continent_asia
concept_city_hawthorne	concept:citylocatedinstate	concept_stateorprovince_california
concept_politicianus_senator_clinton	concept:politicianusendorsedbypoliticianus	concept_politician_clinton
concept_buildingfeature_american	concept:atlocation	concept_city_duarte
concept_profession_workers	concept:professionistypeofprofession	concept_profession_paramedics
concept_profession_attorneys	concept:professionistypeofprofession	concept_profession_lawyers
concept_journalist_rick_weiss	concept:journalistwritesforpublication	concept_company_post
concept_person_wales	concept:atdate	concept_year_n1978
concept_city_home	concept:atdate	concept_year_n1959
concept_lake_new	concept:locationlocatedwithinlocation	concept_country_vietnam
concept_stateorprovince_california	concept:mutualproxyfor	concept_city_danville
concept_plant_flowers	concept:plantincludeplant	concept_plant_roses
concept_person_david	concept:persongraduatedfromuniversity	concept_university_yale_university
concept_protein_medicine	concept:atdate	concept_dateliteral_n2006
concept_animal_animals001	concept:animalsuchasinvertebrate	concept_mollusk_arthropods
concept_sport_rugby	concept:sportfansincountry	concept_country_australia
concept_island_investment	concept:atdate	concept_dateliteral_n2005
concept_sportsteam_white_sox	concept:teamplaysinleague	concept_sportsleague_mlb
concept_furniture_futon	concept:furniturefoundinroom	concept_room_family_room
concept_physicalaction_work	concept:atdate	concept_date_n2001
concept_athlete_p_j__walters	concept:coachwontrophy	concept_awardtrophytournament_super_bowl_xlii
concept_city_pasco	concept:atlocation	concept_city_washington_d_c
concept_agriculturalproduct_products	concept:agriculturalproductincludingagriculturalproduct	concept_agriculturalproduct_grains
concept_grain_sugar	concept:agriculturalproductgrowinginstateorprovince	concept_stateorprovince_texas
concept_governmentorganization_government	concept:atdate	concept_year_n1948
concept_musicsong_louisiana	concept:mutualproxyfor	concept_person_monroe
concept_mammal_rabbits	concept:mammalsuchasmammal	concept_mammal_deer
concept_automobilemaker_honda	concept:automakerproducesmodel	concept_product_prelude
concept_building_higher_education	concept:atdate	concept_dateliteral_n2005
concept_person_mugabe	concept:personleadsgeopoliticalorganization	concept_city_summit
concept_sportsteam_yankees	concept:teamwontrophy	concept_awardtrophytournament_division
concept_ceo_mark_zuckerberg	concept:ceoof	concept_website_facebook
concept_beverage_new	concept:atlocation	concept_visualizablething_sea
concept_website_south	concept:atdate	concept_dateliteral_n2005
concept_journalist_richard_cohen	concept:journalistwritesforpublication	concept_company_post
concept_stateorprovince_oregon	concept:stateorprovinceisborderedbystateorprovince	concept_stateorprovince_california
concept_mammal_animals	concept:animalpreyson	concept_mammal_sheep
concept_politician_roosevelt	concept:politicianholdsoffice	concept_politicaloffice_office
concept_musicgenre_classic_heavy_metal	concept:musicgenressuchasmusicgenres	concept_musicgenre_rock
concept_musicalbum_review	concept:atdate	concept_date_n2000
concept_book_inception	concept:atdate	concept_year_n1992
concept_sportsgame_championship	concept:atdate	concept_date_n2004
concept_female_mary	concept:parentofperson	concept_male_son
concept_mammal_dogs	concept:mammalsuchasmammal	concept_mammal_bears
concept_bedroomitem_bath	concept:itemfoundinroom	concept_officebuildingroom_luxury_bathroom
concept_politicianus_george_w__bush	concept:politicianholdsoffice	concept_politicaloffice_senator
concept_city_web	concept:atdate	concept_month_march
concept_perceptionaction_last_meeting	concept:atdate	concept_date_n2003
concept_physicalaction_assault	concept:atdate	concept_year_n1997
concept_profession_experts	concept:professionistypeofprofession	concept_profession_designers
concept_country_new_zealand	concept:atdate	concept_dateliteral_n2005
concept_vegetable_pepper	concept:agriculturalproductcookedwithagriculturalproduct	concept_vegetable_sprouts
concept_website_issue	concept:atdate	concept_date_n1996
concept_physicalaction_users	concept:atdate	concept_dateliteral_n2007
concept_politicianus_bill	concept:politicianusendorsedbypoliticianus	concept_politicianus_biden
concept_sportsgame_championship_game	concept:sportsgameteam	concept_sportsteam_sd_chargers
concept_visualizablething_residence	concept:atdate	concept_dayofweek_sunday
concept_stateorprovince_georgia	concept:mutualproxyfor	concept_city_duluth
concept_politicalparty_european_commission	concept:atdate	concept_date_n2001
concept_academicfield_economics	concept:atdate	concept_date_n2003
concept_emotion_examination	concept:atdate	concept_dateliteral_n2007
concept_city_islamabad	concept:atdate	concept_dateliteral_n2006
concept_politicaloffice_assistant	concept:atdate	concept_date_n2001
concept_newspaper_la_times	concept:companyeconomicsector	concept_academicfield_news
concept_stateorprovince_california	concept:mutualproxyfor	concept_city_hawthorne
concept_city_tasmania	concept:atdate	concept_date_n2001
concept_book_america	concept:atdate	concept_date_n2003
concept_country_australia	concept:atdate	concept_dateliteral_n1943
concept_stateorprovince_south_carolina	concept:mutualproxyfor	concept_city_charleston
concept_website_broadcast	concept:atdate	concept_date_n2004
concept_insect_flies	concept:invertebratefeedonfood	concept_beverage_blood
concept_island_new_york_city_metropolitan_area	concept:atdate	concept_dateliteral_n2006
concept_politicianus_mitt_romney	concept:agentcollaborateswithagent	concept_person_mccain
concept_musicalbum_death	concept:atdate	concept_date_n1964
concept_city_norwalk	concept:citylocatedinstate	concept_stateorprovince_california
concept_sportsequipment_board	concept:mutualproxyfor	concept_city_team
concept_nerve_nervous_system	concept:bodypartcontainsbodypart	concept_nerve_spine
concept_profession_radiologists	concept:professionistypeofprofession	concept_profession_workers
concept_academicfield_directors	concept:atdate	concept_year_n1998
concept_bedroomitem_bath	concept:itemfoundinroom	concept_officebuildingroom_suite_bathroom
concept_sportsteam_man_utd	concept:atdate	concept_dateliteral_n2006
concept_blog_manager	concept:atdate	concept_dateliteral_n2008
concept_reptile_turtles	concept:animalpreyson	concept_mammal_animals
concept_website_associates	concept:atdate	concept_dateliteral_n2005
concept_country_italy	concept:atdate	concept_dateliteral_n1943
concept_hobby_studio	concept:atdate	concept_date_n2003
concept_politicianus_john_mccain	concept:politicianusendorsedbypoliticianus	concept_politicianus_palin
concept_governmentorganization_standards	concept:atdate	concept_date_n2003
concept_country_belarus	concept:atdate	concept_dateliteral_n2005
concept_governmentorganization_house	concept:agentcontrols	concept_mediatype_white
concept_country_mexico	concept:atdate	concept_date_n1999
concept_website_clients	concept:atdate	concept_dateliteral_n2002
concept_agriculturalproduct_option	concept:agentinvolvedwithitem	concept_product_tab
concept_bird_owls	concept:animalistypeofanimal	concept_animal_creatures
concept_automobilemaker_bmw	concept:automobilemakerdealersincity	concept_city_tampa_bay
concept_stateorprovince_training	concept:atdate	concept_date_n2001
concept_automobilemaker_dodge	concept:automobilemakerdealersincity	concept_city_milwaukee
concept_furniture_beds	concept:furniturefoundinroom	concept_room_decor
concept_visualizablething_use	concept:agentparticipatedinevent	concept_sportsgame_series
concept_city_article	concept:atdate	concept_year_n1995
concept_university_ministry	concept:atdate	concept_year_n1998
concept_personaustralia_james_murdoch	concept:personleadsorganization	concept_musicartist_news
concept_city_dallas	concept:citylocatedinstate	concept_stateorprovince_iowa
concept_weapon_national	concept:atlocation	concept_city_camden
concept_physicalaction_way	concept:atdate	concept_dateliteral_n2005
concept_musician_eric	concept:musicianplaysinstrument	concept_musicinstrument_guitar
concept_mammal_rats	concept:animalpreyson	concept_mammal_small_animals
concept_terroristorganization_state	concept:agentcontrols	concept_profession_administrators
concept_person_david	concept:persongraduatedfromuniversity	concept_university_harvard
concept_city_centre	concept:locationlocatedwithinlocation	concept_stateorprovince_new_york
concept_city_protest	concept:atdate	concept_date_n2004
concept_jobposition_consultant	concept:professionistypeofprofession	concept_profession_professionals
concept_programminglanguage_mail	concept:atdate	concept_date_n2000
concept_animal_chicken001	concept:animaleatfood	concept_agriculturalproduct_fresh_fruit
concept_olympics_jury	concept:atdate	concept_date_n2004
concept_jobposition_physician	concept:professionistypeofprofession	concept_profession_specialists
concept_male_world	concept:agentcontrols	concept_person_greg001
concept_physicalaction_paper	concept:atdate	concept_date_n1999
concept_automobilemaker_information	concept:companyeconomicsector	concept_economicsector_insurance
concept_sportsteam_packers	concept:teamwontrophy	concept_awardtrophytournament_n2008_world_series
concept_visualizablething_baths	concept:itemfoundinroom	concept_officebuildingroom_luxury_suites
concept_museum_new_york_times	concept:atdate	concept_dateliteral_n2008
concept_vegetable_olives	concept:agriculturalproductcookedwithagriculturalproduct	concept_agriculturalproduct_black_pepper
concept_sport_ski	concept:sportusesequipment	concept_sportsequipment_apparel
concept_sportsteam_astros	concept:teamplaysinleague	concept_sportsleague_mlb
concept_country_tx	concept:atdate	concept_dateliteral_n2005
concept_company_adults	concept:agentparticipatedinevent	concept_crimeorcharge_offences
concept_city_kennewick	concept:locationlocatedwithinlocation	concept_city_washington_d_c
concept_bank_national	concept:bankbankincountry	concept_country_swaziland
concept_ceo_carlos_ghosn	concept:ceoof	concept_automobilemaker_nissan
concept_city_washington_d_c	concept:mutualproxyfor	concept_city_bremerton
concept_personsouthamerica_latin	concept:agentactsinlocation	concept_blog_globe
concept_language_russian	concept:languageofcountry	concept_country_venezuela
concept_bathroomitem_shelves	concept:atdate	concept_dateliteral_n2008
concept_sport_cricket	concept:sportfansincountry	concept_country_zimbabwe
concept_organization_national_assembly	concept:atdate	concept_year_n1997
concept_hobby_discussions	concept:atdate	concept_dateliteral_n2002
concept_company_national	concept:hasofficeincity	concept_city_orlando
concept_sport_badminton	concept:sportusesequipment	concept_sportsequipment_rackets
concept_transportation_operation	concept:atdate	concept_year_n1946
concept_academicfield_trial	concept:atdate	concept_dateliteral_n2008
concept_governmentorganization_united_nations	concept:atdate	concept_year_n1946
concept_musicartist_delaware	concept:mutualproxyfor	concept_writer_dover
concept_musician_david	concept:musicianplaysinstrument	concept_musicinstrument_electric_guitar
concept_emotion_appeal	concept:atdate	concept_dateliteral_n2002
concept_governmentorganization_u_s__food_and_drug_administration	concept:atdate	concept_dateliteral_n2002
concept_bathroomitem_tub	concept:itemfoundinroom	concept_officebuildingroom_deluxe_rooms
concept_person_lord	concept:parentofperson	concept_male_yeshua
concept_stateorprovince_virginia	concept:locationlocatedwithinlocation	concept_geopoliticalorganization_eastern
concept_politicianus_george_w_bush	concept:agentcontrols	concept_hotel_white
concept_physicalaction_edition	concept:atdate	concept_dateliteral_n2002
concept_city_yuma	concept:cityliesonriver	concept_river_gila
concept_bank_citibank	concept:bankbankincountry	concept_country_thailand
concept_person_eric001	concept:persongraduatedfromuniversity	concept_university_state_university
concept_vehicle_renovation	concept:atdate	concept_date_n2003
concept_country_france_france	concept:countrylocatedingeopoliticallocation	concept_river_counties
concept_athlete_randy	concept:athleteplayssportsteamposition	concept_sportsteamposition_player
concept_awardtrophytournament_championships	concept:awardtrophytournamentisthechampionshipgameofthenationalsport	concept_sport_lacrosse
concept_bank_national	concept:bankbankincountry	concept_country_bulgaria
concept_company_winter	concept:organizationdissolvedatdate	concept_month_april
concept_bathroomitem_shower	concept:itemfoundinroom	concept_room_area
concept_politicianus_mr__bush	concept:politicianusmemberofpoliticalgroup	concept_governmentorganization_house
concept_insect_honeybees	concept:arthropodandotherarthropod	concept_insect_insects
concept_profession_staff	concept:professionistypeofprofession	concept_profession_officers
concept_profession_staff	concept:professionistypeofprofession	concept_profession_surgeons
concept_sportsgame_playoff	concept:sportsgameteam	concept_sportsteam_red_sox_this_season
concept_furniture_beds	concept:furniturefoundinroom	concept_room_unit
concept_sportsteam_capitals	concept:organizationheadquarteredinstateorprovince	concept_stateorprovince_new_york
concept_artery_arms	concept:bodypartcontainsbodypart	concept_artery_arteries
concept_nongovorganization_u_s_	concept:atdate	concept_year_n1988
concept_landscapefeatures_states	concept:locationlocatedwithinlocation	concept_stateorprovince_colorado
concept_book_attention	concept:atdate	concept_date_n1993
concept_perceptionaction_hearings	concept:atdate	concept_date_n2000
concept_arthropod_spiders	concept:animalistypeofanimal	concept_mammal_pets
concept_city_newark	concept:mutualproxyfor	concept_stateorprovince_california
concept_geopoliticallocation_show	concept:atdate	concept_date_n2003
concept_hobby_negotiations	concept:atdate	concept_dateliteral_n2006
concept_lake_new	concept:locationlocatedwithinlocation	concept_city_central
concept_televisionstation_krwg_tv	concept:agentcollaborateswithagent	concept_company_pbs
concept_monument_supreme_court	concept:atdate	concept_dateliteral_n2005
concept_celebrity_the_national	concept:agentactsinlocation	concept_city_bethesda
concept_blog_myspace	concept:atdate	concept_dateliteral_n2008
concept_furniture_double_bed	concept:furniturefoundinroom	concept_room_master
concept_programminglanguage_scheme	concept:atdate	concept_date_n2001
concept_newspaper_financial_times	concept:atdate	concept_dateliteral_n2007
concept_city_new_orleans	concept:atdate	concept_year_n1862
concept_furniture_bed	concept:furniturefoundinroom	concept_officebuildingroom_air_conditioned_rooms
concept_profession_counsellors	concept:professionistypeofprofession	concept_profession_providers
concept_athlete_barry_bonds	concept:athletebeatathlete	concept_athlete_hank_aaron
concept_furniture_berths	concept:furniturefoundinroom	concept_visualizablething_cabins
concept_university_george_washington_university	concept:atlocation	concept_city_washington_d_c
concept_agriculturalproduct_season	concept:agriculturalproductcookedwithagriculturalproduct	concept_vegetable_pepper
concept_weapon_warheads	concept:weaponmadeincountry	concept_country_west_indies
concept_furniture_bed	concept:furniturefoundinroom	concept_room_spacious_master
concept_animal_humans	concept:animaleatvegetable	concept_vegetable_peas
concept_company_berkshire_hathaway	concept:companyeconomicsector	concept_economicsector_investment
concept_weapon_weeks	concept:atlocation	concept_website_east
concept_geopoliticallocation_surgery	concept:atdate	concept_date_n1996
concept_athlete_justine_henin_hardenne	concept:athletebeatathlete	concept_athlete_jelena_jankovic
concept_city_columbia	concept:cityalsoknownas	concept_city_calgary
concept_profession_nurses	concept:professionistypeofprofession	concept_profession_health_care_professionals
concept_sportsgame_finals	concept:sportsgameteam	concept_sportsteam_heat
concept_musicartist_american	concept:agentactsinlocation	concept_visualizablething_purvis
concept_televisionstation_kbdi_tv	concept:televisionstationaffiliatedwith	concept_televisionnetwork_pbs
concept_visualizableobject_world	concept:objectfoundinscene	concept_visualizablescene_agra
concept_street_public_meeting	concept:atdate	concept_date_n1999
concept_animal_exotics001	concept:animalistypeofanimal	concept_agriculturalproduct_pigs
concept_company_japan	concept:atdate	concept_date_n1944
concept_city_geneva	concept:atdate	concept_date_n1993
concept_website_information	concept:atdate	concept_date_n2001
concept_religion_submission	concept:atdate	concept_date_n2004
concept_politicianus_mrs__clinton	concept:politicianusendorsedbypoliticianus	concept_politician_clinton
concept_person_lincoln	concept:agentcontrols	concept_clothing_white
concept_nongovorganization_council	concept:atdate	concept_date_n2001
concept_sportsteam_texas_a_m	concept:organizationalsoknownas	concept_sportsteam_state_university
concept_weapon_weapons	concept:weaponmadeincountry	concept_country_egypt
concept_arthropod_arthropods	concept:animalpreyson	concept_arachnid_scorpions
concept_drug_alcohol	concept:drughassideeffect	concept_disease_side_effects
concept_insect_fleas	concept:arthropodandotherarthropod	concept_arthropod_arthropods
concept_bedroomitem_bath	concept:itemfoundinroom	concept_officebuildingroom_family_bathroom
concept_physicalaction_materials	concept:atdate	concept_date_n2001
concept_journalist_bob_woodward	concept:journalistwritesforpublication	concept_company_dc
concept_mammal_kittens	concept:animalpreyson	concept_mammal_animals
concept_person_jonathan	concept:persongraduatedschool	concept_university_state_university
concept_city_new_brunswick	concept:cityliesonriver	concept_river_columbia
concept_mammal_lions	concept:mammalsuchasmammal	concept_mammal_bears
concept_crimeorcharge_prison	concept:atdate	concept_year_n1998
concept_governmentorganization_office	concept:organizationacronymhasname	concept_governmentorganization_department
concept_date_holiday	concept:atdate	concept_month_january
concept_musicalbum_luxembourg	concept:atdate	concept_date_n1999
concept_personasia_coup	concept:atdate	concept_year_n1989
concept_profession_faculty	concept:professionistypeofprofession	concept_profession_workers
concept_visualizablescene_apartment	concept:atdate	concept_dateliteral_n2008
concept_company_pbs	concept:agentcontrols	concept_televisionstation_wunp_tv
concept_weapon_national	concept:atlocation	concept_city_bellflower
concept_landscapefeatures_states	concept:locationlocatedwithinlocation	concept_stateorprovince_michigan
concept_visualizableattribute_minutes	concept:atlocation	concept_hotel_north
concept_governmentorganization_legislation	concept:atdate	concept_dateliteral_n2005
concept_weatherphenomenon_warning	concept:atdate	concept_date_n2004
concept_automobilemaker_bmw	concept:automobilemakerdealersincity	concept_city_jacksonville
concept_person_cynthia	concept:persongraduatedschool	concept_university_state_university
concept_governmentorganization_ways	concept:mutualproxyfor	concept_politicaloffice_new
concept_amphibian_larvae	concept:animaleatfood	concept_plant_stems
concept_candy_tea	concept:fooddecreasestheriskofdisease	concept_disease_damage
concept_jobposition_facility	concept:atdate	concept_year_n1992
concept_landscapefeatures_weekend	concept:atdate	concept_year_n1997
concept_personmexico_woody_hayes	concept:agentcollaborateswithagent	concept_sportsteam_ohio_state_university
concept_buildingfeature_floors	concept:atdate	concept_date_n2009
concept_book_years	concept:atlocation	concept_geopoliticallocation_southern
concept_governmentorganization_action	concept:atdate	concept_date_n1993
concept_bedroomitem_bath	concept:itemfoundinroom	concept_officebuildingroom_master_bedroom_suite
concept_stadiumoreventvenue_camp_nou	concept:stadiumlocatedincity	concept_city_barcelona
concept_country_macedonia	concept:countrylocatedingeopoliticallocation	concept_country_countries
concept_musicartist_american	concept:agentactsinlocation	concept_county_san_francisco
concept_automobilemaker_honda_motor_co_	concept:agentinvolvedwithitem	concept_automobilemodel_civic_coupe
concept_city_service	concept:atdate	concept_dateliteral_n2005
concept_perceptionaction_premiere	concept:atdate	concept_date_n2004
concept_automobilemaker_honda_motor_co_	concept:agentinvolvedwithitem	concept_automobilemodel_accord_crosstour
concept_animal_chicken001	concept:animaleatfood	concept_beverage_beer
concept_city_team	concept:agentparticipatedinevent	concept_eventoutcome_title
concept_creditunion_michigan	concept:mutualproxyfor	concept_county_detroit
concept_mammal_cats	concept:animalistypeofanimal	concept_animal_carnivores
concept_plant_trees	concept:plantincludeplant	concept_plant_evergreens
concept_city_columbia	concept:locationlocatedwithinlocation	concept_stateorprovince_missouri
concept_company_national	concept:hasofficeincountry	concept_country_viet_nam
concept_profession_division	concept:atdate	concept_date_n1999
concept_bathroomitem_separate_shower	concept:itemfoundinroom	concept_officebuildingroom_full_bathroom
concept_mammal_apes	concept:animalistypeofanimal	concept_animal_creatures
concept_animal_creatures	concept:animalpreyson	concept_animal_hawks
concept_animal_animals002	concept:animalpreyson	concept_reptile_invertebrates
concept_male_son	concept:parentofperson	concept_person_david003
concept_fish_sharks	concept:agentparticipatedinevent	concept_sportsgame_games
concept_insect_insect_pests	concept:invertebratefeedonfood	concept_plant_plants
concept_scientist_patent	concept:atdate	concept_date_n2000
concept_agriculturalproduct_red_peppers	concept:agriculturalproductcookedwithagriculturalproduct	concept_vegetable_pepper
concept_coach_ncaa_tournament	concept:atdate	concept_date_n1996
concept_personasia_site	concept:agentinvolvedwithitem	concept_buildingfeature_window
concept_agent_start	concept:atdate	concept_date_n2003
concept_landscapefeatures_states	concept:locationlocatedwithinlocation	concept_stateorprovince_wisconsin
concept_sportsteam_ravens	concept:agentparticipatedinevent	concept_convention_games
concept_city_name	concept:atdate	concept_year_n1989
concept_weapon_national	concept:atlocation	concept_aquarium_louis
concept_geometricshape_course	concept:atdate	concept_dateliteral_n2006
concept_furniture_beds	concept:itemfoundinroom	concept_officebuildingroom_single_rooms
concept_insect_ladybugs	concept:arthropodandotherarthropod	concept_insect_insects
concept_profession_recruitment	concept:professionistypeofprofession	concept_profession_professionals
concept_mlarea_recognition	concept:atdate	concept_date_n2001
concept_furniture_beds	concept:furniturefoundinroom	concept_officebuildingroom_honeymoon_suites
concept_furniture_size_bed	concept:itemfoundinroom	concept_room_style
concept_year_new	concept:mutualproxyfor	concept_stateorprovince_points
concept_language_arabic	concept:languageofcountry	concept_country_qatar
concept_country_france_france	concept:atdate	concept_dateliteral_n2006
concept_company_pixar	concept:mutualproxyfor	concept_politician_jobs
concept_insect_bugs	concept:animalthatfeedoninsect	concept_insect_ticks
concept_book_term	concept:atdate	concept_date_n2003
concept_county_baltimore	concept:atdate	concept_date_n2003
concept_automobilemaker_bmw	concept:automobilemakerdealersincity	concept_city_bellevue
concept_company_northwest_airlines	concept:hasofficeincity	concept_city_amsterdam
concept_politicianus_barack_obama	concept:politicianusendorsedbypoliticianus	concept_politicianus_george_w__bush
concept_televisionstation_wneo	concept:agentcollaborateswithagent	concept_company_pbs
concept_politician_clinton	concept:politicianusendorsedbypoliticianus	concept_politicianus_mrs__clinton
concept_city_berlin	concept:atdate	concept_dateliteral_n2007
concept_weapon_national	concept:atlocation	concept_county_las_vegas
concept_personaustralia_pet	concept:agentparticipatedinevent	concept_eventoutcome_result
concept_country_usa	concept:atdate	concept_dateliteral_n2005
concept_animal_bulls	concept:animalistypeofanimal	concept_mammal_animals
concept_sportsteam_pittsburgh_pirates	concept:teamplaysinleague	concept_sportsleague_mlb
concept_beverage_vineyards	concept:objectfoundinscene	concept_landscapefeatures_valley
concept_stateorprovince_california	concept:mutualproxyfor	concept_visualizablescene_dana_point
concept_personnorthamerica_bills	concept:personbelongstoorganization	concept_politicalparty_house
concept_company_pbs	concept:agentcontrols	concept_televisionstation_koac_tv
concept_website_tour	concept:atdate	concept_year_n1975
concept_artery_vessels	concept:arterycalledartery	concept_artery_canal
concept_city_york	concept:citylocatedingeopoliticallocation	concept_city_state
concept_governmentorganization_management	concept:atdate	concept_date_n2001
concept_athlete_playoff	concept:atdate	concept_year_n1982
concept_website_issue	concept:atdate	concept_date_n1999
concept_awardtrophytournament_state_championships	concept:awardtrophytournamentisthechampionshipgameofthenationalsport	concept_sport_basketball
concept_country_chile	concept:atdate	concept_dateliteral_n2008
concept_city_casper	concept:cityliesonriver	concept_visualizablescene_north_platte
concept_televisionstation_wftv	concept:organizationheadquarteredincity	concept_city_orlando
concept_language_persian	concept:languageofcountry	concept_country_kosovo
concept_furniture_berth	concept:furniturefoundinroom	concept_room_master
concept_person_macintosh	concept:agentinvolvedwithitem	concept_buildingfeature_windows
concept_weapon_national	concept:atlocation	concept_city_lynnwood
concept_academicfield_version	concept:atdate	concept_date_n2003
concept_nongovorganization_guide	concept:organizationdissolvedatdate	concept_month_june
concept_programminglanguage_collection	concept:atdate	concept_year_n1974
concept_emotion_charity	concept:atdate	concept_date_n2004
concept_food_peppers	concept:agriculturalproductcookedwithagriculturalproduct	concept_agriculturalproduct_broccoli
concept_country_tn	concept:atdate	concept_date_n2003
concept_geopoliticallocation_franchise	concept:atdate	concept_date_n2004
concept_date_crisis	concept:atdate	concept_dateliteral_n2006
concept_bedroomitem_bed	concept:itemfoundinroom	concept_visualizablething_double_bedroom
concept_sportsgame_series	concept:sportsgameteam	concept_sportsteam_steelers
concept_profession_care_professionals	concept:professionistypeofprofession	concept_profession_specialists
concept_profession_project_managers	concept:professionistypeofprofession	concept_profession_specialists
concept_room_offices	concept:atdate	concept_year_n1997
concept_agriculturalproduct_olive_oil	concept:agriculturalproductcookedwithagriculturalproduct	concept_vegetable_garlic
concept_person_grant001	concept:persongraduatedschool	concept_university_college
concept_city_chester	concept:atlocation	concept_stateorprovince_connecticut
concept_person_roberts001	concept:persongraduatedschool	concept_university_state_university
concept_person_jamie	concept:personbelongstoorganization	concept_sportsteam_state_university
concept_buildingfeature_american	concept:atlocation	concept_city_stockbridge
concept_politician_president_george_w_	concept:politicianholdsoffice	concept_politicaloffice_president
concept_weapon_missiles	concept:weaponmadeincountry	concept_country_japan
concept_jobposition_benefits	concept:atdate	concept_dateliteral_n2005
concept_musicalbum_reality	concept:atdate	concept_date_n2004
concept_personmexico_ryan_whitney	concept:personleadsorganization	concept_geopoliticallocation_agencies
concept_mammal_sea_lions	concept:animalistypeofanimal	concept_mammal_mammals
concept_animal_creatures	concept:animalthatfeedoninsect	concept_arthropod_snails
concept_politicsissue_elections	concept:atdate	concept_month_april
concept_company_pbs	concept:agentcontrols	concept_televisionstation_wha__tv
concept_vegetable_parsley	concept:agriculturalproductcookedwithagriculturalproduct	concept_food_peppers
concept_lake_new	concept:locationlocatedwithinlocation	concept_website_show
concept_sportsgame_list	concept:mutualproxyfor	concept_book_new
concept_city_design	concept:atdate	concept_date_n2003
concept_programminglanguage_classes	concept:atdate	concept_date_n2001
concept_county_records	concept:atdate	concept_date_n2004
concept_bank_the_royal	concept:bankbankincountry	concept_country_great_britain
concept_sportsteam_rams	concept:teamplaysinleague	concept_sportsleague_nfl
concept_athlete_babe_ruth	concept:athleteplaysinleague	concept_sportsleague_mlb
concept_country_poland	concept:countrylocatedingeopoliticallocation	concept_country_countries
concept_biotechcompany_southern	concept:agentactsinlocation	concept_building_america
concept_person_adams	concept:personbelongstoorganization	concept_politicalparty_house
concept_fish_small_fish	concept:animalsuchasfish	concept_fish_anchovies
concept_sport_tennis	concept:sportusesequipment	concept_sportsequipment_sticks
concept_geometricshape_effect	concept:atdate	concept_date_n2003
concept_musicartist_times	concept:agentactsinlocation	concept_city_quito
concept_agriculturalproduct_spices	concept:agriculturalproductcookedwithagriculturalproduct	concept_vegetable_peas
concept_company_campus	concept:atdate	concept_year_n1998
concept_beverage_win	concept:atdate	concept_year_n1998
concept_weapon_national	concept:atlocation	concept_website_support
concept_profession_surgeons	concept:professionistypeofprofession	concept_profession_care_professionals
concept_animal_creatures	concept:animalthatfeedoninsect	concept_insect_cockroaches
concept_person_barbara001	concept:persongraduatedfromuniversity	concept_university_college
concept_mammal_wild_animals	concept:animalpreyson	concept_mammal_raccoons
concept_televisionstation_whla_tv	concept:agentcollaborateswithagent	concept_company_pbs
concept_building_billion	concept:atdate	concept_date_n2000
concept_politicianus_biden	concept:politicianusendorsedbypoliticianus	concept_politicianus_senator_barack_obama
concept_automobilemaker_honda	concept:automobilemakerdealersincity	concept_city_fayetteville
concept_stateorprovince_eu	concept:atdate	concept_dateliteral_n2008
concept_blog_wordpress	concept:atdate	concept_dateliteral_n2007
concept_profession_consultants	concept:professionistypeofprofession	concept_profession_scientists
concept_biotechcompany_apple	concept:agentcollaborateswithagent	concept_radiostation_job
concept_politicianus_president_clinton	concept:politicianusendorsedbypoliticianus	concept_politician_clinton
concept_city_centre	concept:atdate	concept_dateliteral_n2005
concept_agriculturalproduct_products	concept:agriculturalproductincludingagriculturalproduct	concept_food_hay
concept_website_description	concept:agentinvolvedwithitem	concept_wallitem_browser_window
concept_mammal_animals	concept:animalpreyson	concept_bird_turkeys
concept_sportsteam_florida_marlins	concept:atlocation	concept_county_miami
concept_sport_soccer	concept:sportusesequipment	concept_sportsequipment_apparel
concept_coach_rex_grossman	concept:persondiedincountry	concept_country_england
concept_animal_social_insects	concept:animalsuchasinvertebrate	concept_invertebrate_bees
concept_person_alex_rodriguez	concept:personbelongstoorganization	concept_sportsleague_new
concept_vegetable_peas	concept:agriculturalproductcookedwithagriculturalproduct	concept_agriculturalproduct_salt
concept_politicianus_mccain	concept:politicianusendorsedbypoliticianus	concept_politicianus_mr__obama
concept_city_home	concept:atdate	concept_year_n1967
concept_country_cuba	concept:atdate	concept_date_n1962
concept_person_lord	concept:atdate	concept_dateliteral_n2007
concept_visualizableattribute_minutes	concept:atlocation	concept_lake_new
concept_bathroomitem_tub_shower	concept:itemfoundinroom	concept_room_full_bath
concept_highway_lakewood	concept:mutualproxyfor	concept_radiostation_new_jersey
concept_nerve_nervous_system	concept:bodypartcontainsbodypart	concept_braintissue_spinal_cord
concept_city_everett	concept:locationlocatedwithinlocation	concept_city_washington_d_c
concept_sport_basketball	concept:sporthassportsteamposition	concept_sportsteamposition_guard
concept_profession_teachers	concept:professionistypeofprofession	concept_profession_professionals
concept_vegetable_tobacco	concept:agriculturalproductgrowinginstateorprovince	concept_stateorprovince_maryland
concept_profession_surgeons	concept:professionistypeofprofession	concept_profession_medical_professionals
concept_lake_new	concept:atlocation	concept_county_york_county
concept_sportsgame_postseason	concept:atdate	concept_date_n1996
concept_animal_head	concept:agentcontrols	concept_person_williams
concept_bathroomitem_jacuzzi	concept:itemfoundinroom	concept_officebuildingroom_rooms
concept_mldataset__	concept:atdate	concept_date_n1999
concept_animal_humans	concept:animalistypeofanimal	concept_mammal_large_mammals
concept_sportsgame_title	concept:sportsgameteam	concept_sportsteam_longhorns
concept_personsouthamerica_latin	concept:agentactsinlocation	concept_bridge_world
concept_ceo_jim_balsillie	concept:ceoof	concept_company_rim_blackberry
concept_bathroomitem_double_bed	concept:itemfoundinroom	concept_visualizablething_master_suite
concept_animal_federal_government	concept:agentcontrols	concept_transportation_money
concept_politicsissue_graduate	concept:atdate	concept_dateliteral_n2008
concept_book_release	concept:atdate	concept_date_n1993
concept_food_heart	concept:fooddecreasestheriskofdisease	concept_disease_breast_cancer
concept_animal_babies	concept:animalpreyson	concept_mammal_animals
concept_female_hillary	concept:politicianholdsoffice	concept_politicaloffice_u_s__president
concept_householditem_bedroom	concept:itemfoundinroom	concept_officebuildingroom_third_bedroom
concept_reptile_pets	concept:animalpreyson	concept_animal_animals002
concept_city_delivery	concept:atdate	concept_dateliteral_n2008
concept_city_sabres	concept:agentparticipatedinevent	concept_sportsgame_finals
concept_website_broadcast	concept:atdate	concept_date_n2009
concept_sportsteam_penn_state_nittany_lions	concept:teamplaysinleague	concept_sportsleague_ncaa
concept_profession_professionals	concept:professionistypeofprofession	concept_profession_interpreters
concept_grain_sugar	concept:agriculturalproductgrowinginstateorprovince	concept_stateorprovince_ontario
concept_company_national	concept:agentactsinlocation	concept_geopoliticallocation_albion
