concept_sportsteam_eagles	concept:teamplaysagainstteam	concept_sportsteam_bucs
concept_bank_citigroup	concept:headquarteredin	concept_city_new_york
concept_sportsleague_terms	concept:organizationterminatedperson	concept_scientist_no_
concept_athlete_peyton_manning	concept:athleteplayssport	concept_sport_football
concept_sportsteam_florida_international	concept:teamplaysagainstteam	concept_sportsteam_philadelphia_eagles
concept_company_nbc	concept:headquarteredin	concept_city_new_york
concept_personnorthamerica_kevin_reilly	concept:worksfor	concept_company_nbc
concept_coach_jeremy_sowers	concept:worksfor	concept_sportsteam_yankees
concept_company_sony	concept:organizationterminatedperson	concept_ceo_edgar_bronfman
concept_sportsteam_seattle_mariners	concept:teamplaysagainstteam	concept_sportsteam_chicago_white_sox
concept_musicartist_coldplay	concept:musicartistgenre	concept_musicgenre_british_rock
concept_sportsteam_redskins	concept:organizationhiredperson	concept_coach_jim_zorn
concept_sportsteam_texans	concept:teamplaysagainstteam	concept_sportsteam_cleveland_browns
concept_sportsteam_new_york_islanders	concept:teamplaysagainstteam	concept_sportsteam_flyers_playoff_tickets
concept_person_pj_hill	concept:personalsoknownas	concept_coach_p_j__hill
concept_mammal_cats	concept:agentcompeteswithagent	concept_mammal_mals
concept_sportsteam_michigan_state	concept:teamplaysagainstteam	concept_sportsteam_buckeyes
concept_sportsteam_california_angels	concept:teamplaysagainstteam	concept_sportsteam_red_sox_this_season
concept_country_soviet_union	concept:countryalsoknownas	concept_country_belarus
concept_journalist_frank_rich	concept:worksfor	concept_musicartist_times
concept_journalist_dana_milbank	concept:worksfor	concept_company_dc
concept_country_korea	concept:countryalsoknownas	concept_country_west_indies
concept_coach_rex_ryan	concept:worksfor	concept_sportsteam_new_york_jets
concept_country_republic	concept:countryalsoknownas	concept_country_vietnam
concept_company_priority	concept:organizationheadquarteredincountry	concept_country_usa
concept_arthropod_males	concept:animaldevelopdisease	concept_disease_disorder
concept_website_facebook	concept:organizationterminatedperson	concept_ceo_mark_zuckerberg
concept_sportsteam_bucs	concept:teamplaysagainstteam	concept_sportsteam_eagles
concept_sportsteam_los_angeles_angels_of_anaheim	concept:teamplaysagainstteam	concept_sportsteam_chicago_white_sox
concept_sportsteam_new_orleans_hornets	concept:organizationhiredperson	concept_coach_byron_scott
concept_sportsteam_rams	concept:organizationterminatedperson	concept_coach_rich_brooks
concept_insect_mosquitos	concept:animalsuchasinsect	concept_insect_flies
concept_sportsteam_virginia_tech	concept:teamplaysagainstteam	concept_sportsteam_florida_state
concept_ceo_hiroshi_okuda	concept:worksfor	concept_automobilemaker_toyota
concept_sportsteam_blue_jays	concept:teamplaysagainstteam	concept_sportsteam_atlanta_braves
concept_sportsteam_padres	concept:teamplaysagainstteam	concept_sportsteam_new_york_mets
concept_wine_white_wine	concept:beveragemadefrombeverage	concept_wine_sauvignon_blanc
concept_sportsteam_nuggets	concept:teamplaysagainstteam	concept_sportsteam_heat
concept_athlete_chan_ho_park	concept:athletehomestadium	concept_stadiumoreventvenue_pete_times_forum
concept_sportsteam_bucs	concept:teamplaysagainstteam	concept_sportsteam_texans
concept_company_telegraph001	concept:competeswith	concept_website_washington_post
concept_sportsleague_nfl	concept:organizationhiredperson	concept_coach_tony_dungy
concept_university_state_university	concept:synonymfor	concept_university_kansas_state
concept_company_new_york	concept:competeswith	concept_magazine_atlantic_monthly
concept_sportsteam_yankees	concept:teamplaysagainstteam	concept_sportsteam_twins
concept_sportsteam_ncaa_youth_kids	concept:agentcompeteswithagent	concept_company_missouri
concept_insect_flies	concept:animalsuchasinsect	concept_insect_mosquitos
concept_sportsteam_flyers_playoff_tickets	concept:teamplaysagainstteam	concept_sportsteam_rangers
concept_city_montreal	concept:citylocatedincountry	concept_country_canada_canada
concept_sportsteam_los_angeles_lakers	concept:teamplaysagainstteam	concept_sportsteam_indiana_pacers
concept_sportsteam_new_york_giants_in_super_bowl_xlii	concept:teamplaysagainstteam	concept_sportsteam_d_backs
concept_sportsteam_packers	concept:teamalsoknownas	concept_sportsteam_seahawks
concept_company_japan	concept:synonymfor	concept_politicsblog_republic
concept_company_dc	concept:competeswith	concept_company_reuters
concept_building_atlantic_city	concept:buildinglocatedincity	concept_city_vegas
concept_sportsteam_florida_marlins	concept:teamplaysagainstteam	concept_sportsteam_arizona_diamond_backs
concept_sportsteam_louisville_cardinals	concept:teamplaysagainstteam	concept_sportsteam_arizona_diamond_backs
concept_sportsteam_red_sox	concept:teamplaysagainstteam	concept_sportsteam_pittsburgh_pirates
concept_sportsteam_former_san_francisco_giants	concept:teamplaysagainstteam	concept_sportsteam_chicago_cubs
concept_sportsteam_redskins	concept:teamplaysagainstteam	concept_sportsteam_buffalo_bills
concept_country_albania	concept:countryalsoknownas	concept_country_republic
concept_sportsteam_white_sox	concept:teamplaysagainstteam	concept_sportsteam_arizona_diamond_backs
concept_company_fcc	concept:headquarteredin	concept_city_washington_d_c
concept_athlete_kurt_warner	concept:athletewinsawardtrophytournament	concept_awardtrophytournament_super_bowl
concept_athlete_williams	concept:athletewinsawardtrophytournament	concept_awardtrophytournament_australian_open
concept_animal_baby	concept:animaldevelopdisease	concept_disease_syndrome
concept_mammal_rats	concept:animaldevelopdisease	concept_disease_cancer
concept_animal_creatures	concept:animalsuchasinsect	concept_insect_earthworms
concept_automobilemaker_honda	concept:organizationterminatedperson	concept_ceo_takeo_fukui
concept_agriculturalproduct_livestock	concept:agentcompeteswithagent	concept_agriculturalproduct_pigs
concept_insect_bugs	concept:animalsuchasinsect	concept_insect_mosquitos
concept_website_jobs	concept:synonymfor	concept_governmentorganization_u__s__department
concept_person_rachel	concept:personborninlocation	concept_city_york
concept_sportsteam_chicago_bulls	concept:teamplaysagainstteam	concept_sportsteam_minnesota_timberwolves
concept_politicianus_franklin_delano_roosevelt	concept:politicianusholdsoffice	concept_politicaloffice_president
concept_sportsteam_pistons	concept:teamplaysagainstteam	concept_sportsteam_los_angeles_lakers
concept_sportsteam_houston_astros	concept:teamplaysagainstteam	concept_sportsteam_white_sox
concept_sportsteam_man_utd	concept:teamplaysagainstteam	concept_sportsteam_bolton_wanderers
concept_company_daily_news001	concept:competeswith	concept_website_san_jose_mercury_news
concept_city_tampa_bay	concept:organizationhiredperson	concept_coach_dungy
concept_sportsteam_cavaliers	concept:teamplaysagainstteam	concept_sportsteam_washington_wizards
concept_politicianus_harry_truman	concept:politicianusholdsoffice	concept_politicaloffice_president
concept_sportsteam_royals	concept:teamplaysagainstteam	concept_sportsteam_chicago_cubs
concept_sportsteam_steelers	concept:teamplaysagainstteam	concept_sportsteam_new_york_jets
concept_person_carol_bartz	concept:worksfor	concept_biotechcompany_autodesk_inc_
concept_mammal_animals	concept:specializationof	concept_mammal_sheep
concept_sportsteam_oakland_raiders	concept:teamplaysagainstteam	concept_sportsteam_falcons
concept_coach_koyie_hill	concept:athleteplayssport	concept_sport_baseball
concept_athlete_aaron	concept:athleteplayssport	concept_sport_baseball
concept_sportsteam_chicago_bulls	concept:teamplaysagainstteam	concept_sportsteam_red_sox_this_season
concept_city_san_juan	concept:citylocatedincountry	concept_country_puerto_rico
concept_sportsteam_sd_chargers	concept:teamplaysagainstteam	concept_sportsteam_rams
concept_bakedgood_desserts	concept:bakedgoodservedwithbeverage	concept_beverage_coffee
concept_sportsteam_blue_jays	concept:teamplaysagainstteam	concept_sportsteam_chicago_cubs
concept_professor_david_pogue	concept:worksfor	concept_website_new_york_times
concept_athlete_santonio_holmes	concept:athleteplayssport	concept_sport_football
concept_animal_social_insects	concept:animalsuchasinsect	concept_insect_ants
concept_bird_owls	concept:specializationof	concept_animal_wildlife
concept_sportsteam_bengals	concept:teamplaysagainstteam	concept_sportsteam_oakland_raiders
concept_animal_birds003	concept:animalsuchasinsect	concept_insect_pests
concept_sportsteam_washington_wizards	concept:teamplaysagainstteam	concept_sportsteam_raptors
concept_country_republic	concept:countryalsoknownas	concept_country_oman
concept_geopoliticalorganization_list	concept:organizationterminatedperson	concept_scientist_no_
concept_sportsteam_oilers	concept:teamplaysagainstteam	concept_sportsteam_lee_flames
concept_sportsteam_los_angeles_lakers	concept:teamplaysagainstteam	concept_sportsteam_hawks
concept_company_dc	concept:competeswith	concept_website_nbc_news
concept_country_republic	concept:countryalsoknownas	concept_country_germany
concept_sportsteam_cavs	concept:teamplaysagainstteam	concept_sportsteam_magic
concept_sportsteam_former_san_francisco_giants	concept:teamplaysagainstteam	concept_sportsteam_padres
concept_musicartist_news	concept:agentcompeteswithagent	concept_university_yahoo
concept_sportsteam_eagles	concept:teamplaysagainstteam	concept_sportsteam_minnesota_vikings
concept_sportsteam_pirates	concept:teamplaysagainstteam	concept_sportsteam_nevada_wolfpack
concept_sportsteam_la_clippers	concept:teamplaysagainstteam	concept_sportsteam_spurs
concept_politicianus_george_w_bush	concept:politicianusholdsoffice	concept_politicaloffice_president
concept_sportsteam_minnesota_twins	concept:teamplaysagainstteam	concept_sportsteam_texas_rangers
concept_geopoliticallocation_agencies	concept:organizationhiredperson	concept_personmexico_ryan_whitney
concept_company_new_york	concept:organizationhiredperson	concept_coach_eric_mangini
concept_personmexico_ryan_whitney	concept:worksfor	concept_governmentorganization_fbi
concept_company_national_city	concept:headquarteredin	concept_city_cleveland
concept_university_search	concept:agentcompeteswithagent	concept_nonprofitorganization_organizations
concept_sportsteam_boston_celtics	concept:organizationhiredperson	concept_person_allen
concept_person_blair	concept:personchargedwithcrime	concept_crimeorcharge_crimes
concept_company_bloomberg001	concept:competeswith	concept_politicsblog_journal
concept_sportsteam_heat	concept:teamplaysagainstteam	concept_sportsteam_dallas_mavericks
concept_sportsteam_pirates	concept:teamplaysagainstteam	concept_sportsteam_former_san_francisco_giants
concept_coach_steve_spurrier	concept:worksfor	concept_sportsteam_redskins
concept_politicalparty_senate	concept:organizationhiredperson	concept_person_republican
concept_beverage_coffee	concept:agriculturalproductcamefromcountry	concept_country_u_s_
concept_stateorprovince_idaho	concept:statehascapital	concept_city_boise
concept_sportsteam_titans	concept:teamplaysagainstteam	concept_sportsteam_broncos
concept_beverage_milk	concept:beveragemadefrombeverage	concept_beverage_juice
concept_ceo_lee_iacocca	concept:worksfor	concept_automobilemaker_chrysler_llc
concept_coach_dennis_green	concept:athletehomestadium	concept_stadiumoreventvenue_metrodome
concept_country_zimbabwe	concept:countryalsoknownas	concept_country_republic
concept_website_jobs	concept:synonymfor	concept_governmentorganization_us_department
concept_sportsteam_phillies	concept:teamplaysagainstteam	concept_sportsteam_rockies
concept_musicartist_dream_theater	concept:musicartistgenre	concept_musicgenre_prog
concept_stateorprovince_paypal	concept:agentcompeteswithagent	concept_university_google
concept_coach_kyle_kendrick	concept:athleteplayssport	concept_sport_baseball
concept_animal_babies	concept:animaldevelopdisease	concept_disease_disorders
concept_company_new_york	concept:competeswith	concept_politicsblog_wall_street_journal
concept_country_republic	concept:countryalsoknownas	concept_country_republic_of_lithuania
concept_sportsteam_eagles	concept:teamplaysagainstteam	concept_sportsteam_sd_chargers
concept_sportsteam_new_york_giants	concept:teamplaysagainstteam	concept_sportsteam_oakland_raiders
concept_sportsteam_red_sox	concept:teamplaysagainstteam	concept_sportsteam_cleveland_indians
concept_sportsteam_bulldogs	concept:teamplaysagainstteam	concept_sportsteam_esu_hornets
concept_city_nashville	concept:organizationhiredperson	concept_politician_bill_purcell
concept_sportsteam_pirates	concept:teamplaysagainstteam	concept_sportsteam_phils
concept_sportsteam_bulldogs	concept:teamplaysagainstteam	concept_sportsteam_army_black_knights
concept_sportsteam_mariners	concept:teamplaysagainstteam	concept_sportsteam_tampa_bay_devil_rays
concept_coach_new_york_jets	concept:agentcompeteswithagent	concept_sportsteam_philadelphia_athletics
concept_mammal_primates	concept:specializationof	concept_mammal_animals
concept_insect_flies	concept:animalsuchasinsect	concept_insect_midges
concept_insect_insect_pests	concept:animalsuchasinsect	concept_insect_mites
concept_person_walker001	concept:personborninlocation	concept_city_york
concept_building_vegas	concept:buildinglocatedincity	concept_city_las_vegas
concept_blog_google	concept:competeswith	concept_website_technorati
concept_fish_billfish	concept:agentcompeteswithagent	concept_fish_pelagics
concept_sportsteam_reds	concept:teamplaysagainstteam	concept_sportsteam_red_sox
concept_sportsteam_colts	concept:organizationhiredperson	concept_coach_tony_dungy
concept_sportsteam_kansas_city_royals	concept:teamplaysagainstteam	concept_sportsteam_white_sox
concept_sportsteam_rams	concept:teamalsoknownas	concept_sportsteam_titans
concept_sportsteam_tampa	concept:teamplaysagainstteam	concept_sportsteam_colts
concept_company_los_angeles	concept:competeswith	concept_company_daily_news001
concept_governmentorganization_government	concept:organizationhiredperson	concept_personmexico_ryan_whitney
concept_stateorprovince_ole_miss	concept:agentcompeteswithagent	concept_stateorprovince_mississippi_state
concept_personmexico_ryan_whitney	concept:worksfor	concept_governmentorganization_u_s__congress
concept_sportsteam_chicago_bulls	concept:teamplaysagainstteam	concept_sportsteam_kings_college
concept_country_republic	concept:countryalsoknownas	concept_country_turkmenistan
concept_sportsteam_bears_29_17	concept:teamplaysagainstteam	concept_sportsteam_bulldogs
concept_country_republic	concept:countryalsoknownas	concept_country_romania
concept_sportsteam_magic	concept:organizationhiredperson	concept_coach_van_gundy
concept_sportsteam_titans	concept:teamplaysagainstteam	concept_sportsteam_packers
concept_sportsteam_anaheim_ducks	concept:teamplaysagainstteam	concept_sportsteam_l_a__kings
concept_sportsteam_dallas_cowboys	concept:teamplaysagainstteam	concept_sportsteam_colts
concept_university_state_university	concept:synonymfor	concept_bank_iowa_state
concept_politician_eisenhower	concept:personchargedwithcrime	concept_crimeorcharge_murder
concept_bakedgood_sandwiches	concept:bakedgoodservedwithbeverage	concept_beverage_coffee
concept_athlete_jerry_rice	concept:athleteplayssport	concept_sport_football
concept_sportsteam_falcons	concept:teamplaysagainstteam	concept_sportsteam_saints
concept_sportsteam_dallas_cowboys	concept:teamplaysagainstteam	concept_sportsteam_bengals
concept_sportsteam_brewers	concept:teamplaysagainstteam	concept_sportsteam_new_york_giants
concept_bank_barclays	concept:organizationhiredperson	concept_ceo_john_silvester_varley
concept_sportsteam_los_angeles_lakers	concept:teamplaysagainstteam	concept_sportsteam_esu_hornets
concept_politician_jobs	concept:worksfor	concept_university_google
concept_website_links	concept:specializationof	concept_website_points
concept_visualartist_matisse	concept:visualartistartform	concept_visualizablething_painting
concept_sportsteam_tampa_bay_lightning	concept:teamplaysagainstteam	concept_sportsteam_leafs
concept_person_andy_reid	concept:worksfor	concept_sportsteam_eagles
concept_country_republic_of_guatemala	concept:countryalsoknownas	concept_country_republic
concept_university_google	concept:organizationhiredperson	concept_person_home001
concept_musicartist_season	concept:organizationhiredperson	concept_coach_mike_tomlin
concept_company_video	concept:competeswith	concept_blog_myspace
concept_sportsteam_packers	concept:teamplaysagainstteam	concept_sportsteam_cleveland_browns
concept_insect_moths	concept:animalsuchasinsect	concept_insect_insects
concept_sportsteam_seahawks	concept:teamplaysagainstteam	concept_sportsteam_oakland_raiders
concept_sportsteam_rams	concept:teamplaysagainstteam	concept_sportsteam_seahawks
concept_sportsteam_marlins	concept:teamplaysagainstteam	concept_sportsteam_astros
concept_sportsteam_pirates	concept:teamplaysagainstteam	concept_sportsteam_royals
concept_animal_students	concept:animaldevelopdisease	concept_disease_allergies
concept_sportsteam_lsu	concept:teamplaysagainstteam	concept_sportsteam_western_kentucky_hilltoppers
concept_sportsteam_colts	concept:teamplaysagainstteam	concept_sportsteam_new_york_jets
concept_company_financial	concept:competeswith	concept_politicsblog_wall_street_journal
concept_athlete_justine_henin_hardenne	concept:athletewinsawardtrophytournament	concept_awardtrophytournament_french_open
