Andrea_Zanchetta	playsFor	Vicenza_Calcio
Ronald_Brunmayr	playsFor	FC_Pasching
Milorad_Peković	playsFor	SpVgg_Greuther_Fürth
David_Knight_(English_footballer)	playsFor	York_City_F.C.
Loïck_Landre	playsFor	France_national_under-21_football_team
Samir_Aliyev	playsFor	FC_Volyn_Lutsk
Aziz_Ansah	playsFor	F.C._Ashdod
Milan_Perić	playsFor	FK_Jagodina
Edward_Said	wasBornIn	Jerusalem
Dominic_Kinnear	playsFor	San_Jose_Earthquakes
Pablo_Gabriel_García	playsFor	Real_Murcia
John_Sullivan_(English_footballer)	playsFor	Brighton_&_Hove_Albion_F.C.
Leandro_Simioni	playsFor	Yee_Hope_FC
Fernando_Gamboa	playsFor	Newell's_Old_Boys
Adam_Legzdins	playsFor	Oldham_Athletic_A.F.C.
Franz_Hasil	wasBornIn	Vienna
Muhammet_Akagündüz	playsFor	SKN_St._Pölten
Paolo_Vanoli	playsFor	Vicenza_Calcio
Éric_Mouloungui	playsFor	Śląsk_Wrocław
Danny_Murphy_(footballer,_born_1982)	playsFor	League_of_Ireland_XI
Tim_Clarke_(footballer)	playsFor	Altrincham_F.C.
Andrejs_Rubins	playsFor	FK_Auda
Frank_Swift	playsFor	England_national_football_team
Horst_Blankenburg	playsFor	SC_Preußen_Münster
Fernando_Couto	playsFor	S.S._Lazio
Georgios_Kolokoudias	playsFor	Panserraikos_F.C.
Arthur_Stepanyan	playsFor	FC_Tyumen
Dragan_Perišić	playsFor	CS_Pandurii_Târgu_Jiu
Wilko_Risser	playsFor	SV_Elversberg
David_Bishop_(rugby_player_born_1983)	playsFor	Bridgend_Ravens
Maksim_Demenko	wasBornIn	Krasnodar
Cardiff	isLocatedIn	United_Kingdom
Phil_Brown_(footballer,_born_1966)	playsFor	Lincoln_City_F.C.
Chris_Doig	playsFor	Aldershot_Town_F.C.
Alejandro_Curbelo	playsFor	Cerro_Largo_F.C.
Andrei_Kanchelskis	playsFor	FC_Dynamo_Kyiv
Ludwig_Kögl	playsFor	SpVgg_Unterhaching
Allan_McManus	playsFor	Airdrieonians_F.C._(1878)
Miki_Roqué	playsFor	Xerez_CD
Nicolae_Dică	wasBornIn	Pitești
Robert_Neagoe	playsFor	FC_Steaua_II_București
Grillo_Edson	playsFor	Comercial_Futebol_Clube_(Ribeirão_Preto)
Carlos_Germano	playsFor	Sport_Club_Internacional
Craig_Barr	playsFor	Östersunds_FK
Stan_Bowles	playsFor	Brentford_F.C.
Yaniv_Ben-Nissan	playsFor	Israel_national_under-19_football_team
Amadou_Sanokho	playsFor	Iraklis_Psachna_F.C.
Ryan_Burge	playsFor	Barnet_F.C.
Darío_Sala	playsFor	Newell's_Old_Boys
Éric_Sabin	playsFor	Northampton_Town_F.C.
Gennaro_Troianiello	playsFor	S.S._Ischia_Isolaverde
Mel_Blanc	wasBornIn	San_Francisco
Valentin_Năstase	playsFor	FC_Argeș_Pitești
Gianvito_Plasmati	playsFor	A.S._Varese_1910
Ilya_Maksimov	playsFor	Russia_national_football_B_team
Mickaël_Madar	wasBornIn	Paris
Luiz_Carlos_Guedes_Stukas	playsFor	Clube_Atlético_Bragantino
Giovane_Élber	playsFor	FC_Bayern_Munich
Uğur_İnceman	playsFor	Turkey_national_under-21_football_team
Idrissa_Coulibaly	playsFor	Espérance_de_Tunis
Pim_Verbeek	playsFor	NAC_Breda
Mamadou_Seck_(footballer)	playsFor	Le_Havre_AC
Graham_Branch	playsFor	Colwyn_Bay_F.C.
Alexandru_Pițurcă	playsFor	PFC_CSKA_Sofia
Hamdan_Al-Bishi	playsFor	A.S._Avellino_1912
Gottfried_Wilhelm_Leibniz	influences	Félix_Ravaisson-Mollien
David_Preece_(footballer_born_1963)	playsFor	Enfield_1893_F.C.
David_Geddis	playsFor	Swindon_Town_F.C.
Erfurt	isLocatedIn	Germany
Taiwo_Atieno	playsFor	Charleston_Battery
Brose_Baskets	isLocatedIn	Germany
Patrick_Doyle	wroteMusicFor	Gosford_Park
Paul_Verlaine	influences	Arthur_Rimbaud
Cristian_Agnelli	playsFor	S.S._Barletta_Calcio
Tassos_Venetis	playsFor	PAE_Kerkyra
Jamal_Mohammed	playsFor	Liberty_Professionals_F.C.
Marius_Mitu	playsFor	R.S.C._Anderlecht
Emeka_Ezeugo	playsFor	Estudiantes_de_Medicina
Brian_Cox_(actor)	hasWonPrize	Gemini_Awards
Tony_Morley	playsFor	Preston_North_End_F.C.
Jane_Fonda	hasWonPrize	Primetime_Emmy_Award
Fabian_Johnson	wasBornIn	Munich
Erkan_Sulejmani	playsFor	Serbia_national_under-19_football_team
Josh_Gowling	playsFor	Herfølge_Boldklub
Massimiliano_Giacobbo	playsFor	A.S._Cittadella
Dariusz_Rzeźniczek	playsFor	Ruch_Radzionków
Andrzej_Woźniak	playsFor	S.C._Braga
Tony_Gallimore	playsFor	Hucknall_Town_F.C.
Mark_Cairns_(footballer)	playsFor	Alloa_Athletic_F.C.
Gyula_Hegedűs	playsFor	Szolnoki_MÁV_FC
Mateus_Galiano_da_Costa	playsFor	F.C._Lixa
Shariff_Abdul_Samat	playsFor	Home_United_FC
Marcel_Reichwein	playsFor	VfR_Aalen
Rodion_Malinovsky	hasWonPrize	Order_of_Lenin
Vicente_Sánchez	wasBornIn	Montevideo
Arturo_Alvarez	playsFor	Real_Salt_Lake
Péter_Vörös	playsFor	Lokomotiv_Tashkent_FK
David_Fernández_Miramontes	wasBornIn	A_Coruña
René_Higuita	playsFor	Independiente_Medellín
Rıza_Şen	playsFor	Kasımpaşa_Spor_Kulübü
Stanislav_Karasi	playsFor	Buffalo_Stallions
Ryan_Clarke	playsFor	Kidderminster_Harriers_F.C.
Gennaro_Delvecchio	playsFor	U.S._Catanzaro_1929
João_Paulo_Andrade	playsFor	F.C._Porto
Jakarta	isLocatedIn	Indonesia
George_Kennedy	wasBornIn	New_York_City
Brian_McLaughlin_(footballer_born_1974)	playsFor	Celtic_F.C.
Carlo_Luisi	playsFor	S.S.D._Piacenza_Calcio_1919
Andrew_Gregor	wasBornIn	Syracuse,_New_York
Luis_Gabriel_Rey	playsFor	Chiapas_F.C.
Rubén_Palazuelos	playsFor	CF_Palencia
Aristotle	influences	Alfred_North_Whitehead
Liivo_Leetma	playsFor	FC_KooTeePee
Harry_Redknapp	playsFor	A.F.C._Bournemouth
Robert_Reilly_(footballer)	playsFor	Albion_Rovers_F.C.
Matías_Urbano	playsFor	Millonarios_Fútbol_Club
Debra_Messing	graduatedFrom	New_York_University
Jason_Crowe	playsFor	Brentford_F.C.
Delfim_Teixeira	playsFor	BSC_Young_Boys
Maputo	isLocatedIn	Africa
Belgrade	isLocatedIn	Central_Serbia
Ricardo_Mauricio_Martínez	playsFor	Monarcas_Morelia
Zlatko_Kranjčar	playsFor	Croatia_national_football_team
Ronny_Johnsen	playsFor	Beşiktaş_J.K.
Rezo_Dzhikiya	playsFor	FC_Chita
George_S._Patton	hasWonPrize	Order_of_the_White_Lion
Martyn_Naylor	playsFor	Telford_United_F.C.
Nigel_Pepper	playsFor	Barrow_A.F.C.
Timo_Uster	playsFor	SpVgg_Blau-Weiß_1890_Berlin
Markus_Berger	playsFor	IK_Start
Rob_Matthaei	wasBornIn	Amsterdam
Andrei_Sidorenkov	playsFor	FC_Fredericia
Dancer_in_the_Dark	isLocatedIn	United_Kingdom
Dirceu	playsFor	MKE_Ankaragücü
Burt_Bacharach	isMarriedTo	Angie_Dickinson
Liam_Chilvers	playsFor	Northampton_Town_F.C.
António_Sousa	playsFor	Sporting_Clube_de_Portugal
Jan_Michaelsen	playsFor	Akademisk_Boldklub
Bram_Castro	playsFor	Heracles_Almelo
Drewe_Broughton	playsFor	Wigan_Athletic_F.C.
Cristiano_Moraes_de_Oliveira	playsFor	Sporting_Clube_de_Portugal
Luciano_Emílio	playsFor	União_Agrícola_Barbarense_Futebol_Clube
Mladen_Bartolović	playsFor	HNK_Segesta
Dancer_in_the_Dark	isLocatedIn	Iceland
Duane_Darby	playsFor	Shrewsbury_Town_F.C.
Ben_Hecht	hasWonPrize	Academy_Award
Leonardo_Hermes_Lau	playsFor	Brusque_Futebol_Clube
Yoann_Arquin	playsFor	Red_Star_F.C.
Eric_Agyemang	playsFor	SC_Pfullendorf
André_Egli	playsFor	Servette_FC
Tabaré_Silva	playsFor	Defensor_Sporting
Ian_Ross_(footballer_born_1986)	playsFor	Harrogate_Town_F.C.
Mark_Wells_(footballer)	playsFor	Hinckley_United_F.C.
Luciano_Chiarugi	playsFor	ACF_Fiorentina
Jason_Oost	playsFor	VVV-Venlo
Frederick_the_Great	playsFor	Chiapas_F.C.
Mark_Walters	playsFor	Bristol_Rovers_F.C.
Matthew_Berkeley	playsFor	Altrincham_F.C.
Josef_Ivanović	playsFor	TuS_Koblenz
Angelo_Vaccaro	playsFor	FC_08_Homburg
Ganiyu_Oseni	playsFor	Hoàng_Anh_Gia_Lai_F.C.
Maniche	hasWonPrize	Order_of_Prince_Henry
Bruno_Coutinho_Martins	playsFor	América_Futebol_Clube_(RN)
Ihor_Zhabchenko	playsFor	FC_Rotor_Volgograd
Adrian_García_Arias	playsFor	Querétaro_F.C.
Gary_McSwegan	playsFor	Heart_of_Midlothian_F.C.
Janusz_Dziedzic	playsFor	Pogoń_Szczecin
Paul_Parker_(footballer)	playsFor	Farnborough_F.C.
Felipe_Batista_Pinto	playsFor	Democrata_Futebol_Clube
Tommaso_Berni	playsFor	Wimbledon_F.C.
Munich_Airport	isLocatedIn	Munich
Jan_Poortvliet	playsFor	AS_Cannes
José_Sand	playsFor	Deportivo_de_La_Coruña
Ivan_Lietava	playsFor	FC_Spartak_Trnava
André_Leone	playsFor	Vicenza_Calcio
Bo_Henriksen	playsFor	Herfølge_Boldklub
Paulinho_Dias	playsFor	Cruzeiro_Esporte_Clube
Alexandros_Tzorvas	playsFor	Greece_national_football_team
Yaoundé_Nsimalen_International_Airport	isLocatedIn	Cameroon
Laurent_Delorge	wasBornIn	Leuven
Georg_Cantor	graduatedFrom	Humboldt_University_of_Berlin
Ibrahim_Maaroufi	playsFor	Parseh_Tehran_F.C.
Lee_Ridley	playsFor	Lincoln_City_F.C.
Roberto_Soldado	playsFor	Tottenham_Hotspur_F.C.
Welton_Felipe	playsFor	Boa_Esporte_Clube
Mark_Bright	playsFor	Crystal_Palace_F.C.
Mehdi_Mahdavikia	wasBornIn	Tehran
Roger_Jones_(footballer_born_1946)	playsFor	York_City_F.C.
Alexandre_Desplat	wroteMusicFor	Harry_Potter_(film_series)
Grégory_Dufer	playsFor	K.S.C._Lokeren_Oost-Vlaanderen
Haile_Selassie_I_of_Ethiopia	hasChild	Amha_Selassie
Quentin_Tarantino	hasWonPrize	Edgar_Award
Iain_Russell	playsFor	Greenock_Morton_F.C.
Cornell_Glen	playsFor	FC_Dallas
Rodolfo_Rodríguez_(footballer)	playsFor	Deportivo_Saprissa
Eder_Baù	playsFor	Delfino_Pescara_1936
Ian_Ross_(footballer_born_1986)	playsFor	Bury_F.C.
Éver_Banega	playsFor	Argentina_national_under-20_football_team
Lucas_Castromán	playsFor	Udinese_Calcio
Mauro_Minelli	playsFor	Unione_Triestina_2012_S.S.D.
Diego_Aguirre	playsFor	ACF_Fiorentina
Moses_Sichone	playsFor	Zambia_national_football_team
Jim_Bett	playsFor	Valur_Football_Club
Edgars_Gauračs	playsFor	FC_Yenisey_Krasnoyarsk
Victor_Kodelja	playsFor	Calgary_Boomers
Catherine_O'Hara	hasWonPrize	Genie_Awards
Răzvan_Cociș	playsFor	Romania_national_under-21_football_team
Jimmy_Ghaichem	playsFor	Rushden_&_Diamonds_F.C.
John_Scales	playsFor	England_national_football_team
Don_Rickles	influences	Norm_Macdonald
Pavel_Fořt	playsFor	RWDM_Brussels_FC
Steve_Foster_(footballer_born_1974)	playsFor	Blyth_Spartans_A.F.C.
William_Shakespeare	influences	Joaquim_Maria_Machado_de_Assis
Abel_Silva	wasBornIn	Lisbon
Delfín_Benítez_Cáceres	playsFor	Argentina_national_football_team
Stan_Montgomery	playsFor	Cardiff_City_F.C.
Magnus_Okuonghae	playsFor	Aldershot_Town_F.C.
Matías_Pérez_García	playsFor	Argentina_national_under-20_football_team
Ade_Coker	playsFor	Baltimore_Blast_(1980–92)
Martin_Christensen	playsFor	SønderjyskE
de/Die_Schule_für_Berufe_mit_Zukunft	isLocatedIn	Lübeck
NAC_Breda	isLocatedIn	Breda
Matt_Groves	playsFor	Weymouth_F.C.
Tomoyuki_Sakai	playsFor	Deltras_F.C.
Silvio_Luiz_Oliveira_de_Paula	playsFor	Associação_Desportiva_São_Caetano
Julio_César_Yegros	playsFor	Cerro_Porteño
David_Byrne_(footballer,_born_1960)	wasBornIn	Guildford
Fernando_Morientes	playsFor	Spain_national_under-20_football_team
Fabián_Espíndola	playsFor	Deportivo_Anzoátegui
Márcio_da_Silva_Gomes	playsFor	Clube_de_Regatas_do_Flamengo
Igor_Korneev	playsFor	Russia_national_football_team
Thabiso_Khumalo	playsFor	Michigan_Bucks
José_Nunes	playsFor	S.C._Salgueiros
Félix_Ravaisson-Mollien	influences	Paul_Ricœur
Daniel_Scheinhardt	playsFor	VfL_Osnabrück
Marcos_Tavares	wasBornIn	Porto_Alegre
Gérson_Magrão	playsFor	Figueirense_Futebol_Clube
Gino_Gardassanich	playsFor	ACF_Fiorentina
Daniel_Veyt	playsFor	K.S.C._Lokeren_Oost-Vlaanderen
José_Juan_Luque	playsFor	Sevilla_Atlético
Andreas_Labropoulos	playsFor	Panachaiki_G.E.
Cornel_Predescu	wasBornIn	Bucharest
Milan_Biševac	playsFor	Olympique_Lyonnais
Jimmy_McCormick	playsFor	Lincoln_City_F.C.
Vittorio_Tosto	playsFor	A.S._Avellino_1912
Francis_Kioyo	playsFor	Union_Douala
Victoria,_British_Columbia	isLocatedIn	Canada
Tommy_Wright_(footballer,_born_1984)	playsFor	Brentford_F.C.
John_Pelu	playsFor	Rosenborg_BK
Andy_Mulliner	playsFor	Rhyl_F.C.
Buddy_Farah	playsFor	APIA_Leichhardt_Tigers_FC
Luka_Modrić	playsFor	NK_Inter_Zaprešić
Grigol_Chanturia	playsFor	FC_Lokomotivi_Tbilisi
Paul_Furlong	playsFor	Birmingham_City_F.C.
Federico_Laurito	playsFor	Newell's_Old_Boys
Eike_Immel	playsFor	Germany_national_youth_football_team
Nélson_Marcos	playsFor	Vilanovense_F.C.
William_Friedkin	wasBornIn	Chicago
Travis_Mulraine	playsFor	D.C._United
Willie_Hamilton_(footballer)	playsFor	Scottish_Football_League_XI
Charlie_McGillivray	playsFor	Albion_Rovers_F.C.
Thomson_Allan	playsFor	Heart_of_Midlothian_F.C.
Vicente_Sánchez	playsFor	Uruguay_national_football_team
Simon_Webster_(footballer)	playsFor	West_Ham_United_F.C.
Steve_Staunton	playsFor	Republic_of_Ireland_national_under-21_football_team
Sandy_Clark	playsFor	West_Ham_United_F.C.
Carlos_Chaínho	playsFor	C.F._Estrela_da_Amadora
Rodrigue_Akpakoun	playsFor	La_Roche_VF
Jay_O'Shea	playsFor	Birmingham_City_F.C.
Glenn_Helder	playsFor	Arsenal_F.C.
Rob_Lee	playsFor	West_Ham_United_F.C.
Geena_Davis	actedIn	Cutthroat_Island
Chris_Simpkin	playsFor	Baltimore_Comets
João_Francisco_de_Sales	playsFor	Clube_Atlético_Bragantino
Jean_Harbor	playsFor	Montreal_Impact
Peter_Beardsley	playsFor	Everton_F.C.
Gionatha_Spinesi	playsFor	Inter_Milan
Rui_Correia	playsFor	A.D._Ovarense
Vanče_Šikov	playsFor	Ethnikos_Achna_FC
Peter_Higgs	worksAt	University_of_Edinburgh
Eduard_Boltrushevich	wasBornIn	Vitebsk
Róbson	playsFor	Sport_Club_Internacional
José_Mera	playsFor	Independiente_Medellín
Kim_Eun-jung_(footballer)	playsFor	South_Korea_national_football_team
Eddie_Bishop	playsFor	Runcorn_F.C._Halton
Peter_Läng	playsFor	Switzerland_national_under-21_football_team
Juan_Gonzalo_Lorca	playsFor	Deportes_Antofagasta
Thierry_Gathuessi	playsFor	Cameroon_national_football_team
Carl_Fletcher_(Welsh_footballer)	playsFor	West_Ham_United_F.C.
Marco_Tulio	playsFor	Clube_Atlético_Bragantino
Alf_Common	playsFor	Arsenal_F.C.
Drewe_Broughton	playsFor	Kidderminster_Harriers_F.C.
Mike_Sheron	playsFor	Bury_F.C.
Uğur_İnceman	wasBornIn	Aachen
Luciano_Emílio	playsFor	Danubio_F.C.
Byron_Bubb	playsFor	Slough_Town_F.C.
Gennaro_Sardo	playsFor	A.C._Chievo_Verona
Gary_Poole	playsFor	Tottenham_Hotspur_F.C.
Dragan_Perišić	wasBornIn	Belgrade
Ian_Stevens_(footballer)	playsFor	Barrow_A.F.C.
Marvin_Robinson	playsFor	Hednesford_Town_F.C.
Paul_Ritchie_(footballer_born_1975)	playsFor	Heart_of_Midlothian_F.C.
Rudolf_Skácel	playsFor	FC_Hradec_Králové
Sasho_Angelov	playsFor	PFC_Botev_Plovdiv
Josiel_da_Rocha	playsFor	Esporte_Clube_Juventude
Micah_Hyde_(footballer)	playsFor	Burnley_F.C.
Moreno_Aoas_Vidal	playsFor	K.A.S._Eupen
Maksim_Shatskikh	playsFor	FC_Sokol_Saratov
Erhan_Kavak	playsFor	Kartal_S.K.
Wayne_O'Sullivan	playsFor	Cardiff_City_F.C.
Milan_Đurić	playsFor	U.S._Cremonese
Gary_Megson	playsFor	Shrewsbury_Town_F.C.
Zvonko_Monsider	playsFor	HŠK_Concordia
Gustaf_V_of_Sweden	hasWonPrize	Order_of_the_White_Lion
Arjan_Sheta	playsFor	KS_Kastrioti
Alberto_Botía	playsFor	Spain_national_under-23_football_team
Arjan_Beqaj	playsFor	Ionikos_F.C.
Borko_Veselinović	playsFor	Dalian_Shide_F.C.
José_Marcelo_Ferreira	playsFor	Associação_Portuguesa_de_Desportos
Bahman_Tahmasebi	playsFor	Aluminium_Hormozgan_F.C.
Mick_Lambert	playsFor	Vancouver_Whitecaps_(1974–84)
Ioannis_Masmanidis	playsFor	K.A.S._Eupen
James_Robinson_(footballer_born_1982)	playsFor	Crewe_Alexandra_F.C.
Billy_Hughes_(footballer_born_1918)	playsFor	Birmingham_City_F.C.
Mark_Walters	playsFor	Liverpool_F.C.
Steve_Robinson_(English_footballer)	playsFor	Grantham_Town_F.C.
James_Beattie_(footballer)	playsFor	England_national_football_team
Marvin_Compper	playsFor	TSG_1899_Hoffenheim
Yuriy_Maksymov	playsFor	SV_Werder_Bremen
Gabriel_Álvez	playsFor	Defensor_Sporting
Chérif_Oudjani	playsFor	Valenciennes_FC
Burkina_Faso	hasOfficialLanguage	French_language
Dorel_Zaharia	playsFor	FC_Unirea_Urziceni
Amadou_Touré	playsFor	R.O.C._de_Charleroi-Marchienne
Vinícius_Conceição_da_Silva	playsFor	Esporte_Clube_São_José
Matías_Alonso	playsFor	Juventud_de_Las_Piedras
Ursula_K._Le_Guin	influences	William_Gibson
Hilary_Putnam	isInterestedIn	Philosophy_of_language
David_Galbraith	playsFor	Northampton_Town_F.C.
Houssine_Kharja	playsFor	Inter_Milan
Pedro_Pasculli	playsFor	Club_Atlético_Colón
Bruno_Akrapović	playsFor	RSV_Göttingen_05
Benjamin_Auer	playsFor	VfL_Bochum
Pierre_Vermeulen	playsFor	MVV_Maastricht
Västernorrland_County	isLocatedIn	Europe
Kris_Kelderman	playsFor	Buffalo_Blizzard
Joey_Leonetti	playsFor	Portland_Pilots
Stockard_Channing	hasWonPrize	Primetime_Emmy_Award
Hervé_Kage	playsFor	R.S.C._Anderlecht
Richard_Walker_(footballer_born_1977)	playsFor	Northampton_Town_F.C.
Wellington_Luís_de_Sousa	playsFor	Sport_Club_Internacional
John_Pelu	playsFor	Helsingborgs_IF
Jamie_Pollock	playsFor	Crystal_Palace_F.C.
Manuel_Ruiz	playsFor	Xerez_CD
Edmond_Kapllani	playsFor	NK_Orijent
Jim_Beglin	playsFor	Liverpool_F.C.
Christian_Maicon_Hening	playsFor	TSG_1899_Hoffenheim
Dong_Fangzhuo	wasBornIn	Dalian
Chan_Siu_Ki	playsFor	South_China_AA
Niklas_Andersen	playsFor	Germany_national_youth_football_team
Branko_Šegota	playsFor	San_Diego_Sockers_(1978–96)
Cristiano_da_Silva_Santos	playsFor	Clube_Atlético_Mineiro
Mbulelo_Mabizela	playsFor	Platinum_Stars_F.C.
Adolf_Hitler	isPoliticianOf	Germany
Michal_Kolomazník	wasBornIn	Brno
Freddie_Fox_(footballer)	wasBornIn	Swindon
Miklos_Molnar	playsFor	FSV_Frankfurt
Carlos_Villagra	playsFor	Cerro_Porteño
Lee_Roache	playsFor	Eastleigh_F.C.
Francesco_Bolzoni	playsFor	Frosinone_Calcio
Yokohama	isLocatedIn	Kanagawa_Prefecture
Bakary_Diakité	playsFor	TuS_Koblenz
Junior_Agogo	wasBornIn	Accra
Goran_Vučević	playsFor	HNK_Hajduk_Split
Amr_Samaka	playsFor	Kazma_Sporting_Club
George_O'Neill	playsFor	Greenock_Morton_F.C.
Dmitri_Ekimov	playsFor	FC_Dinamo_Minsk
Virgile_Boumelaha	playsFor	FC_Sochaux-Montbéliard
Luiz_Alberto_da_Silva_Oliveira	playsFor	Clube_de_Regatas_do_Flamengo
Frank_Sinatra	playsFor	Al-Zawra'a_SC
Massimo_Zappino	playsFor	S.S.D._Acireale_Calcio_1946
Lenny_Fernandes_Coelho	playsFor	Desportivo_Brasil
Cícero_Semedo	playsFor	Vitória_S.C.
Benoit_Mandelbrot	graduatedFrom	École_Polytechnique
Richard_Pacquette	playsFor	Eastleigh_F.C.
Alexander_Pushkin	influences	Vladimir_Nabokov
Neider_Morantes	playsFor	Atlético_Nacional
Dani_Schahin	playsFor	SpVgg_Greuther_Fürth
Alexandro_Alves_do_Nascimento	playsFor	Cruzeiro_Esporte_Clube
Eliézio_Santos_Santana	playsFor	F.C._Porto
Sergio_Sánchez_Ortega	playsFor	Racing_de_Santander
Craig_Bellamy	playsFor	Liverpool_F.C.
Matías_Almeyda	playsFor	Inter_Milan
Ludwig_Wittgenstein	influences	John_Searle
Ricky_Sappleton	playsFor	Jamaica_national_football_team
Cabore	playsFor	Esporte_Clube_Vitória
Abraham_Kumedor	playsFor	Italy_national_under-18_football_team
Nelson_Rivas	playsFor	Deportivo_Pasto
Kirk_Hudson	playsFor	Aldershot_Town_F.C.
César_Cueto	wasBornIn	Lima
Robert_Ukrop	playsFor	Fort_Lauderdale_Strikers_(1988–94)
Fatmir_Vata	playsFor	TuS_Koblenz
Novak_Martinović	playsFor	CS_Pandurii_Târgu_Jiu
Juan_Martín_Parodi	playsFor	Uruguay_national_football_team
Julio_César_Manzur	playsFor	Club_Cerro_Corá
Aria_(film)	isLocatedIn	United_Kingdom
Michael_Collins_(soccer)	playsFor	St._Louis_Storm
Serge_Dié	playsFor	Reggina_Calcio
D._H._Lawrence	influences	Anthony_Burgess
Mo_Camara	playsFor	Norwich_City_F.C.
Krunoslav_Lovrek	playsFor	HNK_Hajduk_Split
Sam_Ricketts	playsFor	Wales_national_football_team
Mark_Molesley	playsFor	A.F.C._Bournemouth
Renedy_Singh	playsFor	Mohun_Bagan_A.C.
Bram_Castro	playsFor	K.R.C._Genk
Andrea_Parola	playsFor	S.S.D._Piacenza_Calcio_1919
William_James	influences	B._F._Skinner
Maksim_Buznikin	wasBornIn	Krasnodar
Tom_Murphy_(footballer)	playsFor	Farnborough_F.C.
Paul_Reid_(footballer_born_1968)	playsFor	Oldham_Athletic_A.F.C.
Tony_Taylor_(footballer)	playsFor	Swindon_Town_F.C.
Sean_Fraser_(Jamaican_footballer)	playsFor	Once_Municipal
Serhiy_Karpenko	playsFor	PFC_Nyva_Vinnytsia
Rodgers_Kola	playsFor	Hapoel_Ironi_Kiryat_Shmona_F.C.
Miguel_de_Cervantes	influences	Laurence_Sterne
René_Guénon	wasBornIn	Blois
Wesley_Charles	playsFor	FC_Rostov
Frederick_Groves_(footballer_born_1892)	playsFor	Lincoln_City_F.C.
Paweł_Kaczmarek	playsFor	Wisła_Płock
Rodrigo_Alvim	playsFor	C.F._Os_Belenenses
Branko_Karačić	playsFor	Royale_Union_Saint-Gilloise
Karl_Dodd	playsFor	Northern_Fury_FC
Swansea	isLocatedIn	United_Kingdom
Ryan_Gilligan	playsFor	Northampton_Town_F.C.
Mixu_Paatelainen	playsFor	Wolverhampton_Wanderers_F.C.
Manny_Lagos	playsFor	Minnesota_Thunder
José_Batista_Leite_da_Silva	playsFor	Adap_Galo_Maringá_Football_Club
Martin_Černoch	playsFor	FC_Spartak_Trnava
Erick_Torres	playsFor	Peru_national_football_team
Viv_Busby	playsFor	Norwich_City_F.C.
Ólafur_Ingi_Skúlason	playsFor	Brentford_F.C.
Rafał_Szwed	playsFor	GKS_Tychy
Howard_Pritchard	playsFor	Swindon_Town_F.C.
Denis_Diderot	influences	Milan_Kundera
Matej_Krajčík	playsFor	Reggina_Calcio
Angelo_Costanzo	playsFor	Marconi_Stallions_FC
Andrew_Wiles	isCitizenOf	United_Kingdom
Anton_Robinson	playsFor	Millwall_F.C.
Marek_Chojnacki	wasBornIn	Łódź
Fabrice_Reuperné	playsFor	Martinique_national_football_team
Josip_Tadić	playsFor	AC_Omonia
Thomas_Kyparissis	playsFor	Pierikos_F.C.
Nassim_Mendil	playsFor	A.S._Avellino_1912
Horacio_Chiorazzo	playsFor	Club_Real_Potosí
Mark_Pritchard_(footballer)	playsFor	Carmarthen_Town_A.F.C.
Tony_Taylor_(footballer)	playsFor	Northampton_Town_F.C.
Marko_Livaja	playsFor	FC_Lugano
Moudachirou_Amadou	playsFor	FC_St._Pauli
Roy_Barry	playsFor	Crystal_Palace_F.C.
Ruud_Kaiser	playsFor	K.F.C._Dessel_Sport
Neil_Pointon	playsFor	Manchester_City_F.C.
Paulo_Baier	playsFor	Goiás_Esporte_Clube
Jefferson_Louis	playsFor	Hemel_Hempstead_Town_F.C.
Andreas_Reisinger	playsFor	Favoritner_AC
Juan_Toja	playsFor	FC_Dallas
Samson_Siasia	playsFor	El-Kanemi_Warriors_F.C.
Anatoliy_Kitsuta	playsFor	FC_Borysfen_Boryspil
Neil_Jenkins_(footballer)	playsFor	Hampton_&_Richmond_Borough_F.C.
Mehmet_Batdal	playsFor	Kardemir_D._Ç._Karabükspor
Mohammad_Ahmadzadeh	wasBornIn	Bandar-e_Anzali
Nemanja_Supić	playsFor	FK_Voždovac
Frode_Grodås	playsFor	Racing_de_Santander
Charlie_Hewitt	playsFor	West_Bromwich_Albion_F.C.
Lee_Croft	playsFor	Manchester_City_F.C.
Almir_Tolja	playsFor	Nassaji_Mazandaran_F.C.
Richard_Rodgers	hasWonPrize	Pulitzer_Prize_for_Drama
Alou_Diarra	playsFor	Le_Havre_AC
Pablo_Cáceres_Rodríguez	playsFor	AC_Omonia
Sébastien_Sansoni	playsFor	Neuchâtel_Xamax
BFC_Viktoria_1889	isLocatedIn	Berlin
Henry_Eyring	graduatedFrom	University_of_California,_Berkeley
Luigi_Allemandi	playsFor	Inter_Milan
Teet_Allas	playsFor	Dalkurd_FF
André_Carvalhas	wasBornIn	Lisbon
Tsanko_Tsvetanov	playsFor	Bulgaria_national_football_team
Amby_Fogarty	playsFor	Drumcondra_F.C.
César_La_Paglia	playsFor	San_Martín_de_Tucumán
François_Félix	playsFor	Olympique_Lyonnais
Charles_Dickens	influences	Vladimir_Nabokov
Bekim_Kastrati	playsFor	Aris_F.C._(Thessaloniki)
Iranildo_Hermínio_Ferreira	playsFor	Associação_Desportiva_São_Caetano
Steven_Caldwell	playsFor	Wigan_Athletic_F.C.
Idriss_Carlos_Kameni	playsFor	Cameroon_national_football_team
Fernando_Menegazzo	playsFor	A.C._Siena
Little_Vietnam	isLocatedIn	United_Kingdom
Radu_Niculescu	playsFor	Changchun_Yatai_F.C.
Daniel_Martín	playsFor	Real_Betis_B
John_Huston	hasWonPrize	Legion_of_Merit
Kyle_Porter	playsFor	D.C._United
Daniel_Amokachi	playsFor	Everton_F.C.
Marius_Niculae	playsFor	Kavala_F.C.
Ben_Thatcher	playsFor	Millwall_F.C.
Gilbert_Ryle	influences	J._L._Austin
Michel_Vonk	playsFor	Sheffield_United_F.C.
Mark_Bentley	playsFor	Boreham_Wood_F.C.
Germán_Lux	playsFor	Deportivo_de_La_Coruña
Belize	exports	wordnet_clothing_103051540
Saudi_detainees_at_Guantanamo_Bay	playsFor	Gap_FC
Martin_McIntosh	playsFor	Guiseley_A.F.C.
Pat_Noonan	playsFor	LA_Galaxy
Émerson_Leão	playsFor	Sport_Club_do_Recife
Sherjill_MacDonald	wasBornIn	Amsterdam
Dante_Alighieri	influences	Alojz_Rebula
Roberto_Boninsegna	playsFor	Inter_Milan
Emiliano_Dudar	playsFor	D.C._United
Omar_Jarun	playsFor	Pogoń_Szczecin
Corneliu_Papură	playsFor	Changchun_Yatai_F.C.
Motohiro_Yamaguchi	playsFor	Albirex_Niigata
Dejan_Ilić	playsFor	Maccabi_Tel_Aviv_F.C.
Nemanja_Milisavljević	playsFor	PFC_CSKA_Sofia
David_Banks_(soccer)	playsFor	Philadelphia_University
Renan_Marques	playsFor	Baniyas_SC
Spira_Grujić	wasBornIn	Pristina
Mikheil_Khutsishvili	playsFor	Kapaz_PFK
Justo_Ruiz	playsFor	UE_Figueres
Daniele_Amerini	playsFor	Frosinone_Calcio
Steve_Sidwell	playsFor	Brighton_&_Hove_Albion_F.C.
Brittany_Timko	playsFor	Vancouver_Whitecaps_FC_(women)
Stuart_Lewis	playsFor	Arsenal_F.C.
Dirk_Caspers	playsFor	SG_Wattenscheid_09
João_Paulo_Daniel	playsFor	Desportivo_Brasil
Fábio_Nunes_Fernandes	playsFor	Sport_Club_Internacional
Chris_Lucketti	playsFor	Stockport_County_F.C.
Gordon_Smith_(footballer_born_1991)	wasBornIn	Edinburgh
Delroy_Facey	wasBornIn	Huddersfield
Bruno_Rodriguez	playsFor	Rayo_Vallecano
Bogomil_Dyakov	playsFor	PFC_Spartak_Varna
MacBeth_Sibaya	playsFor	Rosenborg_BK
Koo_Ja-cheol	playsFor	South_Korea_national_football_team
Schwenck	playsFor	Figueirense_Futebol_Clube
Dieter_Van_Tornhout	playsFor	Roda_JC_Kerkrade
Ian_Wallace_(footballer)	playsFor	Dumbarton_F.C.
Jovan_Kostovski	playsFor	Macedonia_national_under-21_football_team
Johan_Cavalli	playsFor	Nîmes_Olympique
Silvio_Carrario	playsFor	Racing_Club_de_Avellaneda
Matías_Oyola	playsFor	Club_Atlético_Colón
Salvatore_Campilongo	playsFor	U.S._Città_di_Palermo
Senad_Tiganj	playsFor	SAK_Klagenfurt
Serhiy_Svystun	playsFor	FC_Lokomotiv_Nizhny_Novgorod
Friedhelm_Funkel	playsFor	KFC_Uerdingen_05
Toninho_Dos_Santos	playsFor	Club_América
Ilie_Bărbulescu	playsFor	FC_Argeș_Pitești
Wassily_Leontief	wasBornIn	Munich
Tiago_Henrique_Gonçalves	playsFor	Associação_Ferroviária_de_Esportes
Daniel_Šmejkal	playsFor	Dukla_Prague
Ángel_di_María	wasBornIn	Rosario,_Santa_Fe
Reiner_Maurer	playsFor	BSC_Old_Boys
Sol_Campbell	playsFor	England_national_football_team
Dion_Esajas	playsFor	FC_Lisse
Olav_V_of_Norway	hasChild	Harald_V_of_Norway
Yancarlo_Casas	playsFor	Estudiantes_de_Medicina
Vinha	wasBornIn	Praia
Nikola_Milojević	playsFor	FK_Borac_Čačak
Ramsay_MacDonald	playsFor	Israel_national_under-18_football_team
Quique_Flores	playsFor	Real_Madrid_C.F.
Hamilton_(Ontario)	isLocatedIn	Ontario
Scott_Parker	playsFor	Norwich_City_F.C.
John_MacDonald_(footballer)	playsFor	Airdrieonians_F.C._(1878)
Ricky_George	playsFor	Barnet_F.C.
Pepe_Mel	playsFor	RSD_Alcalá
Rafael_Barber	playsFor	Xerez_CD
Sergio_Órteman	wasBornIn	Montevideo
Frank_Sinatra	playsFor	Talaba_SC
Peter_Woodring	playsFor	AaB_Fodbold
Boban_Stojanović	playsFor	FK_Hajduk_Kula
Dianne_Wiest	wasBornIn	Kansas_City,_Missouri
Vítor_Valente	playsFor	F.C._Alverca
Bobsam_Elejiko	playsFor	Waasland-Beveren
Emilio_Martínez	playsFor	Universidad_Católica_del_Ecuador
José_Manuel_Rey	playsFor	Venezuela_national_football_team
Godfrey_Ingram	playsFor	Pittsburgh_Spirit
Dean_Ashton	playsFor	Crewe_Alexandra_F.C.
Ruslan_Nakhushev	playsFor	FC_Anzhi_Makhachkala
Jan_Tauer	playsFor	Iraklis_Psachna_F.C.
Fallah_Johnson	playsFor	Persita_Tangerang
Jorge_Ribeiro	playsFor	Gil_Vicente_F.C.
Paul_Barron	playsFor	Slough_Town_F.C.
Claudio_Flores	playsFor	Club_Libertad
Nino_Rota	hasWonPrize	David_di_Donatello
Roy_Proverbs	playsFor	Stratford_Town_F.C.
Matías_Manrique	playsFor	Ñublense
Mario_Grgurović	playsFor	NK_Inter_Zaprešić
Amadou_Sanokho	playsFor	San_Frediano_Rondinella_S.S.
Richard_Roelofsen	playsFor	De_Graafschap
Rinaldo_Santana_dos_Santos	playsFor	Clube_Atlético_Mineiro
Craig_Barr	wasBornIn	Edinburgh
Alain_Cantareil	playsFor	AC_Ajaccio
Jefferson_Angulo	playsFor	Deportivo_Pereira
Vadym_Deonas	playsFor	FC_Spartak_Ivano-Frankivsk
Eduardo_Lillingston	playsFor	Club_Atlas
Freeman_Dyson	hasWonPrize	Wolf_Prize_in_Physics
Ashley_Grimes_(English_footballer)	playsFor	Lincoln_City_F.C.
Robertas_Poškus	playsFor	Bnei_Sakhnin_F.C.
Lee_Morris_(footballer)	playsFor	Derby_County_F.C.
Giovane_Élber	wasBornIn	Londrina
Freddie_Fox_(footballer)	playsFor	Brentford_F.C.
Paul_Hall_(footballer)	playsFor	Coventry_City_F.C.
Agon_Mehmeti	playsFor	U.S._Città_di_Palermo
Leigh_Palin	playsFor	Burnley_F.C.
Ardan_Aras	playsFor	PSM_Makassar
Roberto_Cartes	playsFor	Querétaro_F.C.
Scouting_in_California	isLocatedIn	Pasadena,_California
Ionuț_Rada	playsFor	CS_Otopeni
Gilberto_Palacios	playsFor	Tacuary
Gennaro_Delvecchio	playsFor	U.C._Sampdoria
Alberto_Luiz_de_Souza	playsFor	Grêmio_Barueri_Futebol
Diogo_Tavares	wasBornIn	Lisbon
John_Nutter	playsFor	Stevenage_F.C.
Poole	isLocatedIn	United_Kingdom
Karl_Decker_(footballer)	playsFor	FC_Sochaux-Montbéliard
Antônio_Bezerra_Brandão	playsFor	Associação_Ferroviária_de_Esportes
Harry_McShane_(footballer)	playsFor	Telford_United_F.C.
David_Yelldell	wasBornIn	Stuttgart
Ahmed_Abou_Moslem	playsFor	Ismaily_SC
Bill_Lacey_(footballer)	playsFor	Exeter_City_F.C.
Márcio_da_Silva_Gomes	playsFor	Paysandu_Sport_Club
Rubén_Baraja	playsFor	Real_Valladolid_B
Kayke_Rodrigues	wasBornIn	Brasília
Július_Šimon	playsFor	FC_Senec
Toni_Doblas	wasBornIn	Seville
Julio_Ricardo_Cruz	playsFor	Inter_Milan
Balázs_Dzsudzsák	playsFor	FC_Anzhi_Makhachkala
Lee_Sze_Ming	playsFor	Hong_Kong_Rangers_FC
Roberto_Colautti	playsFor	Maccabi_Tel_Aviv_F.C.
Giorgio_Frezzolini	playsFor	S.S._Lazio
Hélder_Cristóvão	wasBornIn	Luanda
Curtis_Fleming	playsFor	Swindon_Town_F.C.
Derek_Smethurst	playsFor	Tampa_Bay_Rowdies_(1975–93)
Léo_Fortunato	playsFor	Cruzeiro_Esporte_Clube
Ciaran_O'Brien	playsFor	Seattle_Sounders_(1994–2008)
Mahamadou_Dissa	playsFor	Mali_national_football_team
Paul_Trollope	playsFor	Northampton_Town_F.C.
Robert_Paul_(footballer)	playsFor	SV_Wehen_Wiesbaden
Norbert_Eschmann	wasBornIn	Besançon
Daniel_Paulista	playsFor	Esporte_Clube_Juventude
João_Soares_de_Almeida_Neto	playsFor	Cruzeiro_Esporte_Clube
Herbert_Banks	playsFor	Stafford_Rangers_F.C.
Martin_Pedersen_(footballer)	wasBornIn	Aalborg
Oribe_Peralta	playsFor	Monarcas_Morelia
Léo_Itaperuna	playsFor	Duque_de_Caxias_Futebol_Clube
Emerson_Thome	playsFor	F.C._Alverca
Mesut_Özil	playsFor	Germany_national_football_team
Matt_Green_(footballer)	playsFor	Newport_County_A.F.C.
Shep_Messing	playsFor	Oakland_Stompers
Owen_Madden_(footballer)	playsFor	Sligo_Rovers_F.C.
Republic_of_the_Congo	exports	wordnet_coffee_bean_107929351
Niklas_Sandberg	playsFor	IK_Brage
Sebastián_Brusco	playsFor	Racing_Club_de_Avellaneda
Robin_Hulbert	playsFor	Telford_United_F.C.
Erik_Setiawan	playsFor	Persib_Bandung
Shaun_Harrad	playsFor	Bury_F.C.
Jani_Viander	playsFor	F.C._Ashdod
Baltazar_Maria_de_Morais_Júnior	playsFor	Grêmio_Foot-Ball_Porto_Alegrense
Gordon_Durie	playsFor	Heart_of_Midlothian_F.C.
Martin_Russell_(footballer)	playsFor	Birmingham_City_F.C.
Ronald_Šiklić	playsFor	FC_Hlučín
Wayne_Gray_(footballer)	playsFor	Wimbledon_F.C.
Catalino_Rivarola	playsFor	Cerro_Porteño
Gaël_Clichy	playsFor	Arsenal_F.C.
Miguel_Ángel_Angulo	playsFor	Villarreal_CF
Roman_Szewczyk	playsFor	Śląsk_Wrocław
Miguel_Lopes	wasBornIn	Lisbon
Brayan_Angulo	playsFor	América_de_Cali
Curtis_Fleming	playsFor	Birmingham_City_F.C.
Ian_Wilson_(footballer_born_1958)	playsFor	Bury_F.C.
José_Dominguez	playsFor	Al_Ahli_SC_(Doha)
Márcio_Nobre	playsFor	Beşiktaş_J.K.
Lee_Jin-ho	playsFor	Sangju_Sangmu_FC
John_Ashbery	influences	Tomaž_Šalamun
Ivan_Kotenko	playsFor	FC_Krymteplytsia_Molodizhne
Kim_Do-keun	playsFor	Gyeongnam_FC
Ndala_Ibrahim	playsFor	Dolphins_F.C._(Port_Harcourt)
Giani_Kiriţă	playsFor	MKE_Ankaragücü
Said_Husejinović	playsFor	GNK_Dinamo_Zagreb
Gustavo_Barros_Schelotto	playsFor	Villarreal_CF
Arnie_Mausser	playsFor	Tampa_Bay_Rowdies_(1975–93)
Carl_Asaba	playsFor	Reading_F.C.
Brian_Deane	playsFor	England_national_football_B_team
Atilla_Birlik	playsFor	SpVgg_Greuther_Fürth
Martin_Hardie	playsFor	Greenock_Morton_F.C.
Sergio_Leal	playsFor	Sporting_Cristal
Jiří_Němec	playsFor	FK_Chmel_Blšany
Andrew_Sinkala	playsFor	FC_Viktoria_Köln
Lars_Müller	playsFor	Alemannia_Aachen
Paul_Carden	playsFor	Burton_Albion_F.C.
Peter_Ollerton	playsFor	APIA_Leichhardt_Tigers_FC
Haile_Selassie_I_of_Ethiopia	hasWonPrize	Order_of_the_Yugoslav_Star
Luke_McShane_(footballer)	playsFor	Hornchurch_F.C.
Graham_Arnold	playsFor	NAC_Breda
Josh_Wright	playsFor	Barnet_F.C.
Carsten_Sträßer	playsFor	Wormatia_Worms
Mario_Basler	playsFor	SV_Werder_Bremen
Michael_Bay	hasWonPrize	Saturn_Award
Jonathan_Lacourt	playsFor	Valenciennes_FC
Zdeněk_Ščasný	playsFor	Dukla_Prague
Guy-Manuel_de_Homem-Christo	playsFor	Real_Madrid_C.F.
Abdelkader_Ghezzal	playsFor	A.C._Siena
Vítor_Moreno	wasBornIn	Lisbon
Jimmy_Mulisa	playsFor	FC_Vostok
Warren_Patmore	playsFor	Cobh_Ramblers_F.C.
Syria	exports	wordnet_clothing_103051540
Aldo_Olcese	playsFor	SC_Eendracht_Aalst
Kevin_Goldthwaite	playsFor	Portland_Timbers_(2001–10)
Louis-Ferdinand_Céline	influences	Irvine_Welsh
Dušan_Pavlović	playsFor	FC_Baden
João_Soares_de_Almeida_Neto	playsFor	Associação_Portuguesa_de_Desportos
Antoine_Kohn	playsFor	Karlsruher_SC
Diego_Gavilán	playsFor	Sport_Club_Internacional
Ângelo_Ricardo_Versari	playsFor	Al_Sadd_SC
Frank_Seator	playsFor	Al_Rayyan_SC
Richard_Bokatola	playsFor	KS_Kastrioti
Frank_Becton	wasBornIn	Preston,_Lancashire
Kanfory_Sylla	playsFor	AS_Kaloum_Star
Eric_Lichaj	playsFor	United_States_men's_national_soccer_team
Milan_Perendija	playsFor	FK_Voždovac
Ugo_Tognazzi	hasWonPrize	David_di_Donatello
Eduardo_Marques	playsFor	APOP_Kinyras_FC
Flemming_Lund	playsFor	Tampa_Bay_Rowdies_(1975–93)
George_Marshall	hasWonPrize	Order_of_the_Bath
Paul_O'Grady_(footballer)	playsFor	Marconi_Stallions_FC
Miha_Kline	playsFor	NK_Domžale
Fernando_Morena	playsFor	Rayo_Vallecano
Godfred_Karikari	playsFor	Shenzhen_Ruby_F.C.
Giorgos_Economides	playsFor	PAEEK
Hervé_Bochud	playsFor	FC_Baden
Jesse_Ventura	playsFor	Bury_F.C.
Wes_Hoolahan	playsFor	Norwich_City_F.C.
Andriy_Novak	playsFor	FC_Spartak_Ivano-Frankivsk
Adam_Wolanin	playsFor	United_States_men's_national_soccer_team
Louis_Nanchoff	playsFor	St._Louis_Steamers_(1979–88)
Federico_Balzaretti	playsFor	A.S._Varese_1910
Pierre_Morice	playsFor	Tampa_Bay_Rowdies_(1975–93)
Brian_Launders	playsFor	Croydon_Kings_FC
Martin_Vingaard	playsFor	Denmark_national_football_team
Eduardo_Tuzzio	playsFor	San_Lorenzo_de_Almagro
Iranildo_Hermínio_Ferreira	playsFor	Clube_de_Regatas_do_Flamengo
Radek_Bejbl	playsFor	Czech_Republic_national_football_team
Leung_Chi_Wing	playsFor	Eastern_AA
John_de_Wolf	playsFor	Wolverhampton_Wanderers_F.C.
Selver_Hodžić	playsFor	FC_Thun
Roy_M._Hopkins	playsFor	Coventry_City_F.C.
Hélder_Muianga	wasBornIn	Maputo
Martin_Thomas_(footballer_born_1959)	playsFor	Birmingham_City_F.C.
Adrian_Littlejohn	playsFor	Oldham_Athletic_A.F.C.
Ignazio_Abate	playsFor	S.S.D._Piacenza_Calcio_1919
Marcin_Bojarski	playsFor	Puszcza_Niepołomice
Lee_Jenkins	playsFor	Carmarthen_Town_A.F.C.
Bogomil_Dyakov	playsFor	PFC_Montana
Alex_McCarthy	playsFor	Reading_F.C.
Giovanni_Bia	playsFor	Udinese_Calcio
Hugo_Henrique_Assis_do_Nascimento	playsFor	Clube_de_Regatas_do_Flamengo
Mark_Bailey_(footballer)	playsFor	Northwich_Victoria_F.C.
Paolo_Guerrero	playsFor	FC_Bayern_Munich
Marcel_Maltritz	playsFor	VfL_Bochum
Łukasz_Załuska	playsFor	Korona_Kielce
Roland_Emmerich	hasWonPrize	European_Film_Awards
Chérif_Touré_Mamam	playsFor	Livingston_F.C.
Ryan_Amoo	playsFor	Lincoln_City_F.C.
Alessandro_Iandoli	wasBornIn	Basel
Daniele_Degano	playsFor	A.C._Rimini_1912
Simon_Travis	playsFor	Stockport_County_F.C.
Carlos_Rivera_(footballer)	playsFor	Independiente_Medellín
José_Marcelo_Ferreira	playsFor	Cruzeiro_Esporte_Clube
Borislav_Georgiev	playsFor	FC_Sachsen_Leipzig
Maksim_Tishchenko	playsFor	FC_Rotor_Volgograd
Sebastian_Schindzielorz	playsFor	Germany_national_football_B_team
Steve_Foster_(footballer_born_1974)	playsFor	Bristol_Rovers_F.C.
Kraikiat_Beadtaku	playsFor	Bangkok_Glass_F.C.
Christian_Alder	playsFor	KFC_Uerdingen_05
Jiří_Lenko	playsFor	SV_Grödig
Rob_Matthaei	playsFor	De_Graafschap
Slobodan_Marković	playsFor	FK_Borac_Čačak
Marek_Čech_(Czech_footballer)	playsFor	FC_Luch-Energiya_Vladivostok
Jeff_Blockley	playsFor	Coventry_City_F.C.
Aurélien_Chedjou	playsFor	Cameroon_national_football_team
Marcus_Pürk	playsFor	SK_Rapid_Wien
Héctor_Rial	playsFor	Olympique_de_Marseille
Peter_Vagenas	wasBornIn	Pasadena,_California
Søren_Kierkegaard	influences	Hermann_Hesse
Aleksandar_Mitreski	playsFor	Macedonia_national_football_team
Neven_Marković	playsFor	PAE_Kerkyra
Pablo_Vitti	playsFor	Argentina_national_under-20_football_team
Johnny_Carey	playsFor	Liverpool_F.C.
Meg_Ryan	isMarriedTo	Anthony_Edwards
Miroslav_Baranek	playsFor	Czech_Republic_national_under-21_football_team
Ian_McCall_(footballer)	playsFor	Happy_Valley_AA
Alin_Minteuan	wasBornIn	Cluj-Napoca
Fabio_Firmani	playsFor	Atletico_Roma_F.C.
Albert_Ferrer	playsFor	Spain_national_under-20_football_team
Guillermo_Daniel_Rodríguez	playsFor	Club_Atlas
Marco_Zanchi	playsFor	Vicenza_Calcio
Julio_Enrique_Martínez	playsFor	A.D._Isidro_Metapán
Jack_Kirby	influences	Alan_Moore
Edmund_Husserl	influences	Martin_Heidegger
Cristian_Portilla	playsFor	CD_Atlético_Baleares
Edinho_Baiano	playsFor	Clube_Atlético_Paranaense
Aristotle	influences	Gottfried_Wilhelm_Leibniz
Marek_Leśniak	playsFor	SG_Wattenscheid_09
Diane_Lane	wasBornIn	New_York_City
Monterey_County,_California	isLocatedIn	Northern_California
Ayres_Cerqueira_Simao	playsFor	Clube_Atlético_Paranaense
Matías_Alonso	playsFor	Defensor_Sporting
Enrique_López_Delgado	playsFor	Real_Valladolid_B
Dennis_Brinkmann	playsFor	Alemannia_Aachen
Marek_Saganowski	playsFor	Poland_national_football_team
Värmland	isLocatedIn	Europe
Rajiv_van_La_Parra	playsFor	Wolverhampton_Wanderers_F.C.
DaMarcus_Beasley	playsFor	United_States_men's_national_soccer_team
Carim_Adippe	playsFor	Deportivo_Marquense
Danny_Potter	playsFor	Exeter_City_F.C.
Jérôme_Leroy_(footballer)	playsFor	FC_Istres
Gladstone_(footballer)	playsFor	Associação_Desportiva_Cabofriense
Mykola_Pavlenko	playsFor	FC_SKVO_Rostov-on-Don
Josh_Gardner_(soccer)	playsFor	Montreal_Impact
Martin_Reeves	playsFor	Hucknall_Town_F.C.
Frank_Becton	playsFor	Liverpool_F.C.
Edson_Minga	playsFor	Hong_Kong_Rangers_FC
Roberto_Bonet	playsFor	Club_Guaraní
Tomasz_Kupisz	playsFor	Wigan_Athletic_F.C.
Danny_Westwood	playsFor	Grays_Athletic_F.C.
Ian_Selley	playsFor	Arsenal_F.C.
Wilko_Risser	playsFor	Aldershot_Town_F.C.
Craig_Burley	playsFor	Celtic_F.C.
Arjan_Sheta	playsFor	Ayia_Napa_F.C.
Cristian_Dănălache	playsFor	Jiangsu_Guoxin-Sainty_F.C.
Ricardo_Mion_Varella_Costa	playsFor	Deportivo_Saprissa
Marcus_Gayle	playsFor	Aldershot_Town_F.C.
Horacio_Troche	playsFor	Uruguay_national_football_team
Waldemar_Ksienzyk	playsFor	SpVgg_Blau-Weiß_1890_Berlin
Marco_Ferrante	playsFor	Inter_Milan
Joan_Cusack	wasBornIn	New_York_City
Jóhannes_Harðarson	playsFor	SC_Veendam
Brent_Goulet	playsFor	A.F.C._Bournemouth
Charles_Amoah	playsFor	FC_Wil_1900
Cidimar	playsFor	Sport_Club_Internacional
Alexandru_Golban	playsFor	FC_Milsami_Orhei
Burt_Bacharach	wasBornIn	Kansas_City,_Missouri
Campbell_Banks	playsFor	Green_Gully_SC
Bertin_Tomou	playsFor	K.S.V._Roeselare
Antoni_Lima_Solá	playsFor	CF_Gavà
Rivaldo	playsFor	Associação_Desportiva_São_Caetano
Eduard_Dubinski	playsFor	SC_Odesa
Heather_Garriock	playsFor	FC_Rosengård
Uwe_Möhrle	playsFor	Germany_national_football_B_team
Gerardo_García_León	playsFor	Villarreal_CF
Carlos_Muñoz_Cobo	playsFor	FC_Barcelona_B
Donovan_Simmonds	playsFor	Kilmarnock_F.C.
François_Félix	playsFor	Paris_FC
Jimmy_Gabriel	playsFor	A.F.C._Bournemouth
Banjul	isLocatedIn	The_Gambia
Álvaro_Gutiérrez_(footballer)	playsFor	Rayo_Vallecano
Peter_Pace	hasWonPrize	Legion_of_Merit
José_Bello_Amigo	playsFor	APIA_Leichhardt_Tigers_FC
Jozef_Karel	playsFor	1._FC_Tatran_Prešov
Damien_Tixier	playsFor	Stade_Beaucairois
Garra_Dembélé	playsFor	FC_Istres
Octavian_Chihaia	wasBornIn	Bucharest
Gennady_Tumilovich	playsFor	FC_Luch-Energiya_Vladivostok
Édouard_Cissé	playsFor	Olympique_de_Marseille
Gavin_Strachan	playsFor	Coventry_City_F.C.
Clodoaldo_Paulino_de_Lima	playsFor	Figueirense_Futebol_Clube
Patrick_Doyle	wroteMusicFor	Harry_Potter_(film_series)
Gbassay_Sessay	playsFor	C.F._Estrela_da_Amadora
Jörg_Schmidt_(footballer)	playsFor	FSV_Zwickau
Ibrahima_Bangoura	playsFor	Troyes_AC
Rick_Titus_(soccer)	playsFor	Montreal_Impact
Ely_Thadeu	playsFor	Red_Star_Belgrade
Scott_Fitzgerald_(footballer_born_1969)	playsFor	Sheffield_United_F.C.
Aaron_Brown_(footballer_born_1983)	playsFor	Reading_F.C.
Willie_Brown_(footballer_born_1950)	playsFor	Barrow_A.F.C.
Oliver_Cuadrado_Martín	playsFor	CD_Guadalajara_(Spain)
Michel_Decastel	playsFor	Servette_FC
Fabio_Daprelà	playsFor	Switzerland_national_under-21_football_team
Vasyl_Rats	playsFor	PFC_Nyva_Vinnytsia
Mickaël_Marsiglia	playsFor	AS_Cannes
David_Johnson_(footballer_born_1976)	playsFor	Bury_F.C.
Percy_Colque	playsFor	Club_Real_Potosí
Gareth_Taylor	playsFor	Sheffield_United_F.C.
Mangualde_(footballer)	playsFor	C.R._Caála
Elnatan_Salami	playsFor	Israel_national_under-18_football_team
James_Newton_Howard	wasBornIn	Los_Angeles
Ayres_Cerqueira_Simao	playsFor	FCM_Bacău
Comoros	isLocatedIn	Indian_Ocean
Iranildo_Hermínio_Ferreira	playsFor	Brasiliense_Futebol_Clube
Volodymyr_Kilikevych	playsFor	FC_Iskra-Stal
Mauro_Navas	playsFor	Racing_Club_de_Avellaneda
Almedin_Civa	playsFor	Füchse_Berlin_Reinickendorf
Chris_Casement	playsFor	Portadown_F.C.
Ruben_Zadkovich	wasBornIn	Sydney
Luciano_Chiarugi	playsFor	A.C._Rimini_1912
Paweł_Kaczmarek	playsFor	Korona_Kielce
Welton_Felipe	playsFor	Clube_Atlético_Mineiro
José_María_Vidal	playsFor	Real_Valladolid
Edinburgh_Rugby	isLocatedIn	Edinburgh
Didier_Tholot	playsFor	FC_Basel
Gerardo_Cortés	playsFor	Colo-Colo
Dick_McCormick	playsFor	Tacoma_Stars_(MISL)
Garry_Shandling	wasBornIn	Chicago
Fernando_Picun	playsFor	Defensor_Sporting
Mark_Lawrenson	playsFor	Liverpool_F.C.
Mile_Krstev	playsFor	SC_Veendam
Martin_Lanig	playsFor	VfB_Stuttgart_II
Dušan_Bajević	wasBornIn	Mostar
Bill_Williams_(footballer_born_1942)	playsFor	West_Bromwich_Albion_F.C.
Zurab_Khizanishvili	playsFor	FC_Lokomotivi_Tbilisi
Pablo_Calandria	playsFor	Argentina_national_under-20_football_team
Buckinghamshire	isLocatedIn	South_East_England
Ian_Lawther	playsFor	Stockport_County_F.C.
Troy_(film)	isLocatedIn	United_Kingdom
César_Carranza	playsFor	Club_Ferro_Carril_Oeste
Keith_Houchen	playsFor	Coventry_City_F.C.
Jonathan_Bolaños	playsFor	L.D._Alajuelense
Slavoj_Žižek	isInterestedIn	Political_philosophy
Oswaldo_Vizcarrondo	playsFor	Caracas_FC
Steve_Mildenhall	playsFor	Swindon_Town_F.C.
Cristiano_Lupatelli	playsFor	ACF_Fiorentina
Marcos_Antônio_dos_Santos	playsFor	U.D._Oliveirense
Andrea_Bernini	playsFor	Reggina_Calcio
Marc_Arnold	playsFor	Karlsruher_SC
Pape_Diakhaté	playsFor	Olympique_Lyonnais
Richard_Garcia_Miranda	playsFor	C.F._Estrela_da_Amadora
Carl_Andrew_Spaatz	hasWonPrize	Order_of_the_Crown_(Belgium)
Wells_Thompson	playsFor	New_England_Revolution
Iulian_Chiriță	playsFor	FC_Argeș_Pitești
Sinthaweechai_Hathairattanakool	playsFor	TTM_Customs_F.C.
Ricardo_Carvalho	playsFor	F.C._Alverca
Francesco_Benussi	playsFor	U.S._Arezzo
Daniel_Lopez_Cruz	playsFor	Pogoń_Szczecin
Dmytro_Hololobov	playsFor	FC_Sevastopol
Oakland,_California	isLocatedIn	Alameda_County,_California
Luigi_Pieroni	playsFor	RC_Lens
Marko_Šuler	wasBornIn	Slovenj_Gradec
Carlos_Roberto_de_Carvalho	playsFor	Bonsucesso_Futebol_Clube
Epicurus	influences	Thomas_Hobbes
Marcin_Nowacki	playsFor	Korona_Kielce
Amir_Azmy	playsFor	Al-Taawon_FC
Răzvan_Țârlea	playsFor	CFR_Cluj
Mladen_Rudonja	playsFor	Slovenia_national_football_team
Flemming_Lund	playsFor	Vancouver_Whitecaps_(1974–84)
Talal_El_Karkouri	playsFor	Aris_F.C._(Thessaloniki)
Alf_Common	playsFor	Preston_North_End_F.C.
Central_African_Republic	hasOfficialLanguage	French_language
Vinny_Samways	playsFor	Birmingham_City_F.C.
Dion_Dublin	wasBornIn	Leicester
Primož_Gliha	playsFor	Chamois_Niortais_F.C.
Michel_Foucault	influences	Edward_Said
Marco_Storari	wasBornIn	Pisa
Atanas_Bornosuzov	playsFor	Aris_Limassol_F.C.
F._Scott_Fitzgerald	created	A_Yank_at_Oxford
Mirel_Rădoi	playsFor	Al_Ain_FC
Demy_de_Zeeuw	playsFor	R.S.C._Anderlecht
Adel_Taarabt	playsFor	Tottenham_Hotspur_F.C.
Andrei_Streltsov	playsFor	FC_Dynamo_Bryansk
Luiz_Carlos_Guedes_Stukas	playsFor	Paykan_F.C.
Frédéric_Danjou	playsFor	AC_Ajaccio
Shaun_Carey	playsFor	Stevenage_F.C.
Adonai_Martínez	playsFor	El_Salvador_national_football_team
Alex_Bruno	playsFor	Clube_Atlético_Mineiro
Rob_Wolleaston	playsFor	Weymouth_F.C.
Joseph_Alcazar	wasBornIn	Oran
Nicolás_Sartori	playsFor	Club_Real_Potosí
Frank_Seator	playsFor	Al-Gharafa_Sports_Club
Georg_Margreitter	playsFor	F.C._Copenhagen
Manuel_Ruz	playsFor	Xerez_CD
Idrissa_Coulibaly	playsFor	JS_Centre_Salif_Keita
Darel_Russell	playsFor	Preston_North_End_F.C.
Tunay_Torun	playsFor	Turkey_national_youth_football_team
Rocky_Siberie	playsFor	Valletta_F.C.
Colin_McGlashan	playsFor	Dundee_F.C.
David_Fernández_Miramontes	playsFor	Kilmarnock_F.C.
Karel_Kula	playsFor	FK_Fotbal_Třinec
Wayne_Allison	playsFor	Swindon_Town_F.C.
Cyrille_Regis	playsFor	Coventry_City_F.C.
Paraskevas_Christou	playsFor	CS_Pandurii_Târgu_Jiu
Abdelmajid_Eddine	playsFor	Dhofar_S.C.S.C.
Hélder_Cristóvão	playsFor	Deportivo_de_La_Coruña
Neil_Murphy	playsFor	Altrincham_F.C.
András_Horváth_(footballer)	playsFor	A.S.D._Gallipoli_Football_1909
Chris_Grossman	playsFor	Moreland_Zebras_FC
Leonardo_Manzi	playsFor	Vila_Nova_Futebol_Clube
Daniel_Gygax	playsFor	FC_Aarau
David_Gutiérrez_de_Coz	playsFor	Real_Murcia
Kelly_Gray	playsFor	LA_Galaxy
John_Oster	playsFor	Barnet_F.C.
Hiraç_Yagan	playsFor	Royale_Union_Saint-Gilloise
Artur_Krysiak	playsFor	York_City_F.C.
Vítor_Valente	playsFor	C.F._Os_Belenenses
Ediz_Bahtiyaroğlu	playsFor	Keçiörengücü
Gunnar_Heiðar_Þorvaldsson	playsFor	Iceland_national_under-19_football_team
Jóhannes_Harðarson	playsFor	MVV_Maastricht
Paulo_Ribeiro	playsFor	S.C._Olhanense
Lluís_Carreras	playsFor	FC_Barcelona_B
James_W._Holsinger	graduatedFrom	Duke_University
Julio_César_Baldivieso	playsFor	Club_Jorge_Wilstermann
Dries_Mertens	playsFor	Belgium_national_under-17_football_team
Marc_Janko	wasBornIn	Vienna
Zlatko_Čajkovski	playsFor	Croatia_national_football_team
Kris_Boyd	playsFor	Kilmarnock_F.C.
Jancarlos_de_Oliveira_Barros	playsFor	Rio_Branco_Atlético_Clube
Alan_Judge_(footballer,_born_1960)	playsFor	Banbury_United_F.C.
Medhi_Lacen	playsFor	Racing_de_Santander
Peter_Daniel_(English_footballer)	wasBornIn	Kingston_upon_Hull
Nigel_Quashie	playsFor	Wolverhampton_Wanderers_F.C.
Mario_Frick_(footballer)	playsFor	U.S._Arezzo
Rauwshan_McKenzie	playsFor	Portland_Timbers
Valeri_Popovitch	playsFor	FC_Lokomotiv_Nizhny_Novgorod
Jakub_Jakubov	playsFor	BFC_Viktoria_1889
Attila_Filkor	playsFor	U.S._Sassuolo_Calcio
Benny_Dargle	playsFor	Seattle_Sounders_(1974–83)
Matías_Urbano	playsFor	Unión_San_Felipe
Mirco_Poloni	playsFor	U.S._Fiorenzuola_1922
Tony_Parks	playsFor	Burnley_F.C.
Joël_Tiéhi	playsFor	Le_Havre_AC
José_Batista_Leite_da_Silva	playsFor	Mogi_Mirim_Esporte_Clube
Schumacher_(footballer)	playsFor	Ascoli_Calcio_1898
Wizz_Air	isLocatedIn	Poznań
Pierre_Issa	playsFor	Ionikos_F.C.
Saudi_detainees_at_Guantanamo_Bay	playsFor	Elche_CF
Ignacio_Carrasco	playsFor	Monarcas_Morelia
O'Brian_White	playsFor	Jamaica_national_football_team
Lassana_Diarra	playsFor	Arsenal_F.C.
Denys_Sokolovskyi	playsFor	FC_Krymteplytsia_Molodizhne
Nuno_Miguel_Prata_Coelho	playsFor	Aris_F.C._(Thessaloniki)
Veseljko_Trivunović	playsFor	FK_Jedinstvo_Ub
César_Carignano	playsFor	Club_América
Dominic_Peitz	playsFor	Karlsruher_SC
Jaílson	playsFor	Marília_Atlético_Clube
Zinho	playsFor	Cruzeiro_Esporte_Clube
Jimmy_Kébé	playsFor	RC_Lens
Rômulo_Marques_Antoneli	playsFor	1._FSV_Mainz_05
Alec_Baldwin	hasWonPrize	Primetime_Emmy_Award
Martin_Grehan	playsFor	Forfar_Athletic_F.C.
Ori_Shitrit	playsFor	Maccabi_Tel_Aviv_F.C.
Matthew_Berkeley	playsFor	Colwyn_Bay_F.C.
Renato_Ramos	playsFor	Lota_Schwager
Maurício_de_Oliveira_Anastácio	playsFor	Sport_Club_Internacional
Luis_Asprilla	playsFor	Cúcuta_Deportivo
Cidimar	playsFor	Sociedade_Esportiva_e_Recreativa_Caxias_do_Sul
Hal_Robson-Kanu	playsFor	Wales_national_under-21_football_team
Ibrahima_Sidibe	playsFor	CS_Sfaxien
Andy_Burgess	playsFor	Chester_F.C.
Jonathan_Estrada	playsFor	Patriotas_F.C.
Sambégou_Bangoura	playsFor	AS_Kaloum_Star
Giovanni_Bartolucci	playsFor	S.E.F._Torres_1903
Howard_Newton	playsFor	Hampton_&_Richmond_Borough_F.C.
Karol_Gregorek	playsFor	Wisła_Płock
Matías_Lequi	playsFor	Celta_de_Vigo
Sonny_Guadarrama	wasBornIn	Austin,_Texas
Akihiro_Ienaga	playsFor	Japan_national_under-23_football_team
Carlos_Bilardo	playsFor	San_Lorenzo_de_Almagro
Kingdom_of_Greece	isLocatedIn	Europe
Alessandro_Parisi	playsFor	U.S._Città_di_Palermo
Leandro_Gracián	playsFor	Querétaro_F.C.
Adrian_Whitbread	playsFor	Swindon_Town_F.C.
Ron_Davies_(footballer_born_1942)	playsFor	Millwall_F.C.
Liam_Henderson_(footballer,_born_1989)	playsFor	Gateshead_F.C.
Scania	isLocatedIn	Europe
Fabrizio_Cacciatore	playsFor	A.S._Varese_1910
John_Gielgud	actedIn	Oh!_What_a_Lovely_War
Daniel_Martín	playsFor	Elche_CF
Ricardo_Villa	playsFor	Atlético_Tucumán
Thomas_Pfannkuch	playsFor	SSV_Reutlingen_05
Luis_Cubilla	playsFor	Defensor_Sporting
Anton_Žlogar	playsFor	Pordenone_Calcio_S.S.D.
Jermaine_Pennant	playsFor	Wolverhampton_Wanderers_F.C.
Daniel_Pendín	wasBornIn	Rosario,_Santa_Fe
Ragnar_Klavan	playsFor	Vålerenga_Fotball
Little_Vietnam	isLocatedIn	France
Aniello_Cutolo	playsFor	U.S._Arezzo
Dejan_Rusmir	playsFor	FC_Farul_Constanța
Ezequiel_Medrán	playsFor	Deportes_La_Serena
Serdar_Kulbilge	playsFor	Gençlerbirliği_S.K.
Wayne_Dyer_(footballer)	playsFor	Hinckley_United_F.C.
Hugo_Carreira	playsFor	AEP_Paphos_F.C.
Willie_Pettigrew	playsFor	Motherwell_F.C.
Peter_Eccles	playsFor	Athlone_Town_A.F.C.
Anastasios_Kyriakos	playsFor	Paniliakos_F.C.
Giorgi_Popkhadze	playsFor	FC_Tbilisi
Karl_Del'Haye	wasBornIn	Aachen
Leopold_Infeld	isCitizenOf	Canada
Reinaldo_José_da_Silva	playsFor	Helsingborgs_IF
Francesco_Galeoto	playsFor	U.S._Città_di_Palermo
Alessandro_Iandoli	playsFor	K.A.S._Eupen
Marco_Capparella	playsFor	A.S._Varese_1910
Adeola_Lanre_Runsewe	playsFor	F.C._Ebedei
Franck_Moussa	playsFor	West_Ham_United_F.C.
Jerzy_Brzęczek	playsFor	FC_Kärnten
Mike_Hill_(film_editor)	edited	EDtv
Tom_Van_Mol	playsFor	FC_Utrecht
Johann_Wolfgang_von_Goethe	influences	Søren_Kierkegaard
Steve_Fulton	playsFor	Kilmarnock_F.C.
Mark_Fish	wasBornIn	Cape_Town
Rolando_Fonseca	playsFor	Independiente_Medellín
Ismaël_Bouzid	playsFor	Kilmarnock_F.C.
Mostafa_Gaafar	playsFor	Egypt_national_football_team
Dejan_Živković_(footballer_born_1979)	playsFor	FK_Voždovac
Alan_Biley	playsFor	Everton_F.C.
Yssouf_Koné	playsFor	Qingdao_Hailifeng_F.C.
Lee_McEvilly	playsFor	Barrow_A.F.C.
Robert_Reilly_(footballer)	playsFor	Kilmarnock_F.C.
Sead_Ramović	playsFor	Sivasspor
Patrick_da_Silva	playsFor	América_Futebol_Clube_(RN)
Mário_Sérgio_Pontes_de_Paiva	playsFor	Grêmio_Foot-Ball_Porto_Alegrense
Jean-Jacques_Eydelie	playsFor	Olympique_de_Marseille
Mukhsin_Mukhamadiev	playsFor	FC_Lokomotiv_Nizhny_Novgorod
Ian_Woan	playsFor	Columbus_Crew
Andrew_Nicholas	playsFor	Barrow_A.F.C.
Čedomir_Janevski	playsFor	K.S.C._Lokeren_Oost-Vlaanderen
Andrej_Hesek	wasBornIn	Bratislava
Carlos_Gamarra	playsFor	Cerro_Porteño
Fabian_Johnson	playsFor	TSG_1899_Hoffenheim
Ezequiel_González	wasBornIn	Rosario,_Santa_Fe
Jimmy_Modeste	playsFor	AEP_Paphos_F.C.
Tom_Shaw_(footballer)	playsFor	Kidderminster_Harriers_F.C.
Stuart_Elliott_(footballer,_born_1977)	playsFor	Gateshead_F.C.
Paulo_Jorge_Sousa_Gomes	playsFor	S.C._Braga
Giovanni_Pérez_Rodríguez	playsFor	SKN_St._Pölten
Charles_VI,_Holy_Roman_Emperor	wasBornIn	Vienna
Daniel_Alberto	playsFor	RC_Lens
Ivan_Čvorović	playsFor	PFC_Naftex_Burgas
Chinedu_Ede	playsFor	1._FSV_Mainz_05
William_Machado_de_Oliveira	playsFor	Associação_Portuguesa_de_Desportos
Djalmir_Vieira_Andrade	playsFor	S.C._Olhanense
Michael_Jordan_(footballer)	playsFor	Farnborough_F.C.
Bryan_Bergougnoux	playsFor	France_national_under-21_football_team
César_Prates	playsFor	Figueirense_Futebol_Clube
Aluísio_da_Silva_Neves_Júnior	playsFor	Tombense_Futebol_Clube
Travis_Mulraine	playsFor	Joe_Public_F.C.
Diogo_Pires	playsFor	Guarani_Esporte_Clube_(MG)
Zé_Antônio	playsFor	Associação_Portuguesa_de_Desportos
Oribe_Peralta	playsFor	Club_América
Bebeto	playsFor	Esporte_Clube_Vitória
Andy_Sandell	playsFor	Bristol_Rovers_F.C.
Aron_Winter	playsFor	S.S._Lazio
John_Ruddy	playsFor	Norwich_City_F.C.
Dario_Zahora	playsFor	GNK_Dinamo_Zagreb
Chris_O'Grady	playsFor	Stockport_County_F.C.
António_Pedro_de_Brito_Lopes	playsFor	Servette_FC
Wisarut_Pannasri	playsFor	Muangthong_United_F.C.
Peter_Eccles	playsFor	Stafford_Rangers_F.C.
Ronnie_Whelan	playsFor	League_of_Ireland_XI
Marko_Kolsi	playsFor	NK_Celje
Paul_Telfer_(footballer)	playsFor	Scotland_national_under-21_football_team
Northern_Norway	isLocatedIn	Tromsø
Jeff_Hopkins	playsFor	Wales_national_football_team
Edgardo_Simovic	playsFor	Grêmio_Esportivo_Glória
Bosco_Frontán	playsFor	Querétaro_F.C.
Michael_Coulson_(footballer)	playsFor	Northwich_Victoria_F.C.
Gabriel_Cedrés	playsFor	Uruguay_national_football_team
Demi_Moore	actedIn	Deconstructing_Harry
Stefan_Nikolić	playsFor	K.S.V._Roeselare
Hristijan_Kirovski	playsFor	FK_Rabotnički
Juninho_Petrolina	playsFor	C.F._Os_Belenenses
Shelley_Winters	actedIn	The_Delta_Force
André_Correia	wasBornIn	Porto
Conor_Downey	playsFor	Carrick_Rangers_F.C.
Aleksey_Skvernyuk	playsFor	FC_Ufa
Marek_Koźmiński	wasBornIn	Kraków
Tayfun_Seven	playsFor	Fenerbahçe_S.K._A2
Dirk_Bremser	playsFor	SC_Preußen_Münster
Vidak_Bratić	playsFor	FK_Spartak_Zlatibor_Voda
Dharmendra	hasWonPrize	Padma_Bhushan
Guillermo_La_Rosa	playsFor	Atlético_Nacional
Terry_Cochrane	playsFor	Burnley_F.C.
Mark_Walters	playsFor	Swindon_Town_F.C.
Vietnam	isLocatedIn	Asia
Ismael_Espiga	playsFor	C.A._Bella_Vista
Doug_Wark	playsFor	Hartwick_College
Iván_Zarandona	playsFor	Happy_Valley_AA
Cédric_Mouret	playsFor	FC_Istres
Paul_Ritchie_(footballer_born_1975)	playsFor	AC_Omonia
Evgeni_Yordanov_(footballer)	playsFor	PFC_Beroe_Stara_Zagora
Hassan_Shirmohammadi	playsFor	PAS_Tehran_F.C.
Michael_Görlitz	playsFor	FSV_Frankfurt
Zurab_Menteshashvili	playsFor	FK_Ventspils
Miodrag_Anđelković	playsFor	Valletta_F.C.
Walter_Matthau	hasWonPrize	David_di_Donatello
Martin_Dimov	wasBornIn	Varna
Chloë_Sevigny	wasBornIn	Springfield,_Massachusetts
Marco_Tulio	playsFor	Albirex_Niigata
Gordon_Armstrong	playsFor	Northampton_Town_F.C.
Petr_Voříšek	playsFor	SK_Rapid_Wien
Emrah_Eren	playsFor	Trabzonspor
Kevin_Oris	playsFor	Daejeon_Citizen_FC
Jonathan_McKain	playsFor	Al_Nassr_FC
Heremaia_Ngata	playsFor	Moreland_Zebras_FC
Alen_Stevanović	playsFor	Serbia_national_under-19_football_team
Boulogne-Billancourt	isLocatedIn	France
Gil_Servaes	playsFor	RWDM_Brussels_FC
Luigi_Martinelli	playsFor	Trapani_Calcio
David_Banks_(soccer)	playsFor	St._Louis_Ambush_(NPSL)
Willie_Young_(footballer_born_1951)	playsFor	Scotland_national_under-21_football_team
Dumitru_Mitu	playsFor	Changchun_Yatai_F.C.
Patrick_Collins_(footballer)	playsFor	Swindon_Town_F.C.
Wang_Dalei	playsFor	China_national_under-23_football_team
Frank_Buckley_(footballer)	playsFor	England_national_football_team
Luke_Freeman	playsFor	Stevenage_F.C.
Roberto_Cartes	playsFor	Albinegros_de_Orizaba
Tam_Nsaliwa	playsFor	Canada_men's_national_soccer_team
Sunar_Sulaiman	playsFor	Persela_Lamongan
Gláucio_de_Jesus_Carvalho	playsFor	Clube_de_Regatas_do_Flamengo
Antonis_Makris	playsFor	Doxa_Katokopias_F.C.
Renedy_Singh	playsFor	East_Bengal_F.C.
Ozéia_de_Paula_Maciel	playsFor	Sociedade_Esportiva_do_Gama
Lance_Cronin	playsFor	Crystal_Palace_F.C.
Simon_Walton	playsFor	England_national_under-19_football_team
Pedro_Mingote	playsFor	A.D._Ovarense
Alexander_Haig	hasWonPrize	Combat_Infantryman_Badge
John_Barnes_(footballer)	playsFor	Celtic_F.C.
James_Jennings	playsFor	Altrincham_F.C.
Éric_Roy	playsFor	Olympique_de_Marseille
Franco_Brienza	playsFor	U.S._Città_di_Palermo
Vyacheslav_Shevchuk	playsFor	FC_Volyn_Lutsk
Adam_Straith	playsFor	FC_Energie_Cottbus
David_Vidal	playsFor	Deportivo_de_La_Coruña
Gerhard_Kleppinger	playsFor	Karlsruher_SC
Ryan_Harding	playsFor	Livingston_F.C.
Santos_Amador	playsFor	Club_Jorge_Wilstermann
John_Burridge	playsFor	Manchester_City_F.C.
Stig_Inge_Bjørnebye	playsFor	Rosenborg_BK
Grzegorz_Mielcarski	playsFor	Poland_national_football_team
Waldemar_Ksienzyk	playsFor	SV_Babelsberg_03
Súni_Olsen	playsFor	AaB_Fodbold
Anatoli_Ponomarev	wasBornIn	Baku
Kevin_O'Flanagan	playsFor	Corinthian-Casuals_F.C.
Peter_van_Vossen	playsFor	Feyenoord
Boris_Groys	wasBornIn	Berlin
Johan_Vonlanthen	playsFor	FC_Schaffhausen
Hamdan_Al-Bishi	playsFor	Alemannia_Aachen
Bréiner_Castillo	playsFor	Atlético_Nacional
Fabrice_Begeorgi	playsFor	TuS_Koblenz
René_Descartes	influences	Émile_Durkheim
Mickaël_Madar	playsFor	AS_Cannes
Alexander_Huber_(footballer)	playsFor	Germany_national_football_B_team
Edmund_Husserl	influences	Paul_Ricœur
Grenoble_Foot_38	isLocatedIn	France
Federico_Balzaretti	playsFor	Italy_national_under-20_football_team
Daniel_Akhtyamov	playsFor	FC_Vityaz_Podolsk
Ricardo_Ribeiro_Fernandes	playsFor	S.C._Freamunde
Billy_Thompson_(soccer)	playsFor	Columbus_Crew
Michael_Robinson_(footballer)	playsFor	Preston_North_End_F.C.
Luís_Boa_Morte	playsFor	Sporting_Clube_de_Portugal
Mario_Erb	playsFor	SpVgg_Unterhaching
Tommy_Breen	wasBornIn	Drogheda
Josef_Laštovka	playsFor	SK_Dynamo_České_Budějovice
Branko_Bošković	playsFor	SK_Rapid_Wien
Paul_Cook_(footballer)	playsFor	Stockport_County_F.C.
Hadis_Zubanović	playsFor	Kardemir_D._Ç._Karabükspor
Abdul_Kader_Keïta	playsFor	Étoile_du_Sahel
Ruud_Geels	playsFor	R.S.C._Anderlecht
Ted_Eck	playsFor	Colorado_Foxes
Michael_Mason_(soccer)	playsFor	SV_Elversberg
Jim_Herriot	playsFor	Scottish_Football_League_XI
Nicolas_Cinalli	playsFor	A.S._Varese_1910
Laurence_Sterne	influences	Samuel_Beckett
DaMarcus_Beasley	playsFor	Hannover_96
Ronaldo_Tres	playsFor	Clube_Atlético_Paranaense
Adam_Buckley	playsFor	Lincoln_City_F.C.
Carlos_Chacana	playsFor	Hapoel_Kfar_Saba_F.C.
Dalian_Atkinson	playsFor	Manchester_City_F.C.
Paul_de_Lange	playsFor	Veria_F.C.
Alan_Brazil	wasBornIn	Glasgow
Andrea_Cossu_(footballer_born_1984)	playsFor	Foligno_Calcio
Juan_Guillermo_Castillo	playsFor	Querétaro_F.C.
Aleksandr_Chertoganov	playsFor	MFC_Mykolaiv
Stuart_Barlow	playsFor	Stockport_County_F.C.
Alípio	playsFor	América_Futebol_Clube_(RN)
Diego_Ribas_da_Cunha	playsFor	SV_Werder_Bremen
Lúcio	playsFor	Inter_Milan
Mike_Barry_(footballer)	wasBornIn	Kingston_upon_Hull
Owen_Story	playsFor	Rushden_&_Diamonds_F.C.
Adel_Chedli	playsFor	Étoile_du_Sahel
Chris_Powell	playsFor	Crystal_Palace_F.C.
Mario_Videla	playsFor	FBC_Melgar
Ciprian_Tătărușanu	playsFor	ACF_Fiorentina
Jonathan_Obika	playsFor	Millwall_F.C.
Ahmet_Görkem_Görk	playsFor	Sivasspor
Rhys_Wilmot	playsFor	Arsenal_F.C.
Fadel_Brahami	playsFor	Le_Havre_AC
Ben_Bowditch	playsFor	England_national_under-19_football_team
Charlie_MacDonald	playsFor	Margate_F.C.
Kaid_Mohamed	playsFor	Bristol_Rovers_F.C.
Bruce_Rioch	playsFor	Birmingham_City_F.C.
William_Sunsing	playsFor	Deportivo_Saprissa
Júlio_Sérgio	playsFor	Comercial_Futebol_Clube_(Ribeirão_Preto)
Adrian_Neaga	wasBornIn	Pitești
Miguel_Mora_Morales	playsFor	Rio_Ave_F.C.
Uherské_Hradiště	isLocatedIn	Czech_Republic
Özden_Öngün	playsFor	Denizlispor
Ray_Wallace_(footballer)	playsFor	Drogheda_United_F.C.
Peter_dos_Santos_Barbosa_Júnior	playsFor	Figueirense_Futebol_Clube
Mirko_Oremuš	playsFor	NK_Novalja
Marcos_Antônio_dos_Santos	playsFor	Bonsucesso_Futebol_Clube
Gustavo_Biscayzacú	playsFor	Club_Atlético_River_Plate_(Montevideo)
Adam_Birchall	playsFor	Wales_national_under-21_football_team
Ben_Burgess	playsFor	Stockport_County_F.C.
Erhan_Albayrak	playsFor	KFC_Uerdingen_05
Dave_Gilroy	playsFor	Bristol_Rovers_F.C.
Morten_Pedersen	playsFor	Vålerenga_Fotball
Stefan_Moore	playsFor	Millwall_F.C.
Jon_Newby	wasBornIn	Warrington
Genc_Iseni	playsFor	FK_Rabotnički
Johnny_Carson	hasWonPrize	Peabody_Award
Roscoe_D'Sane	playsFor	Wealdstone_F.C.
Daniel_Nardiello	playsFor	Exeter_City_F.C.
Paul_Tosh	playsFor	Exeter_City_F.C.
Raïs_M'Bolhi	playsFor	PFC_CSKA_Sofia
David_James_(footballer)	playsFor	West_Ham_United_F.C.
Carl_Cort	playsFor	Guyana_national_football_team
Grzegorz_Lewandowski	playsFor	Adelaide_City_FC
Martín_Romagnoli	playsFor	Club_Atlético_Colón
Benjamin_Weigelt	playsFor	FC_St._Pauli
Adelio_Moro	playsFor	Ascoli_Calcio_1898
Mirano_Carrilho	playsFor	AGOVV_Apeldoorn
Miguel_Mea_Vitali	playsFor	Caracas_FC
George_Travers	playsFor	Tottenham_Hotspur_F.C.
Kevin_Schindler	playsFor	SV_Werder_Bremen
Dejan_Stamenković	wasBornIn	Belgrade
Daniel_Xhafa	playsFor	KF_Bylis_Ballsh
Lee_Molyneaux	playsFor	Clevedon_Town_F.C.
Eduardo_Tuzzio	playsFor	Club_Ferro_Carril_Oeste
Ethel_Merman	actedIn	Journey_Back_to_Oz
Christian_Terlizzi	playsFor	A.S._Varese_1910
Adel_Chedli	playsFor	FC_Sochaux-Montbéliard
Kevin_Johnson_(footballer)	playsFor	Workington_A.F.C.
Ko_Ki-gu	playsFor	South_Korea_national_football_team
Andrei_Stepanov_(footballer)	playsFor	FC_Flora_Tallinn
Kristin_Scott_Thomas	actedIn	Gosford_Park
Élvis_Alves_Pereira	playsFor	Associação_Portuguesa_de_Desportos
Gabriel_Rodrigues_dos_Santos	playsFor	Grêmio_Foot-Ball_Porto_Alegrense
Zanzan_Atte-Oudeyi	playsFor	Togo_national_football_team
John_McGinlay	wasBornIn	Inverness
Atanas_Chipilov	playsFor	FC_Dynamo_Kyiv
Andrej_Panadić	playsFor	KFC_Uerdingen_05
Paulo_Assunção	playsFor	F.C._Porto
Lluís_Carreras	playsFor	Real_Oviedo
Asa_Charlton	playsFor	Telford_United_F.C.
Lee_Harper	playsFor	Arsenal_F.C.
Mikael_Yourassowsky	playsFor	HNK_Rijeka
Volkan_Kahraman	playsFor	S.B.V._Excelsior
Steve_Snow	playsFor	Chicago_Power
Godfrey_Ingram	playsFor	Cardiff_City_F.C.
Mitchell_Cole	playsFor	West_Ham_United_F.C.
Tony_Evans_(footballer_born_1954)	playsFor	Swindon_Town_F.C.
Emmanuel_Osei_Kuffour	playsFor	Asante_Kotoko_SC
Alec_Guinness	hasWonPrize	Saturn_Award
Dino_Seremet	playsFor	PAE_Kerkyra
Leonardo_José_Aparecido_Moura	playsFor	Avaí_Futebol_Clube
Steve_Bowey	playsFor	York_City_F.C.
Chedric_Seedorf	playsFor	Real_Madrid_C.F.
Vítězslav_Mooc	playsFor	FC_Vítkovice
Hugh_Morris_(footballer)	playsFor	Sheffield_United_F.C.
Michael_Gurski	playsFor	SpVgg_Unterhaching
Nodar_Mammadov	playsFor	Sumgayit_FK
Glen_Downey	playsFor	Gateshead_F.C.
Alberto_Costa_(footballer)	playsFor	Argentina_national_football_team
Carl_Schmitt	influences	Slavoj_Žižek
Eddie_Byrne_(footballer)	playsFor	Philadelphia_Fury
Radostin_Stanev	playsFor	Aris_Limassol_F.C.
Rômulo_Noronha	wasBornIn	Caxias_do_Sul
Syarhey_Vyeramko	playsFor	FC_Sevastopol
Dennis_Viollet	playsFor	Baltimore_Bays
Byron_Bubb	playsFor	Millwall_F.C.
Eddy_Lord_Dombraye	playsFor	FC_Volyn_Lutsk
Atdhe_Nuhiu	playsFor	Austria_national_under-19_football_team
Sosthene_Yao	playsFor	Brentwood_Town_F.C.
Harry_Potter_(film_series)	isLocatedIn	United_Kingdom
Drewe_Broughton	playsFor	Lincoln_City_F.C.
Arkadiusz_Radomski	playsFor	Poland_national_football_team
Billy_Jones_(footballer,_born_1987)	playsFor	Crewe_Alexandra_F.C.
Ernesto_Terra	playsFor	U.S._Arezzo
Krisztián_Csillag	playsFor	MTK_Budapest_FC
Mike_Havenaar	playsFor	Yokohama_F._Marinos
Douglas_MacArthur	hasWonPrize	Order_of_the_White_Eagle_(Serbia)
Roberto_Cabañas	playsFor	Independiente_Medellín
Carl_Serrant	playsFor	Sheffield_United_F.C.
Alan_Merrick	playsFor	San_Jose_Earthquakes
Sérgio_Manoel	playsFor	Cruzeiro_Esporte_Clube
Baltazar_Maria_de_Morais_Júnior	playsFor	Clube_de_Regatas_do_Flamengo
Rodion_Malinovsky	hasWonPrize	Order_of_the_Red_Banner
Eduardo_Souza_Reis	playsFor	Boa_Esporte_Clube
José_Luís_Santos_da_Visitação	playsFor	Clube_Atlético_Mineiro
Volkmar_Groß	wasBornIn	Berlin
Marcos_Charras	wasBornIn	Rosario,_Santa_Fe
Vojo_Ubiparip	playsFor	FK_Borac_Čačak
Richard_Roelofsen	playsFor	MVV_Maastricht
Ndala_Ibrahim	playsFor	Wikki_Tourists_F.C.
Māris_Verpakovskis	playsFor	Celta_de_Vigo
Adam_Legzdins	playsFor	Halifax_Town_A.F.C.
Dušan_Savić_(footballer_born_1985)	playsFor	FK_Pobeda
Paul_Mariner	playsFor	England_national_football_team
Josef_Kaufman	playsFor	Czech_Republic_national_under-21_football_team
Marcus_Piossek	playsFor	Germany_national_youth_football_team
Carim_Adippe	playsFor	Neuchâtel_Xamax
John_Powell	wroteMusicFor	Kung_Fu_Panda
Alex_McCarthy	playsFor	Aldershot_Town_F.C.
Dmitriy_Lyapkin	playsFor	FC_Khimki
Jermaine_Beckford	playsFor	Everton_F.C.
Ettore_Mendicino	playsFor	F.C._Crotone
Steve_Pittman	playsFor	Dundee_F.C.
John_McGinlay	playsFor	Bury_F.C.
Scott_Laird	playsFor	Tiverton_Town_F.C.
Sandro_Wagner	wasBornIn	Munich
Ola_Tidman	playsFor	Stockport_County_F.C.
Mike_Gosselin	playsFor	Dayton_Dynamo
David_Campbell_(footballer)	playsFor	Wigan_Athletic_F.C.
Sammy_Smyth	playsFor	Liverpool_F.C.
Darren_Carter	playsFor	West_Bromwich_Albion_F.C.
Konstantin_Nahk	playsFor	FC_Jokerit
Hugo_Henrique_Assis_do_Nascimento	playsFor	Esporte_Clube_Juventude
Bakhtiyor_Ashurmatov	playsFor	FC_Dustlik
Fabio_Nigro	playsFor	S.S._Lazio
Ferenc_Horváth	playsFor	FC_Energie_Cottbus
Romain_Sartre	playsFor	Stade_Lavallois
Lee_Elam	playsFor	Harrogate_Town_F.C.
Bo_Oshoniyi	wasBornIn	Boston
Carlos_Alfaro_Moreno	playsFor	Club_Atlético_Platense
Joílson_Rodrigues_da_Silva	playsFor	Grêmio_Esportivo_Brasil
Peter_Withe	playsFor	Birmingham_City_F.C.
Martín_Ligüera	playsFor	Alianza_Lima
James_Constable	playsFor	Eastleigh_F.C.
Giulio_Andreotti	hasChild	Giuliano_Amato
Colin_Murdock_(footballer)	playsFor	Northern_Ireland_national_football_B_team
Jamie_McMaster	playsFor	APIA_Leichhardt_Tigers_FC
Darío_Franco	playsFor	Club_Atlas
Chérif_Touré_Mamam	playsFor	Hannover_96
Rob_Quinn	playsFor	Crystal_Palace_F.C.
Les_Sealey	playsFor	Coventry_City_F.C.
Zlatko_Junuzović	playsFor	Austria_national_under-19_football_team
David_Silva_(Cape_Verdean_footballer)	playsFor	PFC_CSKA_Sofia
Gheorghe_Boghiu	playsFor	FC_Chita
Kim_Do-keun	playsFor	South_Korea_national_under-23_football_team
Enco_Malindi	playsFor	KS_Kastrioti
Youl_Mawéné	playsFor	Preston_North_End_F.C.
Mahamadou_Sidibé	playsFor	Egaleo_F.C.
Angelo_Martha	wasBornIn	Amsterdam
Jacky_Cheung	hasWonPrize	World_Music_Awards
Gabriele_Paoletti	playsFor	Udinese_Calcio
Edmar_Bernardes	playsFor	Clube_Atlético_Mineiro
Patrick_Apataki	playsFor	K.S.C._Lokeren_Oost-Vlaanderen
Bernabé_Ballester	playsFor	Real_Madrid_C.F.
Rafael_Tesser	playsFor	Clube_Atlético_Mineiro
Bernardo_Tengarrinha	playsFor	S.C._Freamunde
Gelson_Fernandes	playsFor	Switzerland_national_football_team
Walt_Disney	created	The_Walt_Disney_Company
Ariza_Makukula	playsFor	UD_Salamanca
Marcus_Richardson	playsFor	Farnborough_F.C.
Ioan_Sabău	playsFor	Feyenoord
Precious_Emuejeraye	playsFor	Sriwijaya_F.C.
Mahamadou_Dissa	playsFor	Chamois_Niortais_F.C.
Márcio_José_Lisboa_Fortes_Filho	playsFor	Duque_de_Caxias_Futebol_Clube
Harold_Hardman	playsFor	England_national_football_team
Karel_Kula	playsFor	Czechoslovakia_national_football_team
Abdoulaye_Méïté	playsFor	Olympique_de_Marseille
Edgar_Villamarín	playsFor	Cienciano
Minja_Popović	playsFor	FK_Jedinstvo_Ub
Melvin_Holwijn	wasBornIn	Amsterdam
Joan_of_Valois,_Queen_of_Navarre	playsFor	Halifax_Town_A.F.C.
Stewart_Mell	playsFor	Boston_United_F.C.
Andrea_Caracciolo	playsFor	U.S._Città_di_Palermo
Michael_Symes	playsFor	Stockport_County_F.C.
Aleksei_Kozlov_(footballer)	playsFor	FC_Khimki
Victor_Comleonoc	playsFor	FC_Iskra-Stal
Jake_Cole	playsFor	AFC_Wimbledon
Lluís_Carreras	playsFor	Real_Murcia
Mladen_Kašćelan	playsFor	Karlsruher_SC
Dušan_Tittel	playsFor	Nîmes_Olympique
Gintaras_Staučė	playsFor	FK_Daugava_(2003)
Walter_Mazzarri	playsFor	ACF_Fiorentina
Juan_Ramón_Curbelo	playsFor	Danubio_F.C.
Flávio_Cerqueira	playsFor	S.C._Salgueiros
James_McEwen	playsFor	Bury_F.C.
Ralph_Milne	playsFor	West_Ham_United_F.C.
Abdelaziz_Ben_Tifour	playsFor	Espérance_de_Tunis
Gerry_Ingram	playsFor	Preston_North_End_F.C.
Orkun_Uşak	playsFor	Mersin_İdmanyurdu_SK
Evandro_Goebel	playsFor	Clube_Atlético_Paranaense
Khaldoun_Ibrahim	playsFor	Naft_Tehran_F.C.
Gerhard_Tremmel	playsFor	FC_Energie_Cottbus
Richard_Socrier	playsFor	FC_Bourg-Péronnas
Mike_Petersen	playsFor	Australia_national_association_football_team
Ion_Erice_Domínguez	playsFor	SD_Huesca
Oleg_Yashchuk	playsFor	Ukraine_national_under-21_football_team
Kris_Trajanovski	playsFor	Australia_national_association_football_team
Donald_Cock	playsFor	Newport_County_A.F.C.
Friedrich_Engels	influences	Guy_Debord
Rodrigo_Meléndez	playsFor	Cobreloa
Francis_Severeyns	playsFor	Royal_Antwerp_F.C.
Paul_Keegan_(footballer_born_1972)	playsFor	Dumbarton_F.C.
Pierrick_Cros	playsFor	Toulouse_Fontaines_Club
Jamie_Pollock	playsFor	Birmingham_City_F.C.
Chinedu_Ede	playsFor	Berliner_AK_07
Kurniawan_Dwi_Yulianto	playsFor	Persela_Lamongan
Marcus_Richardson	playsFor	Lincoln_City_F.C.
Hugo_Alcântara	playsFor	C.F._Os_Belenenses
Francisco_Valdés	playsFor	Cobreloa
Zvonko_Monsider	playsFor	S.S._Lazio
Wolfgang_Sühnholz	playsFor	FC_Bayern_Munich
Chakhir_Belghazouani	playsFor	Grenoble_Foot_38
Ifeanyi_Udeze	playsFor	Bendel_Insurance_F.C.
Abdul-Wahab_Abu_Al-Hail	playsFor	Foolad_F.C.
Maksim_Shatskikh	playsFor	FC_SOYUZ-Gazprom_Izhevsk
Eric_Brunner	playsFor	Maryland_Terrapins_men's_soccer
Hatem_Ben_Arfa	playsFor	France_national_under-18_football_team
Vesko_Mihajlović	playsFor	FK_Proleter_Zrenjanin
Zvonko_Monsider	playsFor	GNK_Dinamo_Zagreb
Black_Sea	isLocatedIn	Odessa
Joe_Harper_(footballer)	playsFor	Everton_F.C.
Paul_Wimbleton	playsFor	Virginia_Beach_Mariners
Rubén_Iván_Martínez	playsFor	FC_Barcelona_C
Jorge_Bava	playsFor	Juventud_de_Las_Piedras
Thomas_Hinum	playsFor	FC_Kärnten
Dušan_Tittel	playsFor	Czechoslovakia_national_football_team
Wojciech_Szczęsny	playsFor	Poland_national_football_team
Sébastien_Maté	playsFor	Olympique_de_Marseille
Jason_Beckford	playsFor	Bury_F.C.
Jimmy_Quinn_(Northern_Ireland_footballer)	playsFor	A.F.C._Bournemouth
Brendan_Markey	playsFor	Millwall_F.C.
Johnny_McGuire	playsFor	Todd_Shipyards_(soccer_team)
Vladimir_Akhalaia	playsFor	FC_Olimpia_Bălți
Kheireddine_Zarabi	playsFor	C.F._União
Samuel_Firmino_de_Jesus	playsFor	Comercial_Futebol_Clube_(Ribeirão_Preto)
Dariusz_Kubicki	playsFor	Poland_national_football_team
Hussain_Ali_Baba	playsFor	El_Jaish_SC
Gabriel_Álvez	playsFor	C.A._Bella_Vista
Adam_Frye	playsFor	Tampa_Bay_Mutiny
Yordan_Todorov_(footballer_born_July_1981)	playsFor	PFC_CSKA_Sofia
Steve_Evans_(footballer,_born_1962)	wasBornIn	Glasgow
Evan_Horwood	playsFor	York_City_F.C.
Conor_Clifford	playsFor	Republic_of_Ireland_national_under-21_football_team
Carlo_Zotti	playsFor	U.C._Sampdoria
Arthur_Moses	playsFor	Nîmes_Olympique
Lawrie_Leslie	playsFor	Airdrieonians_F.C._(1878)
Mikhael_Jaimez-Ruiz	playsFor	CFR_Cluj
Éldis_Fernando_Damasio	playsFor	Figueirense_Futebol_Clube
José_Luís_Santos_da_Visitação	playsFor	Mogi_Mirim_Esporte_Clube
Miloš_Bursać	playsFor	Celta_de_Vigo
Francisco_Manuel_Durán	playsFor	Elche_CF
Jason_Oost	playsFor	Lommel_United
Jairo_Luis_Blumer	wasBornIn	Campinas
Steve_Horvat	playsFor	HNK_Hajduk_Split
Dragan_Perišić	playsFor	FC_Metalurh_Zaporizhya
Emile_Heskey	playsFor	Birmingham_City_F.C.
Stuart_Storer	playsFor	Exeter_City_F.C.
Francisco_Valmerino_Neri	playsFor	FC_Aarau
Carlton_Cole	playsFor	Wolverhampton_Wanderers_F.C.
Geofrey_Massa	playsFor	Al-Masry_SC
Jacek_Ziober	playsFor	Tampa_Bay_Mutiny
David_Byrne_(footballer,_born_1960)	playsFor	Baltimore_Blast_(1980–92)
Robert_E._Sherwood	hasWonPrize	Pulitzer_Prize_for_Drama
Ricardo_Quaresma	playsFor	Portugal_national_under-19_football_team
David_Cobeño	playsFor	Real_Madrid_C.F.
Roman_Mählich	playsFor	Wiener_Sport-Club
Jorge_Alberto_Rojas	playsFor	Atlético_Nacional
Martín_Barlocco	playsFor	Uruguay_national_football_team
Jamie_Speare	playsFor	Everton_F.C.
Bruno_Aguiar	playsFor	AC_Omonia
Arkadiusz_Kubik	wasBornIn	Kraków
George_Mbwando	playsFor	SSV_Jahn_Regensburg
Rob_Wolleaston	playsFor	Farnborough_F.C.
Ewerthon	playsFor	Al_Ahli_SC_(Doha)
Quincy_Owusu-Abeyie	playsFor	Birmingham_City_F.C.
Beniamino_Abate	playsFor	A.C._Prato
Ahn_Jung-hwan	playsFor	Ajou_University
Luis_Rodas	playsFor	Honduras_national_football_team
Richard_Garcia_Miranda	playsFor	Varzim_S.C.
Reinaldo_José_da_Silva	playsFor	Paysandu_Sport_Club
Chris_Blackburn	playsFor	Northwich_Victoria_F.C.
Emanuel_Centurión	wasBornIn	Lomas_de_Zamora
Henrique_Sereno	playsFor	F.C._Porto
Giorgi_Chelidze	playsFor	FC_Tbilisi
Pat_Morrissey	playsFor	Coventry_City_F.C.
William_Henry_Bragg	worksAt	University_College_London
Joe_Ledley	playsFor	Cardiff_City_F.C.
Marco_Carparelli	playsFor	A.C._Siena
Marcus_Pedersen	playsFor	HamKam
Akeem_Omolade	playsFor	S.S._Barletta_Calcio
Ney_Fabiano	playsFor	Sport_Club_Internacional
Laurent_Fabius	hasChild	Jacques_Chirac
Fabio_Firmani	playsFor	Guizhou_Renhe_F.C.
Mario_Martínez_(footballer)	playsFor	Vålerenga_Fotball
Henry_White_(footballer)	playsFor	Stafford_Rangers_F.C.
Guildford	isLocatedIn	South_East_England
Tommy_McConville	playsFor	Waterford_United_F.C.
Farid_Guliyev	playsFor	Baku_FC
Dimitrios_Grammozis	playsFor	PAE_Kerkyra
Iván_Furios	playsFor	Alianza_Lima
Campinas	isLocatedIn	São_Paulo_(state)
Phil_Smith_(footballer_born_1979)	playsFor	Swindon_Town_F.C.
Damian_Mori	playsFor	Australia_national_association_football_team
Jimmy_Smith_(footballer_born_1902)	playsFor	Tunbridge_Wells_F.C.
Brendan_Ormsby	playsFor	Waterford_United_F.C.
Mostafa_Gaafar	playsFor	Al-Masry_SC
Jamie_McMaster	playsFor	Coventry_City_F.C.
Georgios_Gougoulias	playsFor	SSV_Reutlingen_05
Ian_Lawther	playsFor	Crusaders_F.C.
Alexandru_Tudose	playsFor	FC_Steaua_II_București
Adam_Virgo	playsFor	Bristol_Rovers_F.C.
Obaidullah_Karimi	playsFor	Altonaer_FC_von_1893
Leonard_Bisaku	playsFor	HNK_Rijeka
Eddie_Malone	wasBornIn	Edinburgh
Anthony_Grant_(footballer)	playsFor	Stevenage_F.C.
Colin_Larkin_(footballer)	playsFor	Kidderminster_Harriers_F.C.
Josh_Wright	playsFor	Dumbarton_F.C.
Diego_Cochas	playsFor	Deportivo_Pereira
Mihăiță_Pleșan	playsFor	FC_Steaua_II_București
Sulley_Muntari	playsFor	Udinese_Calcio
Václav_Havel	hasWonPrize	Order_of_the_White_Lion
Ramiz_Mamedov	playsFor	FC_Luch-Energiya_Vladivostok
Thomas_Hinum	playsFor	SK_Rapid_Wien
Elfed_Evans	playsFor	West_Bromwich_Albion_F.C.
Javier_Calleja	playsFor	Villarreal_CF
Aristotle	influences	Félix_Ravaisson-Mollien
Alessandro_Turchetta	playsFor	ACF_Fiorentina
Dalian	isLocatedIn	China
Miroslav_Đukić	wasBornIn	Šabac
Lee_Morris_(footballer)	playsFor	Burton_Albion_F.C.
Alex_Sandro_Santana_de_Oliveira	playsFor	Malatyaspor
Mate_Maleš	playsFor	HNK_Hajduk_Split
Gaetano_Giallanza	playsFor	FC_Aarau
Eldar_Nizamutdinov	playsFor	FC_Rotor_Volgograd
Naseeruddin_Shah	hasWonPrize	National_Film_Awards_(India)
Aleksandar_Živković_(footballer_born_1912)	playsFor	Croatia_national_football_team
Jean-Luc_Godard	hasWonPrize	European_Film_Awards
Edmundo_Rodriguez	playsFor	Tampa_Bay_Terror
Paulo_Madeira	playsFor	C.F._Os_Belenenses
Ross_Macdonald	influences	Robert_B._Parker
Martin_Latka	playsFor	Panionios_G.S.S.
Abdullah_Fusseini	playsFor	U.S._Catanzaro_1929
Wayne_Dyer_(footballer)	playsFor	Stevenage_F.C.
Luxembourg	isLocatedIn	Europe
Marcos_Antônio_de_Lima	playsFor	Figueirense_Futebol_Clube
Manuel_Negrete_Arias	playsFor	Toros_Neza
Vladimir_Petrović	playsFor	Royal_Antwerp_F.C.
Bill_Atkins_(footballer)	playsFor	Halifax_Town_A.F.C.
Kenny_Allen_(footballer)	playsFor	West_Bromwich_Albion_F.C.
Mukhsin_Mukhamadiev	playsFor	Russia_national_football_team
Anton_Shokh	playsFor	FC_Rotor_Volgograd
Fábio_de_Jesus_Oliveira	playsFor	Al-Oruba_SC
Hassan_Mudhafar_Al-Gheilani	playsFor	Al-Oruba_SC
Andrew_Lyons	playsFor	Wigan_Athletic_F.C.
Julio_Gutiérrez	playsFor	Delfino_Pescara_1936
Steed_Malbranque	playsFor	Tottenham_Hotspur_F.C.
Mladen_Lazarević	playsFor	K.S.V._Roeselare
James_Thompson_(footballer)	playsFor	Peterborough_United_F.C.
Mehmet_Yılmaz_(footballer_born_1979)	playsFor	Denizlispor
Ronaldo_Tres	playsFor	Rio_Branco_Sport_Club
Mauricio_Nanni	playsFor	Montevideo_Wanderers_F.C.
Scott_Willis_(footballer)	playsFor	Lincoln_City_F.C.
Vlad_Chiricheș	playsFor	Romania_national_under-21_football_team
César_Carignano	playsFor	Club_Ferro_Carril_Oeste
Bertie_Cozic	playsFor	Aldershot_Town_F.C.
Tom_Geißler	playsFor	VfL_Osnabrück
Dean_Williams_(footballer)	playsFor	Telford_United_F.C.
Michael_Burns_(footballer)	playsFor	Stafford_Rangers_F.C.
James_Obiorah	wasBornIn	Jos
Jhon_Charría	playsFor	Atlético_Bucaramanga
Martín_Hidalgo	wasBornIn	Lima
Thor_Lee	wasBornIn	Long_Beach,_California
Mitja_Brulc	playsFor	NK_Celje
Johann_Gottlieb_Fichte	influences	Søren_Kierkegaard
Nelson_Gutiérrez	playsFor	Atlético_Nacional
Blagoje_Paunović	playsFor	FC_Utrecht
Alexander_Sánchez	playsFor	Club_Deportivo_Universidad_César_Vallejo
Arild_Stavrum	playsFor	Beşiktaş_J.K.
Edson_Minga	playsFor	Congo_national_football_team
Sérgio_Rodrigo_Penteado_Dias	playsFor	União_Agrícola_Barbarense_Futebol_Clube
Luca_Belingheri	playsFor	U.C._AlbinoLeffe
Milan_Biševac	playsFor	Valenciennes_FC
Kevin_Beattie	playsFor	Sandvikens_IF
Daniel_Bierofka	wasBornIn	Munich
Chris_Nurse	playsFor	Guyana_national_football_team
Andy_Rosenband	playsFor	Chicago_Storm
Aboubakar_Oumarou	playsFor	Cameroon_national_football_team
Massimo_Taibi	playsFor	Reggina_Calcio
Richard_Walker_(footballer_born_1977)	playsFor	Shrewsbury_Town_F.C.
Fernando_De_Napoli	playsFor	A.S._Avellino_1912
Daniel_Bierofka	playsFor	Germany_national_football_B_team
John_Linford	playsFor	FC_Utrecht
Mauritania	exports	wordnet_fish_102512053
Siebe_Blondelle	playsFor	Belgium_national_under-17_football_team
Terry_Eviston	playsFor	League_of_Ireland_XI
Almedin_Civa	playsFor	FC_Sachsen_Leipzig
Alberto_Acosta	playsFor	Yokohama_F._Marinos
Shawn_Beveney	playsFor	Caledonia_AIA_F.C.
Manuel_Badenes	playsFor	Real_Valladolid
Juan_Cominges	playsFor	Sporting_Cristal
Lucas_Piasentin	wasBornIn	Londrina
Paul_Kpaka	playsFor	K.R.C._Genk
J._D._Salinger	influences	Jason_Smilovic
Les_Mynard	playsFor	Halesowen_Town_F.C.
John_Coleman_(footballer_born_1962)	playsFor	Runcorn_F.C._Halton
Peter_Ijeh	playsFor	Bridge_Boys_F.C.
Simone_Sannibale	playsFor	S.S._Lazio
Marco_Soares	playsFor	AC_Omonia
Édison_Méndez	playsFor	Club_Deportivo_El_Nacional
Txomin_Nagore	playsFor	Celta_de_Vigo
Martin_Hloušek	playsFor	FC_SOYUZ-Gazprom_Izhevsk
Antonio_Calle	playsFor	Xerez_CD
David_Di_Michele	playsFor	Reggina_Calcio
Michael_Beauchamp	playsFor	AaB_Fodbold
José_Nunes	playsFor	Gil_Vicente_F.C.
Jan_Karaś	playsFor	Poland_national_football_team
Shane_Stefanutto	playsFor	Brisbane_Strikers_FC
Wagner_Diniz	playsFor	Clube_Atlético_Paranaense
Edson_Luis_da_Silva	playsFor	Korona_Kielce
Gláucio_de_Jesus_Carvalho	playsFor	Sport_Club_Internacional
Bülent_Akın	playsFor	Akçaabat_Sebatspor
Jason_Minett	playsFor	Exeter_City_F.C.
Ian_Stevens_(footballer)	playsFor	Preston_North_End_F.C.
Éber_Luís_Cucchi	wasBornIn	Caxias_do_Sul
John_O'Neill_(Scottish_footballer)	playsFor	A.F.C._Bournemouth
Kosta_Rodrigues	playsFor	Hannover_96
Martin_Hayes_(footballer)	playsFor	Celtic_F.C.
Mario_Bolatti	playsFor	ACF_Fiorentina
Jérôme_Leroy_(footballer)	playsFor	Stade_Lavallois
Con_Blatsis	playsFor	Australia_national_under-23_association_football_team
Emiliano_Armenteros	playsFor	Xerez_CD
Jimmy_Johnstone	playsFor	Celtic_F.C.
Fraser_Forster	playsFor	Stockport_County_F.C.
Willamis_de_Souza_Silva	wasBornIn	Maceió
Milan_Đurić	playsFor	Ascoli_Calcio_1898
Jimmy_Mulisa	playsFor	K.F.C._Vigor_Wuitens_Hamme
Henry_León	playsFor	Centro_Deportivo_Olmedo
Jean-François_Rivière	playsFor	AC_Ajaccio
Harry_Redknapp	playsFor	Seattle_Sounders_(1974–83)
Ryan_Mallon	playsFor	Frickley_Athletic_F.C.
Damian_Scannell	playsFor	Dulwich_Hamlet_F.C.
Matthew_Gardiner_(footballer)	playsFor	Redditch_United_F.C.
Paul_Walker_(footballer_born_1977)	playsFor	Montrose_F.C.
Kevin_Hofland	playsFor	VfL_Wolfsburg
Kazimierz_Węgrzyn	playsFor	GKS_Katowice
Saidu_Adeshina	playsFor	U.S._Arezzo
Fahad_Al_Rashidi	playsFor	Al-Arabi_SC_(Kuwait)
Tomislav_Dujmović	playsFor	GNK_Dinamo_Zagreb
Emiliano_Té	playsFor	FC_Felgueiras
Alireza_Abbasfard	playsFor	Paykan_F.C.
Lee_Nogan	playsFor	York_City_F.C.
Hugo_Droguett	playsFor	Cobreloa
Peter_Skov-Jensen	playsFor	Denmark_national_football_team
Andrea_Zanchetta	playsFor	A.C._Chievo_Verona
Andrej_Komac	playsFor	Ruch_Chorzów
Miloš_Kolaković	playsFor	FK_Bežanija
Samuel_Beckett	influences	David_Mamet
John_Scales	playsFor	Liverpool_F.C.
Jack_de_Gier	playsFor	Willem_II_(football_club)
Ioannis_Matzourakis	wasBornIn	Bucharest
Jean-Philippe_Caillet	playsFor	K.R.C._Genk
André-Pierre_Gignac	playsFor	Olympique_de_Marseille
Pablo_Vitti	wasBornIn	Rosario,_Santa_Fe
Amadou_Sanokho	playsFor	Atromitos_F.C.
Alejandro_Mello	playsFor	Tacuarembó_F.C.
Dustin_Hoffman	hasWonPrize	Theatre_World_Award
Răzvan_Cociș	playsFor	FC_Rostov
Lee_Philpott	playsFor	Lincoln_City_F.C.
Marco_Ferreira	playsFor	F.C._Penafiel
Alexander_Sánchez	playsFor	Alianza_Lima
Babacar_N'Diaye	playsFor	SpVgg_Unterhaching
Joonas_Tamm	playsFor	U.C._Sampdoria
Tab_Ramos	playsFor	United_States_men's_national_soccer_team
Thorsten_Wittek	playsFor	Hertha_Zehlendorf
Luis_Fernando_Mosquera	playsFor	Chiapas_F.C.
Colin_Cramb	playsFor	Heart_of_Midlothian_F.C.
Mike_Metcalf	playsFor	Altrincham_F.C.
Gary_Smith_(footballer_born_1968)	playsFor	Enfield_1893_F.C.
Syarhey_Shtanyuk	playsFor	FC_Metalurh_Zaporizhya
Wolfgang_Rausch	playsFor	Dallas_Tornado
Andy_Jones_(footballer)	playsFor	Havant_&_Waterlooville_F.C.
Juanfran_(footballer,_born_1985)	playsFor	Real_Madrid_C.F.
Michel_Platini_Mesquita	playsFor	C.F._Pachuca
Francisco_Aguirre	playsFor	AC_Omonia
Ognjen_Vukojević	playsFor	Croatia_national_football_team
Nathan_Joynes	playsFor	Matlock_Town_F.C.
Matt_Carmichael_(footballer)	playsFor	Boston_United_F.C.
Wolverhampton_Wanderers_F.C.	isLocatedIn	Wolverhampton
Jefferson_Montero	playsFor	Villarreal_CF
Antoni_Łukasiewicz	playsFor	Poland_national_football_team
Jordan_Stewart	playsFor	Coventry_City_F.C.
Mick_Heathcote	playsFor	York_City_F.C.
José_Luis_Pochettino	playsFor	Sportivo_Italiano
Taner_Demirbaş	playsFor	Polatlı_Bugsaşspor
Laurent_Blanc	playsFor	Inter_Milan
Joe_Corrigan	playsFor	Norwich_City_F.C.
Gary_Mills_(footballer,_born_1981)	playsFor	Rushden_&_Diamonds_F.C.
Gary_Rowell	playsFor	Brighton_&_Hove_Albion_F.C.
Wilko_de_Vogt	playsFor	RBC_Roosendaal
Luke_Kreamalmeyer	playsFor	Montreal_Impact
Harry_Redknapp	playsFor	England_national_under-19_football_team
José_Kléberson	playsFor	Clube_Atlético_Paranaense
Gary_Alexander_(footballer)	playsFor	Swindon_Town_F.C.
Eliézio_Santos_Santana	wasBornIn	Salvador,_Bahia
Sean_Doherty_(footballer)	playsFor	Colwyn_Bay_F.C.
Shaun_Goater	playsFor	Coventry_City_F.C.
Walter_Kelsch	wasBornIn	Stuttgart
Erik_Meijer_(footballer)	playsFor	FC_Eindhoven
Paul_Heald	playsFor	Wimbledon_F.C.
Michael_Kümmerle	playsFor	SpVgg_Greuther_Fürth
Paulo_Sérgio_Bento_Brito	playsFor	S.C._Salgueiros
Edmund_G._Ross	playsFor	Swindon_Town_F.C.
Danny_Cullip	playsFor	Brighton_&_Hove_Albion_F.C.
Jürgen_Rollmann	playsFor	FSV_Frankfurt
Dušan_Anđelković	playsFor	FK_Voždovac
Markus_Schupp	playsFor	FC_Basel
Sergio_Rojas	playsFor	Chaco_For_Ever
Dante_Alighieri	influences	Alphonse_de_Lamartine
Benin	isLocatedIn	Africa
Adem_Dursun	playsFor	MKE_Ankaragücü
Tomasz_Radzinski	playsFor	Everton_F.C.
Jimmy_Greaves	playsFor	West_Ham_United_F.C.
Ansgar_Brinkmann	playsFor	SC_Preußen_Münster
Carsten_Fredgaard	playsFor	Akademisk_Boldklub
Sergey_Andreyev	wasBornIn	Luhansk
Argélico_Fucks	playsFor	F.C._Porto
Seo_Ki-bok	playsFor	South_Korea_national_under-23_football_team
Juan_Cruz_Ochoa	playsFor	SD_Huesca
Zineddine_Mekkaoui	playsFor	JS_Kabylie
Samir_Amirèche	playsFor	Al-Gharafa_Sports_Club
Radostin_Stanev	wasBornIn	Varna
Ivo_Afonso	playsFor	Kalamata_F.C.
Robert_Jarni	wasBornIn	Čakovec
Nassim_Mendil	playsFor	Cosenza_Calcio
Edmílson_(footballer_born_1976)	playsFor	Ceará_Sporting_Club
James_Stansfield	playsFor	Guiseley_A.F.C.
Gökhan_Bozkaya	playsFor	Malatyaspor
Michał_Janota	playsFor	Korona_Kielce
Phil_Harrington	playsFor	Preston_North_End_F.C.
SV_Wehen_Wiesbaden	isLocatedIn	Wiesbaden
Vladimir_Akhalaia	playsFor	FC_Dinamo_București
Ponaryo_Astaman	playsFor	Arema_Cronus_F.C.
Richard_Gough	playsFor	Everton_F.C.
Mark_Walton_(footballer)	playsFor	Brighton_&_Hove_Albion_F.C.
Alessandro_Iandoli	playsFor	Delfino_Pescara_1936
Cristián_Montecinos	playsFor	Colo-Colo
Kevin_Francis_(footballer)	playsFor	Derby_County_F.C.
Carsten_Sträßer	playsFor	SSV_Jahn_Regensburg
Henry_Adams	graduatedFrom	Humboldt_University_of_Berlin
Kieron_St_Aimie	playsFor	Stevenage_F.C.
José_Semedo_(footballer,_born_1979)	playsFor	APOP_Kinyras_FC
Felino_Jardim	playsFor	Feyenoord
Marcus_Steegmann	playsFor	Hamburger_SV_II
Tibor_Montvai	playsFor	Nyíregyháza_Spartacus_FC
César_Prates	playsFor	Sport_Club_Internacional
Germano_Borovicz_Cardoso_Schweger	playsFor	Ceará_Sporting_Club
Bryn_Gunn	playsFor	Arnold_Town_F.C.
Andrey_Chernyshov	playsFor	Soviet_Union_national_football_team
Sergio_Rojas	playsFor	Grenoble_Foot_38
Alex_Manninger	playsFor	A.C._Siena
Sinthaweechai_Hathairattanakool	playsFor	Thailand_national_under-23_football_team
Mehdi_Taouil	playsFor	Heart_of_Midlothian_F.C.
Benedict_Akwuegbu	playsFor	RC_Lens
Timothy_Derijck	playsFor	Feyenoord
Jay_Bothroyd	playsFor	Coventry_City_F.C.
Dejan_Stamenković	playsFor	FK_Hajduk_Beograd
Eric_Brunner	playsFor	Portland_Timbers
Bobby_Smith_(soccer)	playsFor	United_States_men's_national_soccer_team
Yannick_Salem	playsFor	AGOVV_Apeldoorn
Aleksandr_Sheshukov	playsFor	FC_Spartak_Tambov
Glenn_Murray	playsFor	Wilmington_Hammerheads_FC
Hervé_Bugnet	playsFor	FC_Martigues
Šabac	isLocatedIn	Mačva_District
Igor_Belanov	playsFor	FC_Dynamo_Kyiv
Chedric_Seedorf	playsFor	Inter_Milan
Vieirinha	playsFor	Portugal_national_under-19_football_team
Pierre_Njanka	playsFor	Club_Africain
Pavlo_Yanchuk	playsFor	FC_Obolon_Kyiv
Bruno_Fontes_da_Mota	playsFor	FC_Le_Mont
Cho_Young-cheol	playsFor	South_Korea_national_under-23_football_team
Anderson_Luiz_Domingos	playsFor	Cruzeiro_Esporte_Clube
Gabriel_Cedrés	playsFor	Montevideo_Wanderers_F.C.
Mutiu_Adepoju	playsFor	Bridge_Boys_F.C.
Paul_Williams_(Northern_Ireland_footballer)	playsFor	Coventry_City_F.C.
Sean_Higgins_(footballer)	playsFor	Dundee_F.C.
Selim_Benachour	playsFor	Vitória_S.C.
Billy_Whitehurst	playsFor	Glentoran_F.C.
Lee_Nogan	playsFor	Wales_national_football_team
Peter_Beardsley	playsFor	Manchester_City_F.C.
Anton_Robinson	playsFor	Weymouth_F.C.
Predrag_Lazić	playsFor	Aris_Limassol_F.C.
Martin_Russell_(footballer)	playsFor	Norwich_City_F.C.
Tomasz_Brzyski	playsFor	Radomiak_Radom
Dominic_Iorfa	playsFor	Royal_Antwerp_F.C.
Željko_Mitrakovič	playsFor	NK_Domžale
Oliver_Cuadrado_Martín	playsFor	Real_Madrid_C.F.
Pierre_Curie	worksAt	fr/Faculté_des_sciences_de_Paris
Barry_Robson	playsFor	Forfar_Athletic_F.C.
Sam_Allardyce	playsFor	Shahin_Bushehr_F.C.
Réunion	isLocatedIn	Indian_Ocean
Bogdan_Vrăjitoarea	playsFor	FC_Ceahlăul_Piatra_Neamț
Victor_Pițurcă	playsFor	RC_Lens
Rohan_Ricketts	playsFor	Wolverhampton_Wanderers_F.C.
Kenny_Deuchar	playsFor	Livingston_F.C.
Gordan_Petrić	playsFor	Heart_of_Midlothian_F.C.
Xavi_Valero	playsFor	Córdoba_CF
Alexandro_Alves_do_Nascimento	playsFor	Associação_Portuguesa_de_Desportos
Stefanos_Athanasiadis	playsFor	Unione_Triestina_2012_S.S.D.
Luchi_Gonzalez	playsFor	Sporting_Cristal
Madagascar	exports	wordnet_clothing_103051540
Liam_Brady	playsFor	Arsenal_F.C.
Ramūnas_Stonkus	playsFor	SV_Wilhelmshaven
Uwe_Möhrle	playsFor	FC_Energie_Cottbus
Andrés_Eduardo_Pérez	playsFor	Real_Cartagena
Ninoslav_Milenković	playsFor	FK_Hajduk_Kula
Thomas_Pfannkuch	playsFor	Olympique_Lyonnais
Dmitri_Karsakov	playsFor	FC_Slavia-Mozyr
Caleb_Ekwegwo	playsFor	Yokohama_FC_Hong_Kong
Luciano_Zavagno	playsFor	Troyes_AC
Darren_Roberts_(footballer)	playsFor	Burton_Albion_F.C.
Angelo_Pagotto	playsFor	F.C._Crotone
Túlio_Gustavo_Cunha_Souza	playsFor	Ceará_Sporting_Club
Karl-Heinz_Mrosko	playsFor	Oakland_Stompers
Norbert_Tóth	playsFor	Hungary_national_football_team
Emin_Quliyev	wasBornIn	Baku
Jimmy_Delaney	playsFor	Falkirk_F.C.
Kjetil_Wæhler	playsFor	Wimbledon_F.C.
Marco_Andreolli	playsFor	A.C._Chievo_Verona
Josh_Gowling	playsFor	West_Bromwich_Albion_F.C.
Gerard_Butler	playsFor	Delfino_Pescara_1936
Sidney_Moraes	playsFor	S.C._Braga
Dennis_Șerban	playsFor	FC_Dinamo_București
Glynor_Plet	wasBornIn	Amsterdam
Leandro_de_Oliveira_da_Luz	playsFor	Paysandu_Sport_Club
Richard_von_Weizsäcker	hasWonPrize	Order_of_the_White_Lion
Ioannis_Okkas	playsFor	Celta_de_Vigo
Michael_Blackwood_(footballer)	playsFor	Stevenage_F.C.
Fabrice_Moreau	playsFor	Cameroon_national_football_team
Gordon_Moore	graduatedFrom	California_Institute_of_Technology
Felix_Luz	playsFor	SHB_Da_Nang_F.C.
Jonathan_Blondel	playsFor	Belgium_national_under-17_football_team
Marcelo_Saragosa	playsFor	Ravan_Baku_FK
Jock_Mulraney	playsFor	Birmingham_City_F.C.
Franco_Navarro	playsFor	Alianza_Lima
Steven_N'Zonzi	wasBornIn	Colombes
Víctor_Muñoz	playsFor	U.C._Sampdoria
Mehmet_Yılmaz_(footballer_born_1979)	playsFor	Trabzonspor
Jonathan_Bru	playsFor	France_national_under-18_football_team
Roberto_de_Sousa_Rezende	playsFor	Celta_de_Vigo
Renato_Queirós	playsFor	FC_Felgueiras
Juiz_de_Fora	isLocatedIn	Southeast_Region,_Brazil
Mark_Wells_(footballer)	wasBornIn	Leicester
Magnus_Okuonghae	playsFor	Weymouth_F.C.
Barry_Conlon	playsFor	Stockport_County_F.C.
Alun_Armstrong_(footballer)	playsFor	Stockport_County_F.C.
Marjan_Jugović	playsFor	Wisła_Płock
Cuca_(footballer)	playsFor	Esporte_Clube_Juventude
Peter_Davenport	playsFor	Cammell_Laird_1907_F.C.
George_Travers	playsFor	Swindon_Town_F.C.
Mark_Stewart_(footballer)	playsFor	Dundee_F.C.
Tony_Stokes	playsFor	Stevenage_F.C.
Jean-Louis_Akpa_Akpro	wasBornIn	Toulouse
Scott_Allan	playsFor	Forfar_Athletic_F.C.
Adriano_Ferreira_Martins	playsFor	Sport_Club_Internacional
Farid_Guliyev	playsFor	Sumgayit_FK
Kenny_Deuchar	playsFor	Falkirk_F.C.
Ricardo_Santos_Lago	playsFor	Londrina_Esporte_Clube
Emrah_Eren	playsFor	Kartal_S.K.
Cem_Atan	playsFor	SK_Rapid_Wien
Arjan_Sheta	playsFor	KF_Elbasani
Chiquinho_Delgado	playsFor	Imortal_DC
Kisho_Yano	playsFor	Júbilo_Iwata
Dejan_Kelhar	playsFor	SpVgg_Greuther_Fürth
Xabi_Alonso	playsFor	Real_Madrid_C.F.
Andrea_Caracciolo	playsFor	Italy_national_under-20_football_team
Alex_Wilkinson	playsFor	Australia_national_association_football_team
Nathan_Jarman	playsFor	Bury_F.C.
Phil_Morgan	playsFor	Halifax_Town_A.F.C.
Claudio_Enría	playsFor	Newell's_Old_Boys
Edgar_Loué	playsFor	Al-Nasr_SC_(Benghazi)
Carl_Fletcher_(Welsh_footballer)	playsFor	Wales_national_football_team
Felix_Aboagye	playsFor	Club_Valencia
Manuel_Hiemer	playsFor	SpVgg_Greuther_Fürth
Hichem_Mezaïr	playsFor	WA_Tlemcen
Salvatore_Campilongo	playsFor	U.S._Salernitana_1919
Mikhael_Jaimez-Ruiz	playsFor	Hemel_Hempstead_Town_F.C.
Nenad_Stojanović	playsFor	FK_Rudar_Pljevlja
Yasen_Petrov	playsFor	PFC_Botev_Plovdiv
Dariusz_Zawadzki	playsFor	Sandecja_Nowy_Sącz
Lionel_Scaloni	playsFor	Newell's_Old_Boys
Billy_Celeski	playsFor	Australia_national_association_football_team
Mate_Maleš	playsFor	Croatia_national_football_team
Cristian_Rami	playsFor	Angers_SCO
Stanislav_Karasi	playsFor	Red_Star_Belgrade
Edmundo_Rodriguez	playsFor	Charleston_Battery
Fernando_Menegazzo	playsFor	Esporte_Clube_Juventude
Joey_Fink	playsFor	New_York_Apollo
Ali_Karimi	playsFor	Tractor_Sazi_F.C.
Steve_Mautone	playsFor	Slough_Town_F.C.
Emilian_Dolha	playsFor	FC_Dinamo_București
Dragan_Čadikovski	playsFor	Macedonia_national_football_team
Sylvain_Monsoreau	playsFor	Olympique_Lyonnais
Siavash_Akbarpour	playsFor	Tractor_Sazi_F.C.
Alejandro_Meloño	playsFor	San_Lorenzo_de_Almagro
Ümit_Korkmaz	playsFor	SK_Rapid_Wien
Herbert_Waas	playsFor	Germany_national_football_team
Johnny_McGuire	playsFor	Dundee_F.C.
Babacar_N'Diaye	playsFor	SC_Preußen_Münster
Colin_Hendry	playsFor	Preston_North_End_F.C.
Danilo_Rios	playsFor	Esporte_Clube_Juventude
Danilo_Soddimo	playsFor	Italy_national_under-18_football_team
Lee_Todd_(footballer)	playsFor	Stockport_County_F.C.
Gonzalo_Rubén_Bergessio	playsFor	San_Lorenzo_de_Almagro
Kris_Taylor	playsFor	Hednesford_Town_F.C.
Javier_Camuñas	playsFor	Rayo_Vallecano
Bobby_Russell_(footballer)	wasBornIn	Glasgow
Marlin_Piana	playsFor	Hapoel_Ironi_Kiryat_Shmona_F.C.
Joel_Sánchez_(Mexican_footballer)	playsFor	Club_América
Bret_Easton_Ellis	influences	Douglas_Coupland
Saša_Gajser	playsFor	Slovenia_national_football_team
Sehar_Fejzulahi	playsFor	Switzerland_national_under-21_football_team
Édson_Nobre	playsFor	C.R.D._Libolo
Adrian_Scarlatache	playsFor	CS_Otopeni
Kevin_Lisbie	playsFor	Derby_County_F.C.
Raul_Otero	wasBornIn	Montevideo
Napoléon_(miniseries)	isLocatedIn	Canada
Mikhail_Biryukov_(footballer_born_1958)	playsFor	Soviet_Union_national_football_team
Dougie_Cameron	playsFor	Montrose_F.C.
Sydney_Brenner	graduatedFrom	University_of_the_Witwatersrand
Leo_Bertos	wasBornIn	Wellington
Oleksandr_Chyzhevskyi	playsFor	FC_Metalurh_Zaporizhya
Ervin_Bulku	wasBornIn	Tirana
Vitaliy_Shevchenko	playsFor	FC_Dynamo_Kyiv
Associação_Portuguesa_de_Desportos	hasWonPrize	Order_of_Prince_Henry
Arturo_Albarrán	playsFor	Club_Universidad_Nacional
Beñat_Etxebarria	playsFor	Real_Betis_B
Adriano_Magrão	playsFor	América_Futebol_Clube_(RN)
Vladislaus_II_of_Hungary	wasBornIn	Kraków
Marcos_António_Elias_Santos	playsFor	F.C._Porto
Michel_Kuipers	playsFor	Brighton_&_Hove_Albion_F.C.
Orhan_Ak	playsFor	Boluspor
James_Lindley	playsFor	Hucknall_Town_F.C.
Luciano_Emílio	playsFor	Querétaro_F.C.
Georg_Wittig	isCitizenOf	Germany
Jorge_Francisco_Vargas	playsFor	Deportes_La_Serena
Mark_DeBolla	playsFor	Grays_Athletic_F.C.
Glen_Fitzpatrick	playsFor	Glenavon_F.C.
Habsburg_Monarchy	isLocatedIn	Europe
Andre_Luiz_de_Souza_Silva	playsFor	Sagan_Tosu
Andrei_Streltsov	playsFor	FC_Luch-Energiya_Vladivostok
Andriy_Fartushnyak	playsFor	Ukraine_national_under-21_football_team
David_McCracken	playsFor	Bristol_Rovers_F.C.
Sherman_Cárdenas	playsFor	Junior_F.C.
Joe_Lewis_(footballer)	playsFor	Cardiff_City_F.C.
Nuno_Miguel_Teixeira_Rocha	playsFor	Varzim_S.C.
Zhivko_Zhelev	playsFor	Inter_Baku_PIK
Aco_Stojkov	playsFor	Nyíregyháza_Spartacus_FC
Victor_Ikpeba	playsFor	ACB_Lagos
Fede_Vico	playsFor	Córdoba_CF
Nathan_Sacks	playsFor	Dallas_Tornado
Farhad_Majidi	playsFor	SK_Rapid_Wien
Ángel_Zubieta	playsFor	San_Lorenzo_de_Almagro
Alex_Sandro	playsFor	F.C._Porto
Rui_Pataca	playsFor	FC_Felgueiras
Nacho_Novo	playsFor	Dundee_F.C.
Neil_Wood	playsFor	Royal_Antwerp_F.C.
Tony_Stokes	playsFor	Concord_Rangers_F.C.
Erhan_Aydın	playsFor	Polatlı_Bugsaşspor
Igor_Bogdanović	playsFor	Gençlerbirliği_S.K.
Vítězslav_Mooc	playsFor	FC_Hradec_Králové
Karel_Poborský	playsFor	S.S._Lazio
Steve_O'Shaughnessy_(footballer)	playsFor	Hong_Kong_Rangers_FC
Sabin_Ilie	playsFor	Qingdao_Hailifeng_F.C.
Julien_Sablé	playsFor	RC_Lens
Iván_Pailós	playsFor	Sud_América
Kamran_Agayev	playsFor	Baku_FC
Pietro_Scalia	edited	Gladiator_(2000_film)
Doug_Wark	playsFor	Las_Vegas_Quicksilvers
Yoann_Bouchard	playsFor	Elche_CF
Zoran_Vujović	playsFor	HNK_Hajduk_Split
Edmar_Bernardes	playsFor	Grêmio_Foot-Ball_Porto_Alegrense
Jorge_Barrera	playsFor	Correcaminos_UAT
Migen_Memelli	playsFor	Al-Taawon_FC
Chris_James_(footballer)	playsFor	APIA_Leichhardt_Tigers_FC
Mourad_Meghni	playsFor	AS_Cannes
Waldir_Lucas_Pereira	playsFor	Clube_Atlético_Metropolitano
Peter_Läng	playsFor	FC_Schaffhausen
Oliver_Schmidt	playsFor	SpVgg_Greuther_Fürth
Egidio_Arévalo	playsFor	Danubio_F.C.
Marco_Walker	playsFor	BSC_Old_Boys
Bruno_Rafael_Bronetta_da_Silva	playsFor	FC_Dinamo_Minsk
Adolfo_Bautista	playsFor	Querétaro_F.C.
Mauricio_Ramos	playsFor	New_England_Revolution
Stuart_McCluskey	playsFor	Scotland_national_under-21_football_team
Joonas_Kolkka	playsFor	Willem_II_(football_club)
Renan_Marques	playsFor	Jeju_United_FC
Davide_Baiocco	playsFor	A.C._Siena
Ryszard_Komornicki	playsFor	Poland_national_football_team
Collins_John	playsFor	K.S.V._Roeselare
Rohan_Ricketts	playsFor	Arsenal_F.C.
Arthur_Schopenhauer	influences	Hermann_Hesse
Josef_Miso	playsFor	L.D._Alajuelense
Stephen_Wright_(English_footballer)	playsFor	Brentford_F.C.
Alejandro_Mancuso	playsFor	C.A._Bella_Vista
Nenad_Lazarevski	playsFor	Serbia_national_under-19_football_team
Janet_Lee_Bouvier	playsFor	F.C._Porto
Frank_Gerster	playsFor	FC_Sachsen_Leipzig
Auguste_Jordan	wasBornIn	Linz
Jean_Tigana	playsFor	Olympique_de_Marseille
Kim_Dong-sub	playsFor	Tokushima_Vortis
Bryn_Halliwell	playsFor	Forfar_Athletic_F.C.
Aleksandar_Živković_(footballer_born_1912)	playsFor	CA_Paris-Charenton
Dave_Sexton	playsFor	West_Ham_United_F.C.
Mike_Slivinski	playsFor	D.C._United
Alexander_Haig	hasWonPrize	Gallantry_Cross_(Vietnam)
Strasbourg	isLocatedIn	France
Ben_Bowditch	playsFor	Akademisk_Boldklub
Cyril_Kali	playsFor	Panserraikos_F.C.
Gottfried_Wilhelm_Leibniz	influences	Giambattista_Vico
Ilami_Halimi	playsFor	NK_Čakovec
Cho_Byung-kuk	playsFor	South_Korea_national_under-23_football_team
Daniel_Zítka	playsFor	K.S.C._Lokeren_Oost-Vlaanderen
Zoran_Kostić_(footballer)	playsFor	FK_Remont_Čačak
Daniel_Wolf	playsFor	S.S.D._Piacenza_Calcio_1919
Akeem_Agbetu	playsFor	F.C._Ebedei
Jackie_Gallagher_(footballer)	playsFor	Eastern_AA
Peter_Beardsley	playsFor	Vancouver_Whitecaps_(1974–84)
Drogheda	isLocatedIn	Ireland
Abdullah_Quaye	playsFor	Málaga_CF
Clint_Dempsey	playsFor	Tottenham_Hotspur_F.C.
Ferenc_Horváth	playsFor	Livingston_F.C.
Ólafur_Gottskálksson	playsFor	Brentford_F.C.
Bruno_Fogaça	playsFor	Clube_Atlético_Bragantino
Sepp_De_Roover	playsFor	NAC_Breda
Martín_Hidalgo	playsFor	Peru_national_football_team
Klimenti_Tsitaishvili	playsFor	Hapoel_Rishon_LeZion_F.C.
José_Semedo_(footballer,_born_1979)	wasBornIn	Lisbon
Schwenck	playsFor	Nova_Iguaçu_Futebol_Clube
Bima_Sakti	playsFor	Indonesia_national_football_team
Pedro_Guerreiro_de_Jesus_Correia	playsFor	C.D._Fátima
Élvis_Alves_Pereira	playsFor	União_Agrícola_Barbarense_Futebol_Clube
Peter_Eastoe	playsFor	Wolverhampton_Wanderers_F.C.
José_Manuel_Moreno	playsFor	Independiente_Medellín
Ismael_Sosa	playsFor	Club_Universidad_Nacional
Marc-Éric_Gueï	playsFor	Panserraikos_F.C.
Senad_Tiganj	playsFor	NK_Svoboda
Benoît_Angbwa	playsFor	FC_Anzhi_Makhachkala
Lukas_Aurednik	playsFor	RC_Lens
Jorge_Bartero	playsFor	Sportivo_Italiano
Néstor_Ayala	playsFor	Santa_Tecla_F.C.
José_Quitongo	playsFor	Albion_Rovers_F.C.
James_White_(Scottish_footballer)	playsFor	New_Bedford_Whalers
Lee_Nguyen	playsFor	United_States_men's_national_soccer_team
Eddie_Byrne_(footballer)	playsFor	Athlone_Town_A.F.C.
Shaun_Murphy_(footballer)	playsFor	Australia_national_under-20_association_football_team
Krzysztof_Ratajczyk	playsFor	SK_Rapid_Wien
Medhi_Lacen	wasBornIn	Paris
Roger_Guerreiro	playsFor	Clube_de_Regatas_do_Flamengo
Guy_Bates	playsFor	Blyth_Spartans_A.F.C.
Vladimir_Shishelov	playsFor	FK_Andijan
Rauwshan_McKenzie	playsFor	Real_Salt_Lake
Andy_Chapman	playsFor	Arsenal_F.C.
Joseph_Amoah	wasBornIn	Accra
Brian_Launders	playsFor	Derby_County_F.C.
Fernando_Arce	playsFor	C.D._Guadalajara
Gyula_Hegedűs	playsFor	BKV_Előre_SC
Mario_Camacho	playsFor	Puntarenas_F.C.
Robert_Ukrop	playsFor	New_England_Revolution
Stanley_Tucci	hasWonPrize	Film_Independent_Spirit_Awards
Július_Korostelev	playsFor	Czechoslovakia_national_football_team
Enílton	wasBornIn	Campo_Grande
Alan_Lloyd_Hodgkin	hasWonPrize	Nobel_Prize_in_Physiology_or_Medicine
Josiel_da_Rocha	playsFor	Cuiabá_Esporte_Clube
Chris_Thompson_(footballer_born_1982)	playsFor	Barrow_A.F.C.
Neil_Janczyk	playsFor	Heart_of_Midlothian_F.C.
Jean-Manuel_Thetis	playsFor	Wolverhampton_Wanderers_F.C.
Michal_Vorel	playsFor	SK_Sparta_Krč
Sérgio_Manoel	playsFor	Marília_Atlético_Clube
Miguel_Peirano_(footballer)	playsFor	Uruguay_national_football_team
Jakub_Jakubov	playsFor	FC_Spartak_Trnava
Graham_Coughlan	playsFor	Burnley_F.C.
Andrea_Manzo	playsFor	U.C._Sampdoria
Dianne_Wiest	hasWonPrize	Clarence_Derwent_Awards
Erminio_Rullo	playsFor	Inter_Milan
Anders_Linderoth	playsFor	Olympique_de_Marseille
Carl_Valentine	playsFor	Baltimore_Blast_(1980–92)
Hector_Marinaro	playsFor	Cleveland_Force_(1978–88)
Saudi_detainees_at_Guantanamo_Bay	playsFor	A.D._Ovarense
Darl_Douglas	playsFor	FC_Utrecht
Alex_McCarthy	wasBornIn	Guildford
Fabien_Bossy	playsFor	Académico_de_Viseu_FC
Alfie_Conn,_Jr.	playsFor	Celtic_F.C.
Danny_Sonner	playsFor	Peterborough_United_F.C.
Adam_Frye	playsFor	LA_Galaxy
Jacques_Chaban-Delmas	wasBornIn	Paris
Joe_Nagbe	playsFor	Panionios_G.S.S.
Disney_Channel_(Latin_America)	isLocatedIn	Ecuador
Richard_Alderson	playsFor	York_City_F.C.
Markus_Babbel	wasBornIn	Munich
Carlos_Villagra	playsFor	Millonarios_Fútbol_Club
Francis_Bugri	playsFor	VfB_Lübeck
Rômulo_Marques_Antoneli	playsFor	Club_Atlas
Todor_Kyuchukov	playsFor	PFC_CSKA_Sofia
Sergei_Pesyakov	playsFor	Russia_national_under-21_football_team
Željko_Mitrakovič	playsFor	FC_Koper
Brian_Etheridge_(footballer)	playsFor	Cercle_Brugge_K.S.V.
Dejan_Blaževski	playsFor	FK_Turnovo
Neto_(footballer)	playsFor	Millonarios_Fútbol_Club
Marco_Pecorari	playsFor	A.S._Avellino_1912
Archil_Arveladze	playsFor	Trabzonspor
Robertas_Poškus	wasBornIn	Klaipėda
Marco_Mejía	playsFor	Comayagua_F.C.
Günter_Bittengel	playsFor	Dukla_Prague
Krzysztof_Adamczyk	playsFor	Zawisza_Bydgoszcz
Ted_Purdon	playsFor	Barrow_A.F.C.
John_Locke	influences	John_Stuart_Mill
André_Luiz_Rodrigues_Lopes	playsFor	Roma_Esporte_Apucarana
Abdoulaye_Baldé_(footballer)	playsFor	A.C._Lumezzane
İlyas_Kahraman	playsFor	Denizlispor
Efraín_Herrera	playsFor	C.F._Pachuca
Stuart_McCall	playsFor	Everton_F.C.
Anton_Mukhovykov	playsFor	FC_Stal_Alchevsk
Sergey_Kutsov	playsFor	FC_Vostok
Tommy_Baldwin	playsFor	Arsenal_F.C.
Keith_Briggs_(footballer)	playsFor	Shrewsbury_Town_F.C.
Jonás_Gutiérrez	playsFor	Norwich_City_F.C.
Andrei_Karpovich	playsFor	FC_Rostov
Dennis_Grassow	playsFor	SpVgg_Unterhaching
Kléber_Pereira	playsFor	Clube_Atlético_Paranaense
Fabio_Daprelà	playsFor	West_Ham_United_F.C.
Don_Goodman	playsFor	Stafford_Rangers_F.C.
Renato_Cajá	playsFor	Grêmio_Foot-Ball_Porto_Alegrense
Zaenal_Arief	playsFor	Persita_Tangerang
Søren_Kierkegaard	influences	Paul_Ricœur
William_Shakespeare	influences	Walter_Scott
Jorge_Rinaldi	playsFor	Argentina_national_football_team
Jasmin_Handanović	playsFor	NK_Svoboda
Eldar_Topić	playsFor	SC_Austria_Lustenau
Arthur_Schopenhauer	influences	Fernando_Pessoa
Barry_Town_United_F.C.	isLocatedIn	Barry,_Vale_of_Glamorgan
Stephen_Wright_(English_footballer)	playsFor	Liverpool_F.C.
Brian_Bates_(soccer)	playsFor	FC_Dallas
Fred_Murray	playsFor	Northampton_Town_F.C.
Porfirio_Armando_Betancourt	playsFor	Honduras_national_football_team
Ismael_Santiago_López	playsFor	CF_Sporting_Mahonés
Héctor_Cúper	playsFor	Argentina_national_football_team
Sead_Zilić	playsFor	Wisła_Płock
Greg_Fleming	playsFor	Galway_United_F.C.
Crawley	isLocatedIn	United_Kingdom
Jeremy_Bentham	influences	John_Stuart_Mill
Mattias_Bjärsmyr	playsFor	Rosenborg_BK
Ervin_Bulku	playsFor	HNK_Hajduk_Split
Benedict_Akwuegbu	playsFor	K.R.C._Zuid-West-Vlaanderen
Zyad_Chaabo	playsFor	Al-Jaish_SC_(Damascus)
Damian_Scannell	playsFor	Brentford_F.C.
Owen_Madden_(footballer)	playsFor	Norwich_City_F.C.
Didier_Tholot	playsFor	BSC_Young_Boys
William_S._Burroughs	graduatedFrom	Harvard_University
Pelé_(footballer,_born_1978)	playsFor	Falkirk_F.C.
Roy_Carter_(footballer)	playsFor	Swindon_Town_F.C.
Mehmet_Durakovic	playsFor	Selangor_FA
George_H._W._Bush	hasWonPrize	Order_of_the_Cross_of_Terra_Mariana
Bozhidar_Iskrenov	playsFor	PFC_CSKA_Sofia
Edmund_Burke	influences	William_Godwin
Keith_Robson	playsFor	West_Ham_United_F.C.
Jacek_Krzynówek	playsFor	Hannover_96
Justin_Hoyte	playsFor	England_national_under-20_football_team
Robbie_Hooker	playsFor	Australia_national_under-23_association_football_team
Danny_Williams_(footballer_born_1981)	playsFor	Rushden_&_Diamonds_F.C.
Krzysztof_Pawlak	playsFor	K.S.C._Lokeren_Oost-Vlaanderen
Ali_Gibb	playsFor	Stockport_County_F.C.
Dejan_Petković	playsFor	Esporte_Clube_Vitória
James_McEveley	playsFor	Burnley_F.C.
Kim_Yong-dae	playsFor	South_Korea_national_football_team
Sehar_Fejzulahi	playsFor	FC_Lugano
Phil_Boyer	playsFor	York_City_F.C.
Thomas_Richter_(footballer_born_1980)	playsFor	FC_08_Homburg
Dani_Chigou	playsFor	FC_Farul_Constanța
Craig_Moore	playsFor	Crystal_Palace_F.C.
Mick_Lambert	playsFor	Peterborough_United_F.C.
Adrián_Berbia	playsFor	Junior_F.C.
Miki_Roqué	playsFor	Liverpool_F.C.
Darran_Kempson	playsFor	Preston_North_End_F.C.
Igor_Demo	playsFor	FC_Nitra
Tolga_Özgen	playsFor	Gaziantep_Büyükşehir_Belediyespor
Tsardom_of_Russia	isLocatedIn	Europe
Ibrahima_Sidibe	playsFor	WSG_Wattens
Julio_Álvarez	playsFor	Rayo_Vallecano
Renato_Cajá	playsFor	Kashima_Antlers
Manuel_Vidrio	playsFor	C.D._Guadalajara
Mohamed_Kader	playsFor	FC_Lugano
Taiwo_Atieno	playsFor	Stevenage_F.C.
Daniel_Lopez_Cruz	playsFor	Rio_Branco_Sport_Club
David_Cerutti	playsFor	General_Paz_Juniors
Leopold_Infeld	wasBornIn	Kraków
Martin_Hayes_(footballer)	playsFor	Coventry_City_F.C.
Rabah_Madjer	playsFor	F.C._Porto
Jos_van_Nieuwstadt	playsFor	Willem_II_(football_club)
Diego_Capel	playsFor	Spain_national_under-19_football_team
Johann_Gottlieb_Fichte	influences	Rudolf_Steiner
Alex_Burns_(footballer)	playsFor	Stranraer_F.C.
Robert_Gallo	wasBornIn	Waterbury,_Connecticut
Daniel_Guerrero_Gómez	playsFor	Real_Jaén
Emin_Quliyev	playsFor	Simurq_PIK
Galway_United_F.C.	isLocatedIn	Ireland
Damien_Tixier	playsFor	Neuchâtel_Xamax
Peter_Bulmer	playsFor	Conwy_Borough_F.C.
Edgar_Borges	playsFor	Grenoble_Foot_38
Daniel_Akhtyamov	playsFor	Kapaz_PFK
Jan_Suchopárek	playsFor	Dukla_Prague
Horace_Harmon_Lurton	playsFor	Al_Ahli_SC_(Doha)
Neil_Warnock	playsFor	Crewe_Alexandra_F.C.
Johnson_Monteiro_Pinto_Macaba	playsFor	Clube_Atlético_Sorocaba
Mark_Walton_(footballer)	playsFor	Norwich_City_F.C.
Richard_Graham_(Northern_Ireland_footballer)	playsFor	Dartford_F.C.
Romulus_Buia	playsFor	FC_Dinamo_București
Johnny_Nicholls	playsFor	Telford_United_F.C.
Liam_Chilvers	playsFor	Preston_North_End_F.C.
Jaap_de_Hoop_Scheffer	wasBornIn	Amsterdam
Renny_Vega	playsFor	Colo-Colo
Sergio_Barila	playsFor	CD_Alcoyano
David_Silva_(Cape_Verdean_footballer)	playsFor	S.C._Olhanense
René_Schneider_(footballer)	playsFor	Germany_national_football_team
Hakoah_Sydney_City_East_FC	isLocatedIn	Sydney
John_Thomas_(footballer_born_1958)	playsFor	West_Bromwich_Albion_F.C.
Michael_Collins_(soccer)	playsFor	Baltimore_Blast_(1980–92)
Tim_Allen	hasWonPrize	Annie_Award
Hal_Robson-Kanu	playsFor	Reading_F.C.
Mark_Kelly_(Irish_footballer)	playsFor	Republic_of_Ireland_national_under-21_football_team
Christos_Patsatzoglou	playsFor	Greece_national_under-21_football_team
Martyn_Corrigan	playsFor	FC_Jokerit
Adílio	playsFor	Friburguense_Atlético_Clube
Anthony_Shandran	playsFor	Blyth_Spartans_A.F.C.
Jan_Rajnoch	playsFor	SC_Xaverov
Miguel_Ángel_Carrilero	playsFor	Xerez_CD
Carlton_Cole	playsFor	England_national_under-20_football_team
Cuauhtémoc_Blanco	playsFor	Club_América
André_Lima_Pedro	playsFor	Clube_de_Regatas_do_Flamengo
Lucky_Idahor	playsFor	Inter_Baku_PIK
Peter_Thomson_(footballer_born_1977)	playsFor	NAC_Breda
Leandro_Rosa_Souza	playsFor	Avaí_Futebol_Clube
Chris_Coleman_(footballer)	playsFor	Manchester_City_F.C.
Cuca_(footballer)	playsFor	Sport_Club_Internacional
Thunder_Bay	isLocatedIn	Ontario
David_Bentley	playsFor	England_national_football_team
Philip_Ifil	playsFor	Tottenham_Hotspur_F.C.
Eugenio_Corini	playsFor	S.S.D._Piacenza_Calcio_1919
Rodrigo_Defendi	playsFor	Cruzeiro_Esporte_Clube
Louis_Nanchoff	playsFor	Cleveland_Force_(1978–88)
Campbell_Banks	playsFor	Sunshine_George_Cross_FC
Dean_Ashton	playsFor	England_national_under-20_football_team
Vadym_Panas	playsFor	FC_Nyva_Ternopil
Miroslav_Kadlec	wasBornIn	Uherské_Hradiště
Gabriele_Paoletti	playsFor	U.S._Arezzo
Kate_Gill	wasBornIn	Auckland
Sunday_Mba	wasBornIn	Aba,_Abia
Mohamed_Gouda	playsFor	Al-Masry_SC
Fernando_Cáceres	playsFor	Córdoba_CF
Davey_Brown	playsFor	New_York_Soccer_Club
Álvaro_Pintos	wasBornIn	Montevideo
Danilo_Soddimo	playsFor	Delfino_Pescara_1936
Blessing_Kaku	playsFor	K.R.C._Genk
Julian_Gray	playsFor	Coventry_City_F.C.
Ufukhan_Bayraktar	playsFor	Denizlispor
Mike_Pollitt	playsFor	Burnley_F.C.
Ibrahim_Maaroufi	playsFor	K.A.S._Eupen
Joël_Cantona	playsFor	Peterborough_United_F.C.
Bulgaria	isLocatedIn	Europe
Baba_Iddi	playsFor	Asante_Kotoko_SC
Mark_Twain	influences	Philip_José_Farmer
Marek_Penksa	playsFor	Stuttgarter_Kickers
Nicky_Hunt	playsFor	Birmingham_City_F.C.
Colin_Brazier_(footballer)	playsFor	Wolverhampton_Wanderers_F.C.
Robertas_Poškus	playsFor	Lithuania_national_football_team
Roberto_Silva	playsFor	Universidad_Católica_del_Ecuador
Jaime_Bragança	wasBornIn	Lisbon
Marinos_Ouzounidis	playsFor	Greece_national_football_team
Volkan_Arslan	playsFor	Adanaspor
Nicolás_Navarro_(Argentine_footballer)	playsFor	Kayserispor
Stephen_Cooke	playsFor	Weymouth_F.C.
Martín_Ligüera	playsFor	Centro_Atlético_Fénix
Gene_Kelly	graduatedFrom	University_of_Pittsburgh
Steven_Joseph-Monrose	playsFor	RC_Lens
Bunny_Larkin	playsFor	Norwich_City_F.C.
Glenn_Helder	playsFor	RBC_Roosendaal
Francisco_Gabriel_Guerrero	playsFor	Argentina_national_under-20_football_team
Nenad_Grozdić	playsFor	FC_Pasching
Mauricio_Pinilla	playsFor	U.S._Città_di_Palermo
Vakhtang_Khvadagiani	playsFor	FC_Ameri_Tbilisi
Andy_Turner_(footballer)	playsFor	Tottenham_Hotspur_F.C.
Rezart_Maho	playsFor	KF_Laçi
Dmitri_Karsakov	playsFor	FC_Nosta_Novotroitsk
Gerardo_García_León	playsFor	CD_Leganés
Neill_Roberts	wasBornIn	Durban
Óscar_Serrano_Rodríguez	playsFor	UE_Figueres
Kheireddine_Zarabi	playsFor	RC_Kouba
Colin_Larkin_(footballer)	playsFor	Wolverhampton_Wanderers_F.C.
Dean_Williams_(footballer)	playsFor	Gateshead_F.C.
Thomas_Rongen	playsFor	Minnesota_Strikers
Anthony_Braizat	playsFor	AS_Cannes
Abdessalam_Benjelloun	playsFor	Widad_Fez
Graham_Moore_(footballer)	playsFor	Wales_national_football_team
Mehdi_Seyed-Salehi	playsFor	Paykan_F.C.
Joseph_Alcazar	playsFor	Olympique_Lillois
Marcus_Steegmann	playsFor	FC_Viktoria_Köln
Sandro_(Spanish_footballer)	playsFor	Málaga_CF
Ólafur_Ingi_Skúlason	playsFor	Helsingborgs_IF
Dave_Martin_(footballer,_born_1985)	playsFor	Millwall_F.C.
Lubomir_Velichkov	playsFor	PFC_Vidima-Rakovski_Sevlievo
João_Paiva	playsFor	C.S._Marítimo_B
Jason_Vandelannoite	playsFor	Sheffield_United_F.C.
Fernando_Sales	playsFor	Real_Valladolid
Ron_Yeats	playsFor	Liverpool_F.C.
David_Córcoles	playsFor	FC_Barcelona_B
C._J._Watson	playsFor	China_national_football_team
Lee_Elam	playsFor	Weymouth_F.C.
André_Luiz_Rodrigues_Lopes	playsFor	AEP_Paphos_F.C.
Steve_O'Shaughnessy_(footballer)	playsFor	Rhyl_F.C.
Paul_Robinson_(footballer,_born_November_1978)	playsFor	Consett_A.F.C.
Matěj_Vydra	playsFor	Udinese_Calcio
Viktor_Onopko	wasBornIn	Luhansk
John_Harkes	playsFor	Derby_County_F.C.
Michael_Ferrante	playsFor	West_Ham_United_F.C.
Nicky_Wroe	playsFor	Shrewsbury_Town_F.C.
Luisinho_Netto	playsFor	Marília_Atlético_Clube
Mohamed_Seguer	playsFor	MC_Saïda
Davis_Curiale	playsFor	Unione_Triestina_2012_S.S.D.
Dobrin_Orlovski	playsFor	PFC_Lokomotiv_Plovdiv
Dany_N'Guessan	playsFor	Boston_United_F.C.
Marius_Skinderis	playsFor	GKS_Bełchatów
Domenic_Mobilio	playsFor	Dundee_F.C.
Scott_Phelan	playsFor	Kidderminster_Harriers_F.C.
Mao_Jianqing	playsFor	China_national_football_team
Ståle_Solbakken	playsFor	HamKam
Kristijan_Polovanec	playsFor	NK_Inter_Zaprešić
Alioune_Touré	playsFor	France_national_under-18_football_team
Ludwig_Wittgenstein	influences	Hilary_Putnam
Andrey_Varankow	playsFor	FC_Metalurh_Zaporizhya
Aleksandr_Shmarko	playsFor	FC_Rostov
Selmir_dos_Santos_Bezerra	playsFor	Vitória_S.C.
Pat_Noonan	playsFor	Columbus_Crew
Ugo_Tognazzi	actedIn	Sunday_Lovers
Pavel_Platonaw	playsFor	FC_Gorodeya
Jimmy_Mulisa	playsFor	K.S.V._Roeselare
Marc_Torrejón	playsFor	Atlético_Malagueño
Hugh_Vallance	wasBornIn	Wolverhampton
Friedrich_Kohlrausch	isCitizenOf	Germany
Sidnei_da_Silva	playsFor	Esporte_Clube_Juventude
Éldis_Fernando_Damasio	playsFor	Oita_Trinita
Chedric_Seedorf	playsFor	SC_Cambuur
Maggie_Smith	actedIn	Oh!_What_a_Lovely_War
Steve_Daley	playsFor	Manchester_City_F.C.
Paulo_Wanchope	playsFor	Málaga_CF
Artsyom_Radzkow	playsFor	Gençlerbirliği_S.K.
Ivan_Dal_Santo	playsFor	FC_Wettingen
Billy_Crook_(American_soccer)	playsFor	Seattle_Sounders_(1994–2008)
David_Gutiérrez_de_Coz	playsFor	Xerez_CD
John_Maisano	playsFor	Marconi_Stallions_FC
John_McCann_(footballer)	playsFor	Scotland_national_football_B_team
Fredrik_Björck	playsFor	IF_Elfsborg
Rodney_Green_(footballer)	playsFor	Durban_United_F.C.
Percy_Olivares	playsFor	Alianza_Atlético
Daniel_Bierofka	playsFor	Bayern_Munich_Junior_Team
O'Hare_International_Airport	isLocatedIn	Chicago
Serdar_Özbayraktar	playsFor	Gaziantep_Büyükşehir_Belediyespor
John_Roberts_(footballer_born_1946)	playsFor	Wales_national_football_team
Aleš_Čeh	wasBornIn	Maribor
Grigol_Chanturia	playsFor	FC_Torpedo_Kutaisi
Neal_Bartlett	playsFor	Newport_County_A.F.C.
Manuel_Neira	playsFor	San_Luis_de_Quillota
Herbert_Banks	wasBornIn	Coventry
Haakon_VII_of_Norway	hasWonPrize	Order_of_the_White_Lion
Dimitrios_Papadopoulos	playsFor	Akratitos_F.C.
Chumbinho	playsFor	Qarabağ_FK
Édouard_Cissé	playsFor	France_national_under-20_football_team
Malky_Mackay	playsFor	Celtic_F.C.
Gláucio_de_Jesus_Carvalho	playsFor	S.B.V._Excelsior
Franck_Moussa	playsFor	Coventry_City_F.C.
Ian_Baird	playsFor	Heart_of_Midlothian_F.C.
Steve_MacLean_(footballer)	playsFor	Scotland_national_under-21_football_team
Kerim_Zengin	playsFor	Akhisar_Belediyespor
Martyn_Margetson	playsFor	Wales_national_under-21_football_team
Youssef_Haraoui	playsFor	Kardemir_D._Ç._Karabükspor
Jaime_Valdés	playsFor	Colo-Colo
Mehmet_Yozgatlı	playsFor	Gençlerbirliği_S.K.
Elvin_Mammadov	playsFor	Inter_Baku_PIK
Jochen_Seitz	playsFor	Viktoria_Aschaffenburg
Tomi_Ameobi	playsFor	FC_Edmonton
David_Johnson_(footballer_born_1951)	playsFor	England_national_football_team
Ânderson_Lima	playsFor	Associação_Desportiva_São_Caetano
Romulus_Buia	playsFor	FCM_Baia_Mare
José_Enrique_(footballer)	playsFor	Liverpool_F.C.
Manuel_Castellano	playsFor	UD_Almería_B
Jane_Fonda	wasBornIn	New_York_City
Rob_Alflen	playsFor	SC_Cambuur
Edmur_Ribeiro	playsFor	Vitória_S.C.
Marc_Pugh	playsFor	Burnley_F.C.
Søren_Lerby	playsFor	FC_Bayern_Munich
Mikheil_Khutsishvili	playsFor	FC_Merani_Tbilisi
Oleksandr_Aliyev	playsFor	FC_Metalurh_Zaporizhya
Davide_Chiumiento	playsFor	Villarreal_CF
Paul_Butler_(footballer_born_1972)	playsFor	Wolverhampton_Wanderers_F.C.
Aleš_Mejač	playsFor	Slovenia_national_football_team
Nicola_Amoruso	playsFor	A.C._Siena
Jonathan_Brown_(Welsh_footballer)	wasBornIn	Bridgend
Fabio_Paratici	playsFor	U.S._Città_di_Palermo
Mark_Jackson_(footballer)	playsFor	England_national_under-20_football_team
Masahiro_Endo	wasBornIn	Tokyo
Harrie_Gommans	playsFor	De_Graafschap
Francis_Kioyo	wasBornIn	Yaoundé
Darren_Bradshaw	playsFor	Rushden_&_Diamonds_F.C.
Mehmet_Durakovic	playsFor	Australia_national_association_football_team
Thomas_F._Bayard,_Jr.	playsFor	Sporting_Clube_de_Portugal
Kevin_Harmse	playsFor	Tromsø_IL
Jojó_(footballer_born_1970)	playsFor	Bonnyrigg_White_Eagles_FC
Ömer_Rıza	playsFor	Denizlispor
Josh_Gowling	playsFor	Kidderminster_Harriers_F.C.
Nicolas_Beney	playsFor	FC_Wil_1900
Edson_Henrique_da_Silva	playsFor	C.F._Os_Belenenses
Marko_Kolsi	playsFor	FC_Eindhoven
Vladimir_Gabulov	playsFor	Russia_national_football_team
Paul_Walsh	playsFor	Liverpool_F.C.
Ronnie_Wallwork	playsFor	Stockport_County_F.C.
Alan_Taylor_(footballer,_born_1953)	playsFor	Vancouver_Whitecaps_(1974–84)
Josef_Kaufman	wasBornIn	Pardubice
Beto_(Portuguese_footballer_born_1982)	playsFor	Sporting_Clube_de_Portugal
Robin_Hulbert	playsFor	Barrow_A.F.C.
Toafik_Salhi	playsFor	FC_Sevastopol
Charlie_Wilson_(footballer_born_1905)	playsFor	West_Bromwich_Albion_F.C.
Francesco_Galeoto	playsFor	A.C.R._Messina
Trevor_Hockey	playsFor	Athlone_Town_A.F.C.
Kevin_Francis_(footballer)	playsFor	Exeter_City_F.C.
Erkan_Sulejmani	playsFor	Trabzonspor
Jaycee_John_Okwunwanne	playsFor	R.E._Mouscron
Evangelos_Nastos	playsFor	Kalamata_F.C.
Adin_Brown	playsFor	Tampa_Bay_Mutiny
Arturo_Albarrán	playsFor	C.D._Universidad_de_El_Salvador
Pim_Balkestein	playsFor	AFC_Wimbledon
William_Henry_Bragg	isCitizenOf	Australia
Marco_Gómez	playsFor	Querétaro_F.C.
Marcelo_Tejera	playsFor	Millonarios_Fútbol_Club
Simo_Valakari	playsFor	Derby_County_F.C.
Franz_Gerber	playsFor	Wuppertaler_SV
Billy_Hodgson	wasBornIn	Glasgow
Rodrigo_Defendi	playsFor	Esporte_Clube_Vitória
Urmas_Hepner	playsFor	FC_Flora_Tallinn
Sergio_Marcon	playsFor	U.C._Sampdoria
Oleh_Matveyev	playsFor	FC_Dynamo_Kyiv
Matías_Aguirregaray	wasBornIn	Porto_Alegre
Davide_Matteini	playsFor	U.S._Città_di_Palermo
Veldin_Karić	playsFor	Croatia_national_football_team
Shlomi_Edri	playsFor	Bnei_Sakhnin_F.C.
Franck_Manga_Guela	playsFor	Anagennisi_Karditsa_F.C.
Jonathan_Bru	playsFor	U.D._Oliveirense
Adrián_Romero	wasBornIn	Montevideo
Miguel_Lopes	playsFor	F.C._Alverca
Johann_Wolfgang_von_Goethe	influences	Ludwig_Wittgenstein
Francesco_Baldini	playsFor	A.S._Lucchese_Libertas_1905
Willie_Johnston	playsFor	Hakoah_Sydney_City_East_FC
Dino_Baggio	playsFor	Inter_Milan
Lars_Hirschfeld	playsFor	FC_Energie_Cottbus
Maxence_Flachez	playsFor	FC_Martigues
Emerson_de_Andrade_Santos	playsFor	Real_Murcia
Mia_Farrow	wasBornIn	Los_Angeles
Stefan_Giglio	playsFor	Valletta_F.C.
Laurent_Schwartz	graduatedFrom	École_Normale_Supérieure
Christian_Alder	playsFor	Anorthosis_Famagusta_FC
Simone_Inzaghi	playsFor	S.S.D._Piacenza_Calcio_1919
Willie_Johnston	playsFor	Heart_of_Midlothian_F.C.
Luis_Barbat	wasBornIn	Montevideo
Matías_Escobar	playsFor	Doxa_Katokopias_F.C.
Pierre_Aubameyang	playsFor	Stade_Lavallois
Graeme_Smith_(footballer_born_1982)	playsFor	Kilmarnock_F.C.
Nicaragua	exports	wordnet_coffee_bean_107929351
Jimmy_Smailes	playsFor	Stockport_County_F.C.
José_Burtovoy	playsFor	Club_Atlético_Colón
William_Goldman	graduatedFrom	Columbia_University
Abraham_Kumedor	playsFor	F.C._Crotone
Jimmy_Smith_(footballer_born_1902)	playsFor	Bristol_Rovers_F.C.
Jamie_Gosling	playsFor	Weymouth_F.C.
Dave_Rogers_(footballer)	playsFor	Portadown_F.C.
Elizeu_Ferreira_Marciano	playsFor	Rio_Branco_Atlético_Clube
Paul_Telfer_(footballer)	playsFor	Scotland_national_football_B_team
Ted_Purdon	playsFor	Bristol_Rovers_F.C.
Josip_Tadić	playsFor	HNK_Rijeka
Adem_Dursun	playsFor	Boluspor
Danijel_Ljuboja	playsFor	Grenoble_Foot_38
Robert_Ukrop	playsFor	Dayton_Dynamo
Piotr_Włodarczyk	playsFor	Ruch_Chorzów
Sunday_Rotimi	playsFor	Hapoel_Rishon_LeZion_F.C.
Benjamin_Baltes	playsFor	Wuppertaler_SV
Tomi_Saarelma	playsFor	FC_KooTeePee
Fabian_Ernst	playsFor	Hannover_96
İlyas_Kahraman	playsFor	Adanaspor
Leandro_de_Deus_Santos	playsFor	Toledo_Colônia_Work
Miloš_Nikolić	playsFor	FK_Jagodina
Rildo_da_Costa_Menezes	playsFor	Sport_Club_do_Recife
Gordon_Cowans	playsFor	Sheffield_United_F.C.
Tabaré_Silva	playsFor	Uruguay_national_football_team
Paíto	wasBornIn	Maputo
Cristóvão_da_Silva_Ramos	playsFor	F.C._Penafiel
Paul_Krumpe	playsFor	United_States_men's_national_soccer_team
Genar_Andrinúa	playsFor	Spain_national_under-23_football_team
Daniele_Mannini	playsFor	U.C._Sampdoria
Wallyson	playsFor	Clube_Atlético_Paranaense
Sergio_Ballesteros	playsFor	Villarreal_CF
Bruno_Grassi	playsFor	Sport_Club_Internacional
Klemen_Lavrič	playsFor	HNK_Hajduk_Split
Zajko_Zeba	playsFor	NK_Brotnjo
Martin_Taylor_(footballer,_born_1966)	playsFor	Telford_United_F.C.
Hüseyin_Yoğurtçu	playsFor	Mersin_İdmanyurdu_SK
Clément_Halet	playsFor	SC_Preußen_Münster
Ivo_Damas	playsFor	Sporting_Clube_de_Portugal
Kévin_Gameiro	playsFor	France_national_under-18_football_team
Christian_McClean	playsFor	Bristol_Rovers_F.C.
Cliff_Holton	playsFor	Arsenal_F.C.
D.C._United	isLocatedIn	Washington,_D.C.
Desmond_Tachie	playsFor	AaB_Fodbold
Henry_David_Thoreau	influences	E._O._Wilson
Jarl_André_Storbæk	playsFor	HamKam
Thando_Mngomeni	wasBornIn	Cape_Town
Airton_Ribeiro_Santos	playsFor	Sport_Club_Internacional
Robbie_Ryan	playsFor	Bristol_Rovers_F.C.
Ramon_Menezes_Hubner	playsFor	Cruzeiro_Esporte_Clube
Alan_Whittle	playsFor	Sheffield_United_F.C.
Kevin_Oris	playsFor	K.S.V._Roeselare
Orlin_Orlinov	playsFor	PFC_Spartak_Varna
Fredy_Bareiro	playsFor	Club_Nacional
Marek_Leśniak	playsFor	Poland_national_football_team
Joseph_Yobo	playsFor	Norwich_City_F.C.
Mariano_Barbosa	wasBornIn	Lanús
Ľubomír_Guldan	wasBornIn	Banská_Bystrica
Ioannis_Okkas	playsFor	AC_Omonia
Arkadiusz_Kubik	playsFor	K.R.C._Zuid-West-Vlaanderen
James_Stansfield	playsFor	Halifax_Town_A.F.C.
Serhat_Akın	playsFor	R.S.C._Anderlecht
Andrey_Zhelyazkov	playsFor	Bulgaria_national_football_team
Alan_Biley	playsFor	Brighton_&_Hove_Albion_F.C.
O._W._Fischer	playsFor	Coventry_City_F.C.
Karim_El_Mourabet	playsFor	France_national_under-21_football_team
Jimmy_Smailes	playsFor	Tottenham_Hotspur_F.C.
Asa_Charlton	playsFor	Kidderminster_Harriers_F.C.
Klodian_Duro	playsFor	KF_Elbasani
Fabian_Ernst	playsFor	Kasımpaşa_Spor_Kulübü
Billel_Dziri	playsFor	NA_Hussein_Dey
Robert_Reilly_(footballer)	playsFor	Airdrieonians_F.C._(1878)
Jules_Verne	influences	Arthur_Rimbaud
James_Tomkins_(footballer)	playsFor	West_Ham_United_F.C.
Kim_Chang-hoon	playsFor	South_Korea_national_under-23_football_team
Willie_Wallace	playsFor	Crystal_Palace_F.C.
Belize	exports	wordnet_sugar_107859284
Elvis_Comrie	wasBornIn	Bristol
Rob_Witschge	wasBornIn	Amsterdam
Don_Heath	playsFor	Oldham_Athletic_A.F.C.
Marián_Dirnbach	wasBornIn	Bratislava
Massimo_Oddo	playsFor	FC_Bayern_Munich
Arnhem	isLocatedIn	Gelderland
Christopher_Kanu	playsFor	Dolphins_F.C._(Port_Harcourt)
Graeme_Revell	wasBornIn	Auckland
Richard_Garcia	playsFor	Australia_national_under-23_association_football_team
Martín_Bonjour	playsFor	Vancouver_Whitecaps_FC
Craig_Forsyth	playsFor	Derby_County_F.C.
David_Giles_(footballer)	wasBornIn	Cardiff
Adolf_Scherer	playsFor	Czechoslovakia_national_football_team
Lionel_Messi	isCitizenOf	Argentina
Răzvan_Cociș	playsFor	Al_Nassr_FC
Mike_Hellawell	playsFor	Peterborough_United_F.C.
Eduard_Cristian_Zimmermann	playsFor	CS_Otopeni
Thomas_Rongen	playsFor	Los_Angeles_Aztecs
Samuel_Holmén	playsFor	IF_Elfsborg
Vedran_Runje	playsFor	HNK_Hajduk_Split
Rodolfo_Fischer	playsFor	Esporte_Clube_Vitória
Abdelkader_Ferhaoui	playsFor	AS_Cannes
Hebert_Revetria	playsFor	Cobreloa
Emil_Ninu	playsFor	FC_Universitatea_Cluj
Valon_Behrami	playsFor	ACF_Fiorentina
Muriqui_(footballer)	playsFor	Clube_Atlético_Mineiro
Darryl_Flahavan	playsFor	Oldham_Athletic_A.F.C.
Eduardo_Marques	playsFor	Sport_Club_do_Recife
John_Coleman_(footballer_born_1962)	playsFor	Rhyl_F.C.
Ugo_Tognazzi	actedIn	Io_la_conoscevo_bene
Pablo_Gaglianone	playsFor	Defensor_Sporting
Cees_Paauwe	playsFor	S.B.V._Excelsior
Shaun_McSkimming	playsFor	Kilmarnock_F.C.
Oscar_Echeverry	playsFor	Atlético_Nacional
Adrián_Berbia	wasBornIn	Montevideo
Osvaldo_Escudero	playsFor	Chaco_For_Ever
Haile_Selassie	hasWonPrize	Order_of_the_White_Eagle_(Poland)
Marius_Mitu	playsFor	R._White_Daring_Molenbeek
Billy_Thompson_(soccer)	playsFor	Pau_FC
Ryan_Harding	playsFor	Alloa_Athletic_F.C.
Éber_Luís_Cucchi	playsFor	Veranópolis_Esporte_Clube_Recreativo_e_Cultural
Francis_Chansa	playsFor	Durban_United_F.C.
András_Simon	playsFor	Liverpool_F.C.
Demetris_Leoni	playsFor	Anorthosis_Famagusta_FC
Anthony_Shandran	playsFor	York_City_F.C.
Marcelo_Luis_de_Almeida_Carmo	playsFor	Betim_Esporte_Clube
Emil_Kostadinov	playsFor	Bulgaria_national_football_team
Andrejs_Rubins	wasBornIn	Riga
Maximiliano_Blanco	playsFor	Sportivo_Italiano
Giovanni_Hernández	playsFor	Junior_F.C.
Rod_Brown	playsFor	Club_América
Tihamér_Lukács	playsFor	BFC_Siófok
Leonel_Rocco	playsFor	Independiente_Medellín
Mario_Gori	playsFor	D.C._United
Ivan_Dragičević	playsFor	FK_BASK
Bernd_Patzke	wasBornIn	Berlin
Felipe_Caicedo	playsFor	FC_Basel
Ivan_Pelizzoli	playsFor	U.C._AlbinoLeffe
Jason_Norville	playsFor	Wealdstone_F.C.
Eduardo_Delani	wasBornIn	Brasília
Luis_Aguiar	playsFor	C.F._Estrela_da_Amadora
2012_Romanian_protests	isLocatedIn	Strasbourg
Roberto_Saporiti	playsFor	Clube_Atlético_Mineiro
Nilton_Fernandes	playsFor	Gil_Vicente_F.C.
Jim_Beglin	playsFor	Republic_of_Ireland_national_under-21_football_team
Serhiy_Husyev	playsFor	FC_SOYUZ-Gazprom_Izhevsk
Bruno_Lança_Andrade	playsFor	Esporte_Clube_Juventude
Azer_Mammadov	playsFor	Azerbaijan_national_football_team
Roger_Van_Gool	playsFor	Nîmes_Olympique
Kevin_MacDonald_(footballer)	playsFor	Coventry_City_F.C.
Winston_White	playsFor	Bury_F.C.
Euzebiusz_Smolarek	playsFor	Racing_de_Santander
Radosław_Jasiński	playsFor	Paniliakos_F.C.
Vadym_Deonas	playsFor	FC_Borysfen_Boryspil
Mor_Dahan	playsFor	Hapoel_Ironi_Kiryat_Shmona_F.C.
Henry_Paul	playsFor	Gloucester_Rugby
Alessandro_Beti_Rosa	playsFor	Sport_Club_do_Recife
Harrison_Otálvaro	playsFor	FC_Dynamo_Kyiv
Kevin_James_(Scottish_footballer)	playsFor	Falkirk_F.C.
Alexandros_Tzorvas	playsFor	Greece_national_under-21_football_team
Peter_Bulmer	playsFor	Rhyl_F.C.
Charles_Sanders_Peirce	influences	Umberto_Eco
Michel_Vonk	playsFor	Manchester_City_F.C.
Olympique_de_Marseille	isLocatedIn	Marseille
Sergio_Castaño_Ortega	playsFor	Pontevedra_CF
Marcus_Stewart	playsFor	Bristol_Rovers_F.C.
Maciej_Scherfchen	playsFor	Ruch_Chorzów
Stijn_Vreven	playsFor	FC_Utrecht
Kevin_Cooper_(footballer)	playsFor	Wimbledon_F.C.
Chris_Humphrey	playsFor	Shrewsbury_Town_F.C.
Abraham_Kumedor	playsFor	Inter_Milan
Ali_Al-Habsi	playsFor	Lyn_Fotball
Steve_Shak	playsFor	Minnesota_Thunder
Dick_Rowley	playsFor	Tottenham_Hotspur_F.C.
Carlos_Gamarra	playsFor	Sport_Club_Internacional
Bruno_da_Silva_Barbosa	playsFor	Grêmio_Catanduvense_de_Futebol
Claudio_Marangoni	wasBornIn	Rosario,_Santa_Fe
Richard_Dryden	playsFor	Exeter_City_F.C.
Scott_Cuthbert	playsFor	Livingston_F.C.
Lior_Asulin	playsFor	Hapoel_Rishon_LeZion_F.C.
Edimar_Fraga	playsFor	Betim_Esporte_Clube
Trevor_Molloy	playsFor	Glenavon_F.C.
Aleksey_Korol	playsFor	Kalamazoo_Kingdom
Robert_Neagoe	playsFor	ACF_Gloria_Bistrița
Horacio_Raúl_Baldessari	playsFor	Sporting_Cristal
Óscar_Díaz_González	playsFor	AD_Alcorcón
Sean_Fraser_(Jamaican_footballer)	playsFor	North_East_Stars_F.C.
Juan_Toja	playsFor	New_England_Revolution
Ángel_Ortiz	playsFor	Club_Libertad
Enílton	playsFor	Esporte_Clube_Juventude
Jasur_Hasanov	playsFor	Lokomotiv_Tashkent_FK
John_Coady	playsFor	Drogheda_United_F.C.
Sérgio_Pinto_(footballer_born_1980)	playsFor	Hannover_96
Olaf_Lindenbergh	playsFor	De_Graafschap
Eurico_Gomes	playsFor	Sporting_Clube_de_Portugal
Arthur_Schopenhauer	influences	Joaquim_Maria_Machado_de_Assis
Éric_Deloumeaux	playsFor	Livingston_F.C.
Justo_Ruiz	playsFor	C.F._União
Ruberth_Morán	playsFor	Atlético_Bucaramanga
Saudi_detainees_at_Guantanamo_Bay	playsFor	Pau_FC
César_Carranza	playsFor	Colo-Colo
Efe_Ambrose	playsFor	Nigeria_national_under-20_football_team
Gary_Richards_(footballer)	playsFor	Lincoln_City_F.C.
Ely_Thadeu	playsFor	Guarani_Esporte_Clube_(MG)
Stefan_Ishizaki	playsFor	IF_Elfsborg
Billy_Gonsalves	playsFor	Fall_River_Marksmen
Nikola_Pokrivač	playsFor	Croatia_national_football_team
Arthur_Gómez	playsFor	Henan_Jianye_F.C.
Shaun_Harrad	playsFor	Northampton_Town_F.C.
John_McGinlay	playsFor	Nairn_County_F.C.
Abdul-Wahab_Abu_Al-Hail	playsFor	Talaba_SC
Alexandro_Álvarez	playsFor	Monarcas_Morelia
Dmitri_Sychev	playsFor	Olympique_de_Marseille
Alex_Emenike	playsFor	VfB_Stuttgart_II
Rudolf_Brunnenmeier	wasBornIn	Munich
Noam_Chomsky	graduatedFrom	University_of_Pennsylvania
Javi_Moreno	playsFor	Córdoba_CF
Martín_Cardetti	playsFor	UD_Salamanca
Eric_Nixon	playsFor	Wigan_Athletic_F.C.
Kanga_Akalé	playsFor	RC_Lens
Nikola_Petković	playsFor	FK_Radnički_Pirot
Rafael_Márquez_Lugo	playsFor	Club_América
Graham_Mitchell_(English_footballer)	playsFor	Cowdenbeath_F.C.
Stephan_Schmidt_(footballer)	playsFor	Hertha_Zehlendorf
Carlos_Asprilla	playsFor	Deportes_La_Serena
Hayden_Foxe	playsFor	Australia_national_under-23_association_football_team
Edward_Plunkett,_18th_Baron_of_Dunsany	influences	Arthur_C._Clarke
Adrian_Neaga	playsFor	FC_Argeș_Pitești
Steven_Fletcher_(footballer)	playsFor	Wolverhampton_Wanderers_F.C.
Andy_McLaren	playsFor	Dundee_F.C.
Andranik_Eskandarian	wasBornIn	Tehran
Robbie_Dunn	playsFor	Australia_national_association_football_team
Dean_Holdsworth	playsFor	Wimbledon_F.C.
Waldir_Lucas_Pereira	playsFor	Duque_de_Caxias_Futebol_Clube
Mark_Aizlewood	playsFor	Wales_national_under-21_football_team
Roberto_Polo	playsFor	Cúcuta_Deportivo
Francisco_Antonio_Pavón	playsFor	C.D.S._Vida
Craig_Easton	playsFor	Swindon_Town_F.C.
Geufer	playsFor	Esporte_Clube_Juventude
Mohamed_Kallon	playsFor	Vicenza_Calcio
Dominic_Green_(footballer)	playsFor	Rushden_&_Diamonds_F.C.
Brian_Lloyd	playsFor	Wales_national_football_team
Gia_Guruli	playsFor	GKS_Katowice
Vítor_Valente	playsFor	Atlético_Clube_de_Portugal
Emiliano_Viviano	playsFor	Italy_national_under-20_football_team
Alex_Wilkinson	playsFor	Australia_national_under-20_association_football_team
Moumouni_Dagano	playsFor	Burkina_Faso_national_football_team
Everaldo_Batista	playsFor	Sport_Club_do_Recife
Martin_Petrov	playsFor	PFC_CSKA_Sofia
Ken_DeMange	playsFor	Home_Farm_F.C.
Kenneth_Brylle_Larsen	playsFor	R.S.C._Anderlecht
Piotr_Świerczewski	playsFor	Olympique_de_Marseille
Regis_Pitbull	playsFor	Ceará_Sporting_Club
Scott_Dann	playsFor	Coventry_City_F.C.
Akihiro_Ienaga	playsFor	Oita_Trinita
Gustavo_Biscayzacú	playsFor	Defensor_Sporting
Filipe_Azevedo	playsFor	F.C._Alverca
Jean_de_Lattre_de_Tassigny	hasWonPrize	Order_of_the_White_Lion
Steve_Mildenhall	playsFor	Bristol_Rovers_F.C.
Hamisi_Amani-Dove	playsFor	FC_Dallas
Yangtze_River_Delta	isLocatedIn	Nanjing
Branko_Karačić	wasBornIn	Vinkovci
Julie_Andrews	hasWonPrize	Donaldson_Awards
Kevin_Schindler	playsFor	Germany_national_youth_football_team
Zezinando	playsFor	Atlético_Clube_de_Portugal
Cihan_Yılmaz	playsFor	SV_Wehen_Wiesbaden
Sergio_Volpi	playsFor	Reggina_Calcio
Farès_Bousdira	playsFor	AS_Béziers_Hérault_(football)
Paul_Barron	playsFor	Crystal_Palace_F.C.
Siramana_Dembélé	wasBornIn	Paris
Jerzy_Brzęczek	playsFor	Poland_national_football_team
Ármann_Smári_Björnsson	playsFor	Iceland_national_under-21_football_team
Ivan_Perišić	playsFor	K.S.V._Roeselare
Marvin_Robinson	playsFor	Stockport_County_F.C.
Billy_Davies	playsFor	Motherwell_F.C.
Dariusz_Kubicki	playsFor	Stal_Mielec
Cary_Grant	wasBornIn	Bristol
Roman_Wallner	playsFor	Hannover_96
Chevy_Chase	influences	Tim_Allen
Medical_Park_Antalyaspor	isLocatedIn	Antalya
Vanja_Grubač	playsFor	Pierikos_F.C.
Emil_Kostadinov	playsFor	F.C._Porto
Laurens_ten_Heuvel	playsFor	SC_Telstar
Eoin_Hand	playsFor	Drumcondra_F.C.
Ciriaco_Sforza	playsFor	Switzerland_national_football_team
Paul_Kohler	playsFor	South_Coast_Wolves_FC
Anthony_Ormerod	playsFor	Bury_F.C.
Marino_Biliškov	playsFor	VfL_Wolfsburg
Mick_Morris_(footballer)	playsFor	Stafford_Rangers_F.C.
Yssouf_Koné	playsFor	CFR_Cluj
Henk_Vos	playsFor	Feyenoord
Cristian_Pasquato	playsFor	Modena_F.C.
Cristiano_Zanetti	playsFor	Inter_Milan
Sammy_Youssouf	playsFor	Vejle_Boldklub
Pablo_Tiscornia	playsFor	Juventud_de_Las_Piedras
Ryan_Robinson	playsFor	Evesham_United_F.C.
Luciano_Goux	playsFor	Defensa_y_Justicia
Rene_Gilmartin	playsFor	Republic_of_Ireland_national_under-21_football_team
Jimmy_Kébé	playsFor	Reading_F.C.
Rosario_Dawson	wasBornIn	New_York_City
Marek_Leśniak	playsFor	Pogoń_Szczecin
Ran_Kadoch	playsFor	Hapoel_Ra'anana_A.F.C.
Logan_Tom	playsFor	Voléro_Zürich
Imre_Varadi	playsFor	Everton_F.C.
Felix_Halfon	playsFor	Israel_national_under-21_football_team
Louie_Soares	playsFor	Aldershot_Town_F.C.
Tote_(footballer)	playsFor	Real_Madrid_C.F.
Anatolie_Doroș	playsFor	Korona_Kielce
Mike_Walsh_(footballer)	playsFor	Manchester_City_F.C.
Denys_Stoyan	playsFor	FC_Borysfen_Boryspil
Nontapan_Jeansatawong	playsFor	Muangthong_United_F.C.
David_Burnside_(footballer)	playsFor	Crystal_Palace_F.C.
Marcel_Reichwein	playsFor	Wuppertaler_SV
Roberto_Colautti	playsFor	Anorthosis_Famagusta_FC
Steve_Banks	playsFor	Wimbledon_F.C.
Julio_Pablo_Rodríguez	playsFor	Uruguay_national_football_team
Finn_Laudrup	playsFor	Denmark_national_football_team
Andy_Impey	playsFor	West_Ham_United_F.C.
Francesco_Benussi	playsFor	U.S._Città_di_Palermo
Sam_Gargan	playsFor	Whitehawk_F.C.
Lee_Fowler	playsFor	Burton_Albion_F.C.
David_Preece_(footballer_born_1963)	playsFor	England_national_football_B_team
Valentino_Lai	playsFor	U.S._Città_di_Palermo
Mohamed_Kanu	playsFor	Cercle_Brugge_K.S.V.
Disney_Channel_(Latin_America)	isLocatedIn	Dominican_Republic
Dimitar_Iliev_(footballer_born_1988)	playsFor	PFC_Montana
Wilson_Surubim	playsFor	Ypiranga_Futebol_Clube
Billy_Hughes_(footballer_born_1960)	playsFor	Crystal_Palace_F.C.
Fred_Kennedy	playsFor	Reading_F.C.
Brian_Laudrup	playsFor	Denmark_national_under-17_football_team
Abdul_Kader_Keïta	playsFor	Olympique_Lyonnais
Harry_Curran	wasBornIn	Glasgow
César_Peixoto	playsFor	Gil_Vicente_F.C.
Montbéliard	isLocatedIn	France
Carlos_Zegarra	playsFor	Sporting_Cristal
Abdulla_Baba_Fatadi	playsFor	Al-Qadisiyah_FC
Mindaugas_Malinauskas	wasBornIn	Vilnius
Bovar_Karim	playsFor	SC_Cambuur
Micah_Richards	playsFor	England_national_under-19_football_team
Paulius_Grybauskas	playsFor	Lithuania_national_football_team
Luigi_Martinelli	playsFor	F.C._AlzanoCene_1909
Michal_Kolomazník	playsFor	SSV_Jahn_Regensburg
Diego_Trotta	playsFor	S.C._Salgueiros
Gavin_Wilkinson	playsFor	Portland_Timbers_(2001–10)
Oscar_Rossi	playsFor	Sporting_Cristal
H._G._Wells	influences	John_Fowles
Andrejs_Rubins	playsFor	Qarabağ_FK
Daryl_Clare	playsFor	Boston_United_F.C.
Walter_Paz	playsFor	Gil_Vicente_F.C.
Peter_Till	playsFor	Boston_United_F.C.
Guillaume_Hoarau	playsFor	Le_Havre_AC
Alessandro_Lucarelli	playsFor	A.C._Siena
Andrew_McCulloch_(footballer)	playsFor	Cardiff_City_F.C.
Alessandro_Diamanti	playsFor	ACF_Fiorentina
Erik_Setiawan	playsFor	Arema_Cronus_F.C.
Gary_Bollan	playsFor	Livingston_F.C.
Pius_Ndiefi	playsFor	Al-Gharafa_Sports_Club
Josiel_da_Rocha	playsFor	Esporte_Clube_Pelotas
David_Carney	wasBornIn	Sydney
Paulo_Roberto_Junges	playsFor	Associação_Atlética_Internacional_(Limeira)
Thomas_Kläsener	playsFor	FC_Schalke_04_II
Ernie_Campbell	playsFor	Marconi_Stallions_FC
Nicolas_Dikoumé	wasBornIn	Yaoundé
Leandro_de_Oliveira_da_Luz	playsFor	Associação_Desportiva_Cabofriense
Brent_Rahim	playsFor	Falkirk_F.C.
Gary_Walsh	playsFor	Airdrieonians_F.C._(1878)
Giovanni_Bia	playsFor	Cosenza_Calcio
Thomas_Hobbes	influences	Jeremy_Bentham
Alan_Gow	playsFor	Scotland_national_football_B_team
Mehmet_Aurélio	playsFor	Trabzonspor
André_Luiz_Moreira	playsFor	Cruzeiro_Esporte_Clube
Jaka_Štromajer	playsFor	FC_Koper
Ab_Fafié	playsFor	Feyenoord
Timo_Achenbach	playsFor	SpVgg_Greuther_Fürth
Mohammad_Mohammadi	playsFor	Bargh_Shiraz_F.C.
Franck_Queudrue	playsFor	Red_Star_F.C.
Igor_Rakočević	hasWonPrize	All-Euroleague_Team
Saša_Simonović	playsFor	FK_Voždovac
Alceu	playsFor	Marília_Atlético_Clube
Marko_Mlinarić	playsFor	HNK_Segesta
Erison_Carlos_dos_Santos_Silva	playsFor	Cerezo_Osaka
Joe_Ledley	wasBornIn	Cardiff
Jonathan_Woodgate	playsFor	Real_Madrid_C.F.
Mark_Gardiner	playsFor	Crewe_Alexandra_F.C.
Nicklas_Bendtner	playsFor	Arsenal_F.C._Academy
Adam_Lockwood	playsFor	Guiseley_A.F.C.
Billy_Whitehurst	playsFor	Goole_A.F.C.
Pedro_Geromel	playsFor	Vitória_S.C.
Dante_Alighieri	influences	Alexander_Pushkin
Nestor_Subiat	playsFor	Switzerland_national_football_team
Nenad_Gračan	playsFor	Real_Oviedo
Black_Sea	isLocatedIn	Georgia_(country)
Pablo_Guiñazú	playsFor	Argentina_national_football_team
Jimmy_Dunne	playsFor	New_Brighton_A.F.C.
Andy_Ferguson	playsFor	Alloa_Athletic_F.C.
Pavel_Ryzhevski	playsFor	FC_Molodechno-2013
Peter_Thomson_(footballer_born_1977)	playsFor	Altrincham_F.C.
Nikolai_Latysh	playsFor	FC_Arsenal_Tula
Idriss_Ech-Chergui	playsFor	Aviron_Bayonnais_FC
Ronaldo	hasWonPrize	Pichichi_Trophy
Tim_Sills	playsFor	Aldershot_Town_F.C.
Lakhdar_Adjali	playsFor	NA_Hussein_Dey
University_of_Coimbra	isLocatedIn	Centro_Region,_Portugal
Leandro_Carrijó	playsFor	Associação_Portuguesa_de_Desportos
Rob_Matthaei	playsFor	Motherwell_F.C.
James_H._Kasler	hasWonPrize	Legion_of_Merit
Kieran_O'Regan	playsFor	Swindon_Town_F.C.
Mark_Smyth	playsFor	Gap_Connah's_Quay_F.C.
Edmundo_Alves_de_Souza_Neto	playsFor	ACF_Fiorentina
Jackson_(footballer_born_1973)	playsFor	Paulista_Futebol_Clube
HC_Pardubice	isLocatedIn	Czech_Republic
Juan_Martín_Parodi	playsFor	Zacatepec
Anton_Malatinský	playsFor	FC_Spartak_Trnava
Carl_Veart	playsFor	Adelaide_City_FC
Randy_Garber	playsFor	Los_Angeles_Aztecs
Fernando_Pessoa	wasBornIn	Lisbon
Madonna_(entertainer)	actedIn	Four_Rooms
Frankie_Artus	playsFor	Exeter_City_F.C.
Carl_Fletcher_(Canadian_soccer)	playsFor	Canada_men's_national_soccer_team
Yevgeni_Kuznetsov_(footballer_born_1983)	playsFor	FC_Khimki
Rubén_Darío_Gigena	playsFor	LDU_Portoviejo
Ray_Wallace_(footballer)	playsFor	Airdrieonians_F.C._(1878)
Aleksandar_Stoimirović	playsFor	FK_Hajduk_Kula
Valerio_Virga	playsFor	S.S._Virtus_Lanciano_1924
Billy_Celeski	playsFor	Australia_national_under-20_association_football_team
Tommy_Wright_(footballer,_born_1984)	playsFor	England_national_under-20_football_team
Rodrigo_Tabata	playsFor	Ferroviário_Atlético_Clube_(CE)
Samassi_Abou	playsFor	Olympique_Lyonnais
Carlo_Ferrario	playsFor	A.S._Varese_1910
Bruno_Ferraz_das_Neves	playsFor	Mogi_Mirim_Esporte_Clube
John_Beresford_(footballer)	playsFor	Ossett_Town_F.C.
Michael_Caine	actedIn	A_Bridge_Too_Far_(film)
Almir_Kayumov	playsFor	FC_SKVO_Rostov-on-Don
Paul_Price_(footballer)	playsFor	Tottenham_Hotspur_F.C.
Anton_Mukhovykov	playsFor	FC_Tytan_Armyansk
Miki_Roqué	playsFor	Oldham_Athletic_A.F.C.
José_Padrón	playsFor	Red_Star_F.C.
Kristian_Sørli	playsFor	IK_Start
Neil_Wood	playsFor	Coventry_City_F.C.
Ali_Bendebka	playsFor	NA_Hussein_Dey
William_Shakespeare	influences	Arthur_Schopenhauer
Alessio_Sarti	playsFor	A.C._Prato
Ney_Fabiano	playsFor	Bangkok_Glass_F.C.
Micah_Richards	playsFor	Manchester_City_F.C.
Gabriel_Batistuta	playsFor	Inter_Milan
Giambattista_Vico	influences	Edward_Said
Ray_Wilkins	playsFor	Millwall_F.C.
David_Kinnear	playsFor	Scottish_Football_League_XI
Jan_Šimák	playsFor	SK_Dynamo_České_Budějovice
Jakub_Sylvestr	playsFor	GNK_Dinamo_Zagreb
Viktor_Dvirnyk	playsFor	FC_Dynamo_Kyiv
Kirk_Broadfoot	playsFor	St._Mirren_F.C.
Serhiy_Tkachenko	wasBornIn	Odessa
Lee_Jenkins	playsFor	Kidderminster_Harriers_F.C.
Alessandro_Pistone	playsFor	A.S.D._SolbiaSommese_Calcio
First_French_Empire	hasOfficialLanguage	French_language
Dean_West	playsFor	Lincoln_City_F.C.
Matthew_Bloomer	playsFor	Lincoln_City_F.C.
Cleonésio_Carlos_da_Silva	playsFor	Al-Khor_Sports_Club
David_Pizarro	playsFor	ACF_Fiorentina
Paul_Walsh	playsFor	Manchester_City_F.C.
Jim_Gannon	playsFor	Crewe_Alexandra_F.C.
Thomas_Ritter	playsFor	Dynamo_Dresden
Rafael_Carlos_Santacruz	playsFor	Valencia_CF_Mestalla
Aldo_Olcese	playsFor	Peru_national_football_team
Lee_Morris_(footballer)	playsFor	Eastwood_Town_F.C.
Justice_Christopher	playsFor	PFC_Levski_Sofia
Dermot_Curtis	playsFor	League_of_Ireland_XI
Billy_Hendry	playsFor	Bury_F.C.
Peter_Swan_(footballer_born_1966)	playsFor	York_City_F.C.
Tamás_Kádár	playsFor	Hungary_national_under-17_football_team
Dustin_Hoffman	hasWonPrize	David_di_Donatello
Ricky_George	playsFor	Corinthian-Casuals_F.C.
Pavel_Novotný_(footballer)	playsFor	Czech_Republic_national_under-21_football_team
Pat_Morrissey	playsFor	Crewe_Alexandra_F.C.
Carol_Burnett	wasBornIn	San_Antonio
Luca_Lacrimini	playsFor	S.E.F._Torres_1903
Martin_Reeves	playsFor	Aldershot_Town_F.C.
Gabriel_Álvez	playsFor	Real_Cartagena
Dario_Hübner	playsFor	U.S._Pergolettese_1932
Oprah_Winfrey	hasWonPrize	Peabody_Award
Marcus_Stewart	playsFor	Exeter_City_F.C.
Lorenzo_Bucchi	playsFor	U.S._Arezzo
Colin_Brazier_(footballer)	playsFor	Kidderminster_Harriers_F.C.
Jack_Paar	influences	Johnny_Carson
Henry_White_(footballer)	wasBornIn	Watford
Robert_Reilly_(footballer)	playsFor	Dumbarton_F.C.
Víctor_Aristizábal	playsFor	Atlético_Nacional
Włodzimierz_Lubański	playsFor	Valenciennes_FC
Massimiliano_Cappioli	playsFor	U.S._Città_di_Palermo
Robbie_Ryan	playsFor	Croydon_Athletic_F.C.
Greg_Strong	playsFor	Rhyl_F.C.
Alípio	playsFor	Rio_Ave_F.C.
Mikhail_Yuryevich_Komarov	playsFor	FC_Luch-Energiya_Vladivostok
Raúl_Díaz_Arce	wasBornIn	Salvador
Dodô_(footballer_born_1974)	playsFor	Associação_Portuguesa_de_Desportos
Alberto_Orlando	playsFor	ACF_Fiorentina
Eugen_Trică	playsFor	Anorthosis_Famagusta_FC
Dmytro_Topchiyev	playsFor	FC_Dynamo_Kyiv
Andriy_Proshyn	playsFor	FC_Khimik_Dzerzhinsk
Cristian_Portilla	playsFor	Aris_F.C._(Thessaloniki)
Selim_Teber	playsFor	TSG_1899_Hoffenheim
Mike_Stojanović	playsFor	San_Diego_Sockers_(1978–96)
Germán_Lux	playsFor	Argentina_national_under-20_football_team
Luke_Guttridge	playsFor	Aldershot_Town_F.C.
Igor_Moiseyev	hasWonPrize	National_Order_of_the_Cedar
Klemen_Lavrič	playsFor	NK_Inter_Zaprešić
Julio_César_Baldivieso	playsFor	Cobreloa
Lauren_Etame_Mayer	playsFor	Córdoba_CF
Reinhold_Mathy	playsFor	Bayern_Munich_Junior_Team
Thomas_Holm	playsFor	Vålerenga_Fotball
Moshe_Ohayon	playsFor	FC_Winterthur
Alejandro_Sequeira	playsFor	Deportivo_Saprissa
Brno	isLocatedIn	South_Moravia
Maxime_Josse	playsFor	FC_Sochaux-Montbéliard
Tarmo_Kink	playsFor	Kaposvári_Rákóczi_FC
Jordi_Lardín	playsFor	Spain_national_under-23_football_team
Consadole_Sapporo	isLocatedIn	Sapporo
Carlos_Solis_(footballer)	playsFor	Peru_national_football_team
Grétar_Steinsson	playsFor	Kayserispor
Stefano_Guberti	playsFor	Ascoli_Calcio_1898
Hrayr_Mkoyan	playsFor	SK_Dynamo_České_Budějovice
Richard_Daddy_Owubokiri	playsFor	C.F._Estrela_da_Amadora
Paul_Telfer_(footballer)	playsFor	A.F.C._Bournemouth
Roberto_Trashorras	playsFor	FC_Barcelona_C
Matías_Almeyda	playsFor	Lyn_Fotball
Léo_Silva	playsFor	Associação_Portuguesa_de_Desportos
Paul_Kinnaird	playsFor	St._Mirren_F.C.
Danny_Hoesen	playsFor	Jong_Ajax
Vanče_Šikov	playsFor	FC_Volyn_Lutsk
Jonny_Harkness	playsFor	Kidderminster_Harriers_F.C.
Greater_Manchester	isLocatedIn	United_Kingdom
Kléber_de_Carvalho_Corrêa	playsFor	FC_Basel
Tayfun_Seven	playsFor	Turkey_national_youth_football_team
Luciano_Goux	playsFor	Everton_de_Viña_del_Mar
Carlos_Eduardo_da_Silva	playsFor	Marília_Atlético_Clube
Kevin_Francis_(footballer)	playsFor	Birmingham_City_F.C.
Mounir_Soufiani	playsFor	Neuchâtel_Xamax
Gary_Kelly_(footballer_born_1966)	wasBornIn	Preston,_Lancashire
Pat_Clarke	playsFor	Cowdenbeath_F.C.
Stefano_Nava	playsFor	F.C._AlzanoCene_1909
Thomas_Allofs	wasBornIn	Düsseldorf
Tommy_Bell_(footballer_born_1906)	playsFor	Wellingborough_Town_F.C.
Emilia-Romagna	isLocatedIn	Bologna
Paul_Brooker	playsFor	Reading_F.C.
Johann_Gottlieb_Fichte	influences	Edmund_Husserl
David_Silva_(Cape_Verdean_footballer)	wasBornIn	Coimbra
Grzegorz_Rasiak	playsFor	Derby_County_F.C.
Chris_Robertson_(footballer_born_1986)	playsFor	Sheffield_United_F.C.
Olivier_Martinez	wasBornIn	Paris
Alessandro_Pierini	playsFor	Reggina_Calcio
Daley_Blind	playsFor	Jong_Ajax
Zoran_Vujović	playsFor	Red_Star_Belgrade
Nebi_Mustafi	playsFor	Neuchâtel_Xamax
Daniel_Rygel	playsFor	Odra_Wodzisław
Damir_Memišević	wasBornIn	Banja_Luka
Neil_Redfearn	playsFor	Oldham_Athletic_A.F.C.
Stanislav_Cherchesov	playsFor	Soviet_Union_national_football_team
Kris_Trajanovski	playsFor	Australia_national_under-20_association_football_team
William_Keepers_Maxwell,_Jr.	influences	John_Cheever
Dominic_Kinnear	wasBornIn	Glasgow
Florin_Bratu	wasBornIn	Bucharest
Gerhard_Progni	playsFor	KS_Kastrioti
Mo_Camara	playsFor	Derby_County_F.C.
Kabul	isLocatedIn	Asia
Ken_DeMange	playsFor	Crusaders_F.C.
Michel_Decastel	wasBornIn	Geneva
Dušan_Savić_(footballer_born_1985)	playsFor	Macedonia_national_under-21_football_team
Zbigniew_Boniek	playsFor	Poland_national_football_team
Amitabh_Bachchan	wasBornIn	Allahabad
Khari_Stephenson	playsFor	Jamaica_national_football_team
Jassim_Ghulam_Al-Hamd	playsFor	Al_Rayyan_SC
Billy_Wright_(footballer_born_1958)	playsFor	Everton_F.C.
Massimiliano_Giacobbo	playsFor	Delfino_Pescara_1936
Enrique_Fernández_Viola	playsFor	Uruguay_national_football_team
Jhon_Viáfara	playsFor	Deportivo_Pereira
Tokyo	isLocatedIn	Asia
Israel	isLocatedIn	Asia
Tam_McManus	playsFor	Falkirk_F.C.
Josué_Balamandji	playsFor	Paris_FC
Élder_Granja	playsFor	Clube_Atlético_Mineiro
Alberto_Toril	playsFor	Real_Madrid_C.F.
Dennis_Wit	playsFor	Baltimore_Comets
Akwá	playsFor	F.C._Alverca
Julio_César_Yegros	playsFor	Club_Universidad_Nacional
Dekel_Keinan	playsFor	Crystal_Palace_F.C.
Dirk_Anders	playsFor	Berliner_FC_Dynamo
Gabriel_Rodrigues_dos_Santos	playsFor	Sport_Club_Internacional
Archie_Gemmill	playsFor	Derby_County_F.C.
Nathan_Peat	playsFor	York_City_F.C.
Carlton_Palmer	playsFor	England_national_football_team
Kristaps_Grebis	playsFor	Kapaz_PFK
Lorenzo_Del_Prete	playsFor	A.C._Siena
Rey_Ángel_Martínez	playsFor	New_Jersey_Ironmen
Edson_Henrique_da_Silva	playsFor	Figueirense_Futebol_Clube
Marco_Vanzini	wasBornIn	Montevideo
Robert_Reilly_(footballer)	playsFor	Stranraer_F.C.
Juho_Mäkelä	playsFor	FC_Thun
Joonas_Tamm	playsFor	JK_Viljandi_Tulevik
George_Swift_(footballer)	playsFor	Crewe_Alexandra_F.C.
Barry_Robson	playsFor	Scotland_national_football_B_team
Ireland	isLocatedIn	Europe
Zinedine_Zidane	playsFor	France_national_under-18_football_team
Caetano_Calil	playsFor	Roma_Esporte_Apucarana
Francesco_Colonnese	playsFor	S.S._Lazio
Luis_Eduardo_Hicks	playsFor	Hougang_United_FC
Eddie_McGoldrick	playsFor	Crystal_Palace_F.C.
Fred_Kennedy	playsFor	Northwich_Victoria_F.C.
Jamie_Mackie	playsFor	Wimbledon_F.C.
Brian_Deane	playsFor	West_Ham_United_F.C.
Josh_Magennis	playsFor	Glentoran_F.C.
Agustín_Delgado	playsFor	Club_Deportivo_El_Nacional
Diego_Forlán	playsFor	Uruguay_national_football_team
Iain_Anderson_(footballer)	playsFor	Dundee_F.C.
Kieran_Charnock	playsFor	Northwich_Victoria_F.C.
Robbie_Middleby	playsFor	Australia_national_association_football_team
Henrik_Risom	playsFor	Denmark_national_football_team
Faruk_Namdar	playsFor	Hannover_96
Whitney_Houston	hasWonPrize	Juno_Award
Alan_Main	playsFor	Livingston_F.C.
Jancarlos_de_Oliveira_Barros	playsFor	Clube_Atlético_Paranaense
Mark_Peat	playsFor	Forfar_Athletic_F.C.
Ioan_Sabău	playsFor	FC_Universitatea_Cluj
Rolando_(footballer)	playsFor	C.F._Os_Belenenses
Pablo_Ibáñez	playsFor	Birmingham_City_F.C.
Aleksandr_Shmarko	playsFor	FC_Rotor_Volgograd
Lassana_Diarra	playsFor	Real_Madrid_C.F.
Leung_Tsz_Chun	playsFor	Eastern_AA
Clive_Allen	playsFor	Crystal_Palace_F.C.
Damir_Memišević	playsFor	FC_Taraz
Mark_Rudan	playsFor	Australia_national_under-20_association_football_team
Pablo_Munhoz	playsFor	Juventud_de_Las_Piedras
Oliver_Schmidt	playsFor	VfR_Mannheim
Anatoliy_Bezsmertnyi	playsFor	FC_Rostov
Peter_Lorimer	playsFor	Vancouver_Whitecaps_(1974–84)
Petr_Samec	playsFor	FC_Vítkovice
Ensar_Arifović	playsFor	Neuchâtel_Xamax
Henri_Stambouli	playsFor	Olympique_de_Marseille
Sylvinho	playsFor	Arsenal_F.C.
Sandy_Hodge	playsFor	Alloa_Athletic_F.C.
Chris_Albright	playsFor	Philadelphia_Union
Salvador_Cabañas	playsFor	Club_América
Eddy_Lord_Dombraye	playsFor	Stomil_Olsztyn_(football)
Thierry_Mouyouma	playsFor	FC_Felgueiras
Steve_Pittman	playsFor	Tampa_Bay_Mutiny
Aachen	isLocatedIn	Germany
Stevo_Glogovac	playsFor	FK_Bežanija
Kyle_Porter	playsFor	FC_Energie_Cottbus
Andrea_Campagnolo	playsFor	Vicenza_Calcio
Branimir_Subašić	wasBornIn	Belgrade
Pier_Ruggero_Piccio	playsFor	FFA_Centre_of_Excellence
Jackie_McNamara	playsFor	Celtic_F.C.
Nicolaj_Agger	playsFor	SønderjyskE
Ivo_Iličević	playsFor	SpVgg_Greuther_Fürth
Ricardo_Mion_Varella_Costa	playsFor	Daejeon_Citizen_FC
Michael_Love_(footballer)	playsFor	Wigan_Athletic_F.C.
Emanuel_Bentil	playsFor	Ghana_national_under-17_football_team
Stanimir_Georgiev	playsFor	PFC_CSKA_Sofia
Santos_Amador	playsFor	Nacional_Potosí
Henry_Adams	graduatedFrom	Harvard_University
Lilo_(footballer)	playsFor	Pogoń_Szczecin
Alexander_Søderlund	playsFor	Rosenborg_BK
Alyaksandr_Bychanok	playsFor	FC_Dinamo_Minsk
Dmitri_Kruglov	playsFor	Ravan_Baku_FK
Vyacheslav_Kalashnikov	playsFor	FC_SKVO_Rostov-on-Don
Lee_Wilkie	playsFor	Scotland_national_football_B_team
Ruud_Kaiser	playsFor	Royal_Antwerp_F.C.
Uche_Okafor	playsFor	Hannover_96
Darl_Douglas	playsFor	HFC_Haarlem
Denis_McLaughlin	playsFor	Dumbarton_F.C.
Vienna	isLocatedIn	Europe
Warren_Patmore	playsFor	Rushden_&_Diamonds_F.C.
Ben_Luz	playsFor	Maccabi_Tel_Aviv_F.C.
Sergio_Órteman	playsFor	Querétaro_F.C.
Dmytro_Parfenov	playsFor	FC_Khimki
Ronnie_Hildersley	playsFor	Preston_North_End_F.C.
David_Pizarro	playsFor	Inter_Milan
Vincent_Péricard	playsFor	Havant_&_Waterlooville_F.C.
Craig_Dobson	playsFor	Jamaica_national_football_team
Felipe_Caicedo	playsFor	Manchester_City_F.C.
Christian_Rahn	playsFor	SSV_Jahn_Regensburg
Speed_Racer_(film)	isLocatedIn	Germany
Ukraine	isLocatedIn	Europe
Ian_Hazel	playsFor	Bristol_Rovers_F.C.
André_Guy	playsFor	FC_Sochaux-Montbéliard
Percy_Olivares	playsFor	FC_Dallas
Erik_Lincar	playsFor	CS_Concordia_Chiajna
Tahar_El_Khalej	playsFor	Kawkab_Marrakech
Viktor_Sofroniev	playsFor	PFC_Spartak_Varna
Adam_Murray	playsFor	Burton_Albion_F.C.
Brett_Johnson_(footballer_born_1985)	playsFor	Aldershot_Town_F.C.
Eddie_Izzard	hasWonPrize	Primetime_Emmy_Award
Little_Vietnam	isLocatedIn	New_Zealand
Viktor_Sofroniev	playsFor	PFC_Beroe_Stara_Zagora
Vanja_Grubač	playsFor	Digenis_Akritas_Morphou
Nicki_Bille_Nielsen	playsFor	Elche_CF
William_Martínez	playsFor	Rampla_Juniors
Mario_Martínez_(footballer)	playsFor	R.S.C._Anderlecht
Gilles_De_Bilde	playsFor	SC_Eendracht_Aalst
Kevin_De_Bruyne	playsFor	VfL_Wolfsburg
Joe_Benjamin_(footballer)	playsFor	Wealdstone_F.C.
Arthur_Laffer	playsFor	Bnei_Sakhnin_F.C.
Jeremy_Bentham	influences	Michel_Foucault
Iain_Russell	playsFor	Motherwell_F.C.
Diomansy_Kamara	playsFor	Red_Star_F.C.
Alessandro_Matri	playsFor	A.C._Prato
Fabien_Boudarène	playsFor	FC_Universitatea_Cluj
Wellington_Luís_de_Sousa	playsFor	Associação_Desportiva_São_Caetano
Charlie_Davies	playsFor	New_England_Revolution
Tomislav_Ivić	wasBornIn	Split,_Croatia
Federico_Piovaccari	playsFor	U.C._Sampdoria
Koray_Çölgeçen	playsFor	MKE_Ankaragücü
Tiago_Costa	playsFor	Doxa_Katokopias_F.C.
Will_Robson_Emilio_Andrade	playsFor	Clube_Atlético_Paranaense
Leandro_Chaves	playsFor	Foolad_F.C.
Simon_Rea	playsFor	Peterborough_United_F.C.
Krassimir_Chomakov	playsFor	Panionios_G.S.S.
Dimosthenis_Manousakis	playsFor	Ethnikos_Achna_FC
Stuart_Elliott_(footballer,_born_1977)	playsFor	Stockport_County_F.C.
Maxence_Flachez	playsFor	Olympique_Lyonnais
Paul_Evans_(footballer_born_1974)	playsFor	Brentford_F.C.
Edwin_Pérez	playsFor	FBC_Melgar
Alen_Bajkuša	playsFor	Happy_Valley_AA
Angelo_Pagotto	playsFor	Unione_Triestina_2012_S.S.D.
Peter_Kropotkin	influences	Leo_Tolstoy
Thompson_Usiyan	playsFor	St._Louis_Storm
Hassan_Mudhafar_Al-Gheilani	playsFor	Al_Rayyan_SC
Peter_Kyle	playsFor	Arsenal_F.C.
Jonatan_Binotto	playsFor	Unione_Triestina_2012_S.S.D.
Halil_Savran	wasBornIn	Wiesbaden
Cleveland_Taylor	wasBornIn	Leicester
James_Thompson_(footballer)	playsFor	Wimbledon_F.C.
Diego_Simeone	playsFor	S.S._Lazio
Juan_Martín_Parodi	playsFor	Toros_Neza
Stephen_Wright_(English_footballer)	playsFor	England_national_under-20_football_team
Foto_Strakosha	playsFor	Proodeftiki_F.C.
Julius_Plücker	graduatedFrom	University_of_Marburg
Colin_Cramb	playsFor	Falkirk_F.C.
Willie_Johnston	playsFor	Scottish_Football_League_XI
Manoel_Morais_Amorim	wasBornIn	Maceió
Radosław_Kałużny	playsFor	FC_Energie_Cottbus
Joe_Ledley	playsFor	Crystal_Palace_F.C.
William_James	influences	Émile_Durkheim
Ovidiu_Petre	playsFor	Al_Nassr_FC
Dominic_Naylor	playsFor	Halifax_Town_A.F.C.
Robert_Enke	playsFor	Germany_national_football_B_team
Fabio_Paratici	playsFor	A.C._Pavia
Martin_Steuble	playsFor	FC_Wil_1900
Vincenzo_Chiarenza	playsFor	S.S._Lazio
Peter_Hucker	playsFor	Farnborough_F.C.
Guy_Debord	wasBornIn	Paris
Luis_Asprilla	playsFor	Real_Cartagena
Ángel_Bernabé	playsFor	UD_Salamanca
Tommy_Spencer	wasBornIn	Glasgow
Samir_Aliyev	playsFor	Baku_FC
Baruch_Spinoza	influences	Johann_Wolfgang_von_Goethe
Anatoliy_Kitsuta	playsFor	FC_Dynamo_Kyiv
Ross_Macdonald	influences	William_Goldman
Yavuz_Eraydın	playsFor	Çamlıdere_Şekerspor
Markus_Heppke	playsFor	FC_Schalke_04_II
Joaquim_Alberto_Silva	playsFor	Rayo_Vallecano
Yıldıray_Baştürk	playsFor	VfL_Bochum
Luis_Tejada	playsFor	Al_Ain_FC
Fredrik_Risp	playsFor	Ethnikos_Achna_FC
Aaron_Brown_(footballer_born_1983)	playsFor	Burton_Albion_F.C.
Alejandro_Sequeira	playsFor	Proodeftiki_F.C.
César_Prates	playsFor	A.C._Chievo_Verona
Colin_Calderwood	playsFor	Tottenham_Hotspur_F.C.
Sékou_Berthé	playsFor	West_Bromwich_Albion_F.C.
University_of_Vienna	isLocatedIn	Vienna
Alan_Knill	playsFor	Cardiff_City_F.C.
David_Bisconti	playsFor	Sagan_Tosu
Guido_Gorges	playsFor	RSV_Göttingen_05
Jimmy_Kébé	playsFor	Crystal_Palace_F.C.
Gaël_Danic	playsFor	Olympique_Lyonnais
Dustin_Hoffman	actedIn	Kung_Fu_Panda
Centro_Region,_Portugal	isLocatedIn	Europe
Zlatan_Muslimović	playsFor	A.C._Rimini_1912
Alex_Massie	playsFor	Heart_of_Midlothian_F.C.
Dimosthenis_Manousakis	playsFor	Atromitos_F.C.
Bavaria	isLocatedIn	Munich
Andrejs_Pavlovs	playsFor	FK_Ventspils
Spencer_Weir-Daley	wasBornIn	Leicester
Kim_Källström	playsFor	Arsenal_F.C.
Walter_Ribonetto	playsFor	Querétaro_F.C.
Reginaldo_de_Santana	playsFor	Sociedade_Esportiva_e_Recreativa_Caxias_do_Sul
Goran_Adamović	wasBornIn	Belgrade
Viktor_Zhylin	playsFor	FC_Dynamo_Kyiv
Andriy_Oberemko	playsFor	FC_Dynamo_Kyiv
Branislav_Rzeszoto	playsFor	FC_Senec
Bruno_da_Silva_Barbosa	playsFor	Toledo_Colônia_Work
Tomasz_Cywka	playsFor	Oldham_Athletic_A.F.C.
Christian_Karembeu	playsFor	U.C._Sampdoria
Pablo_Granoche	playsFor	Modena_F.C.
Nikolay_Pavlov_(footballer)	playsFor	FC_Spartak_Plovdiv
Craig_Foster	playsFor	Adelaide_City_FC
Michael_Collins_(soccer)	playsFor	San_Diego_Sockers_(1978–96)
Bruno_Coutinho_Martins	wasBornIn	Porto_Alegre
Anatoli_Ponomarev	playsFor	Qarabağ_FK
José_Gerson_Ramos	playsFor	Mogi_Mirim_Esporte_Clube
Jamie_Clapham	playsFor	Birmingham_City_F.C.
Vlado_Šmit	playsFor	Delfino_Pescara_1936
Maurice_Dalé	playsFor	FC_Unirea_Urziceni
Aurélien_Chedjou	playsFor	Pau_FC
Julien_Tournut	playsFor	F91_Dudelange
Santiago	isLocatedIn	Chile
Tim_Carter_(footballer)	playsFor	Bristol_Rovers_F.C.
Mikalay_Kashewski	playsFor	FC_SKVICH_Minsk
Alan_Walsh_(footballer)	playsFor	Cardiff_City_F.C.
Murat_Şahin	playsFor	Adanaspor
Darryl_Flahavan	playsFor	A.F.C._Bournemouth
Giani_Kiriţă	playsFor	FC_Dinamo_București
Ian_Wright	playsFor	Celtic_F.C.
Alfonso_Dulanto	playsFor	Estudiantes_de_Medicina
François_Lemasson	playsFor	AS_Cannes
Pat_Noonan	playsFor	New_England_Revolution
René_Descartes	influences	Thomas_Hobbes
Stéphane_Demol	playsFor	R.S.C._Anderlecht
Aleksei_Gerasimenko	playsFor	FC_Rostov
Cristian_Dănălache	playsFor	CS_Otopeni
Martin_Phillips	playsFor	Bristol_Rovers_F.C.
David_Brcic	playsFor	Pittsburgh_Spirit
Fernando_Gamboa	playsFor	Argentina_national_football_team
Martin_Heidegger	influences	Leo_Strauss
Adam_Griffiths	playsFor	Australia_national_association_football_team
Marcel_Augusto_Ortolan	playsFor	Grêmio_Foot-Ball_Porto_Alegrense
Roni_Porokara	playsFor	Örebro_SK
Samir_Ujkani	playsFor	Kosovo_national_football_team
Mody_Traoré	playsFor	Le_Havre_AC
Bill_Paterson_(footballer_born_1930)	playsFor	Greenock_Morton_F.C.
Slaviša_Žungul	playsFor	HNK_Hajduk_Split
Danko_Lazović	playsFor	FC_Rostov
Gündüz_Gürol_Azer	playsFor	Kasımpaşa_Spor_Kulübü
Giorgio_Gorgone	playsFor	Unione_Triestina_2012_S.S.D.
Yuriy_Tselykh	playsFor	FC_CSKA_Kyiv
Edmundo_Rodriguez	playsFor	Hershey_Wildcats
Alex_Burke	playsFor	St._Mirren_F.C.
Hiraç_Yagan	playsFor	FC_Gandzasar
Jean-Santos_Muntubila	playsFor	ESA_Brive
Rodolfo_Lima	playsFor	C.F._Os_Belenenses
Ole_Martin_Årst	playsFor	IK_Start
Joey_Fink	playsFor	United_States_men's_national_soccer_team
Atanas_Bornosuzov	wasBornIn	Plovdiv
Veldin_Karić	playsFor	NK_Marsonia
Dejan_Rusmir	playsFor	FC_Ceahlăul_Piatra_Neamț
David_Bell_(footballer_born_1985)	playsFor	Rushden_&_Diamonds_F.C.
Dragan_Đukić	playsFor	FC_Wohlen
Vivien_Leigh	actedIn	A_Yank_at_Oxford
Ezequiel_Garay	playsFor	Argentina_national_under-23_football_team
Gláucio_de_Jesus_Carvalho	playsFor	Associação_Desportiva_São_Caetano
Luis_Patricio_Núñez	playsFor	Universidad_Católica_del_Ecuador
Rodrigo_Prieto_(footballer)	playsFor	Caracas_FC
Marcelo_Baron_Polanczyk	playsFor	Sport_Club_Internacional
Denis_McLaughlin	playsFor	Gimnástica_de_Torrelavega
Nelson_Haedo_Valdez	playsFor	SV_Werder_Bremen
Adrian_Mutu	playsFor	Inter_Milan
Gary_Oldman	actedIn	Batman_Begins
Schumacher_(footballer)	playsFor	FC_Volyn_Lutsk
Paul_Marshall_(footballer)	playsFor	Stockport_County_F.C.
Tha'er_Bawab	playsFor	FC_Barcelona_B
Nuno_Santos_(footballer_born_1973)	playsFor	F.C._Arouca
Benjamin_Siegert	playsFor	VfL_Wolfsburg
Pedro_Pasculli	playsFor	Argentina_national_football_team
Víctor_Rossel	playsFor	Unión_Comercio
Hugo_Monteiro	playsFor	Gil_Vicente_F.C.
Anatoliy_Kitsuta	playsFor	Ukraine_national_under-21_football_team
Trevor_Howard	actedIn	Battle_of_Britain_(film)
Yuriy_Nikiforov	playsFor	SC_Odesa
Capi_(footballer_born_1977)	playsFor	Xerez_CD
Élder_Granja	playsFor	Esporte_Clube_Juventude
Neville_Southall	playsFor	Everton_F.C.
Wayne_O'Sullivan	playsFor	Republic_of_Ireland_national_under-21_football_team
Chris_Albright	playsFor	United_States_men's_national_soccer_team
John_P._Jumper	hasWonPrize	Distinguished_Service_Medal_(US_Navy)
Martin_Heidegger	influences	Hannah_Arendt
Ján_Kozák_(footballer_born_1980)	playsFor	West_Bromwich_Albion_F.C.
Emanuel_Faria_Braga	playsFor	S.C._Salgueiros
Scott_McGarvey	playsFor	Oldham_Athletic_A.F.C.
Philippe_Albert	playsFor	R.S.C._Anderlecht
Ivan_Čvorović	wasBornIn	Belgrade
Denys_Sokolovskyi	playsFor	Pogoń_Szczecin
Henrique_Sereno	playsFor	Kayserispor
Pavel_Drsek	wasBornIn	Kladno
Yehiel_Tzagai	playsFor	Sektzia_Nes_Tziona_F.C.
Pablo_Correa	playsFor	Montevideo_Wanderers_F.C.
Babacar_Gueye	playsFor	Shenzhen_Ruby_F.C.
Lance_Cronin	playsFor	Bristol_Rovers_F.C.
Eldar_Nizamutdinov	playsFor	FC_Khimki
Paul_Krumpe	playsFor	Los_Angeles_Heat
Alejandro_Cichero	playsFor	Venezuela_national_football_team
Abdullah_Fusseini	playsFor	A.S._Melfi
Henry_James	wasBornIn	New_York_City
João_Pedro_Guerra_Cunha	playsFor	F.C._Penafiel
Pierre_Aubameyang	playsFor	Le_Havre_AC
Josh_Saunders	playsFor	LA_Galaxy
Gerhard_Tremmel	playsFor	Bayern_Munich_Junior_Team
Jorge_Luis_Borges	influences	Philip_K._Dick
Paulo_Marcel_Pereira_Merabet	playsFor	Brasiliense_Futebol_Clube
Adam_Strachan	playsFor	Albion_Rovers_F.C.
Mesut_Bakkal	playsFor	Turkey_national_under-21_football_team
Richard_Goulooze	playsFor	SC_Cambuur
Emiliano_Dudar	playsFor	BSC_Young_Boys
Danny_Dichio	playsFor	Derby_County_F.C.
Boban_Stojanović	playsFor	Red_Star_Belgrade
Jan_Hable	playsFor	ACF_Fiorentina
Giuseppe_Cardone	playsFor	S.S.D._Piacenza_Calcio_1919
David_Bermudo	playsFor	FC_Barcelona_C
Gary_Holt_(footballer)	playsFor	Kilmarnock_F.C.
Cesare_Rickler	playsFor	S.S.D._Piacenza_Calcio_1919
Jakub_Sylvestr	wasBornIn	Banská_Bystrica
Miroslav_Klose	playsFor	Germany_national_football_team
Cihan_Yılmaz	playsFor	Boluspor
Bob_Newhart	influences	Norm_Macdonald
Holger_Badstuber	playsFor	Germany_national_youth_football_team
Leandro_Remondini	playsFor	Modena_F.C.
Elvir_Melunović	playsFor	FC_Wil_1900
Leconte_de_Lisle	influences	Stéphane_Mallarmé
Michael_Renwick	playsFor	Glenavon_F.C.
Dmitri_Parkhachev	playsFor	FC_Slavia-Mozyr
Hans-Jürgen_Boysen	wasBornIn	Mannheim
Mark_Rawle	playsFor	Rushden_&_Diamonds_F.C.
Alex_Dias	playsFor	Brasiliense_Futebol_Clube
Mahamadou_Dissa	playsFor	Grenoble_Foot_38
Park_Chu-young	playsFor	FC_Seoul
Lukáš_Janič	playsFor	1._FC_Tatran_Prešov
Ian_Selley	playsFor	Grays_Athletic_F.C.
Curd_Jürgens	wasBornIn	Munich
Sílvio_José_Canuto	playsFor	Sport_Club_Internacional
Marc_Van_Der_Linden	playsFor	R.S.C._Anderlecht
Izale_McLeod	playsFor	Barnet_F.C.
Peter_Kavanagh_(Irish_footballer)	playsFor	Waterford_United_F.C.
Ryan_Miller_(soccer)	playsFor	D.C._United
Blake_Edwards	isMarriedTo	Julie_Andrews
Ricardo_Phillips	playsFor	New_England_Revolution
Luboš_Kubík	playsFor	FC_Hradec_Králové
Franco_Parisi_(soccer_player)	wasBornIn	Sydney
Walter_Scott	influences	Charles_Dickens
Giovane_Élber	playsFor	Olympique_Lyonnais
Yuri_Matveyev	playsFor	Russia_national_football_team
Nicolás_Esteban_Medina_Ríos	playsFor	SD_Huesca
John_Baird_(footballer_born_1985)	playsFor	St._Mirren_F.C.
Maksim_Buznikin	playsFor	FC_Rotor_Volgograd
Alex_Emenike	playsFor	Nigeria_national_under-20_football_team
Steve_Finnan	playsFor	Wimbledon_F.C.
Chris_Powell	playsFor	West_Ham_United_F.C.
Ronny_Gaspercic	playsFor	K.R.C._Genk
Tom_Davis_(footballer)	playsFor	Drumcondra_F.C.
Saudi_detainees_at_Guantanamo_Bay	playsFor	Shonan_Bellmare
Fredric_March	actedIn	Paramount_on_Parade
Alejandro_Curbelo	playsFor	Montevideo_Wanderers_F.C.
Jesús_Rodríguez_Tato	playsFor	FC_Barcelona_C
Ármann_Smári_Björnsson	playsFor	Valur_Football_Club
Juan_Ramón_Curbelo	playsFor	Centro_Atlético_Fénix
Carlo_Zotti	playsFor	A.S._Cittadella
Wesley_Charles	playsFor	Montreal_Impact
Alfred_Osmani	playsFor	KS_Kastrioti
Luciano_Chiarugi	playsFor	San_Frediano_Rondinella_S.S.
Shuki_Nagar	playsFor	Hapoel_Ashkelon_F.C.
Richard_Brodie_(footballer)	playsFor	Gateshead_F.C.
Barry,_Vale_of_Glamorgan	isLocatedIn	South_Wales
Don_DeLillo	wasBornIn	New_York_City
Slobodan_Janković_(footballer_born_1946)	wasBornIn	Belgrade
Pedro_Guerreiro_de_Jesus_Correia	playsFor	S.C._Olhanense
Gary_Silk	playsFor	Boston_United_F.C.
Patrick_Wolf_(Austrian_footballer)	playsFor	SV_Ried
Tom_Sermanni	wasBornIn	Glasgow
George_Best	playsFor	Stockport_County_F.C.
Iván_Emmanuel_González	playsFor	VfB_Stuttgart_II
Akaki_Khubutia	playsFor	Georgia_national_under-21_football_team
Ronald_Brunmayr	playsFor	Grazer_AK
Zlatko_Arambasic	wasBornIn	Split,_Croatia
Fernando_Aguiar	playsFor	Toronto_Blizzard_(1986–93)
Raoul_Magrin-Vernerey	hasWonPrize	Croix_de_guerre_1914–1918_(France)
Mike_Zaher	wasBornIn	Phoenix,_Arizona
Albano_Bizzarri	playsFor	Racing_Club_de_Avellaneda
Shep_Messing	playsFor	Boston_Minutemen
Jim_Barron	playsFor	Swindon_Town_F.C.
William_S._Burroughs	influences	Alan_Moore
Arthur_Schopenhauer	influences	Knut_Hamsun
João_Soares_de_Almeida_Neto	playsFor	Betim_Esporte_Clube
Jon_Stead	playsFor	Oldham_Athletic_A.F.C.
Luis_Tejada	playsFor	América_de_Cali
Stefan_Lexa	playsFor	SpVgg_Unterhaching
Joël_Tchami	playsFor	Stade_Lavallois
Jonathan_Spector	playsFor	West_Ham_United_F.C.
André_Correia	playsFor	F.C._Alverca
Emmanuel_Osei_Kuffour	playsFor	FC_Anzhi_Makhachkala
Germano_Borovicz_Cardoso_Schweger	playsFor	Vila_Nova_Futebol_Clube
Silvestre_Varela	playsFor	Sporting_Clube_de_Portugal
Hugh_Vallance	playsFor	Kidderminster_Harriers_F.C.
Chris_Blackburn	playsFor	Weymouth_F.C.
Scott_McGleish	playsFor	Bristol_Rovers_F.C.
Gianluca_Comotto	playsFor	Vicenza_Calcio
Lord_Byron	influences	Charlotte_Brontë
Steve_MacLean_(footballer)	wasBornIn	Edinburgh
George_Hunt_(forward)	playsFor	Arsenal_F.C.
Josip_Tadić	playsFor	GNK_Dinamo_Zagreb
Gil_Gomes	playsFor	C.F._Estrela_da_Amadora
Christian_Lara_(footballer)	playsFor	Deportivo_Pereira
Melvin_Holwijn	playsFor	Barnet_F.C.
Laurence_Sterne	influences	Joaquim_Maria_Machado_de_Assis
Alphonse_Tchami	playsFor	Al_Wasl_FC
Christian_Rahn	playsFor	Altonaer_FC_von_1893
Adrian_Mihalcea	playsFor	CS_Concordia_Chiajna
Iván_Guerrero	playsFor	Honduras_national_football_team
Mohamed_Hubail	playsFor	Al-Qadisiyah_FC
Liam_Brady	playsFor	Ascoli_Calcio_1898
Cristóvão_da_Silva_Ramos	playsFor	AEP_Paphos_F.C.
Ryan_Amoo	wasBornIn	Leicester
Daniel_Moreira	playsFor	Grenoble_Foot_38
Greg_Halford	playsFor	Sheffield_United_F.C.
Robin_Previtali	playsFor	CS_Louhans-Cuiseaux
Carlo_Costly	playsFor	Club_Atlas
Ian_Lawther	playsFor	Brentford_F.C.
Alan_Merrick	playsFor	Los_Angeles_Aztecs
Andriy_Poroshyn	wasBornIn	Kirovohrad
Sergei_Volgin	playsFor	FC_Kairat
Steve_Archibald	playsFor	Reading_F.C.
Bing_Crosby	hasWonPrize	Academy_Award_for_Best_Actor
Craig_Foster	playsFor	FFA_Centre_of_Excellence
King's_College_London	isLocatedIn	United_Kingdom
Justin_Evans	playsFor	Charleston_Battery
Emerson_da_Luz	playsFor	F.C._Arouca
Lionel_Cappone	playsFor	Olympique_de_Marseille
Alberto_Malusci	playsFor	RWDM_Brussels_FC
Gary_Hooper	playsFor	Grays_Athletic_F.C.
Andrei_Yevgenyevich_Ivanov	playsFor	Soviet_Union_national_football_team
Germán_Burgos	playsFor	Argentina_national_football_team
Dedi_Ben_Dayan	playsFor	Hapoel_Kfar_Saba_F.C.
Túlio_de_Melo	playsFor	Clube_Atlético_Mineiro
Mauro_Milanese	playsFor	U.S._Cremonese
Solomon_Okoronkwo	playsFor	Aalesunds_FK
Edson_Henrique_da_Silva	playsFor	Sociedade_Esportiva_e_Recreativa_Caxias_do_Sul
Mark_Roberts_(footballer,_born_1983)	playsFor	Stevenage_F.C.
André_Luiz_Moreira	playsFor	Olympique_de_Marseille
Edwin_Zoetebier	playsFor	NAC_Breda
Honoré_de_Balzac	influences	Bret_Easton_Ellis
George_Mbwando	playsFor	VfB_Lübeck
Hassan_Souari	playsFor	Hatta_Club
Martin_Lejsal	playsFor	Reggina_Calcio
Josip_Šimić	playsFor	FC_Kärnten
Malky_Mackay	playsFor	West_Ham_United_F.C.
Welton_Felipe	playsFor	Changchun_Yatai_F.C.
Emrah_Eren	playsFor	Akhisar_Belediyespor
Mamadou_Diallo	playsFor	Tampa_Bay_Mutiny
Đorđije_Ćetković	playsFor	KS_Kastrioti
Abuda_(footballer_born_1986)	playsFor	VfL_Wolfsburg
Gennady_Tumilovich	playsFor	FC_Yenisey_Krasnoyarsk
Víctor_Púa	playsFor	Club_Atlético_River_Plate_(Montevideo)
Alexandru_Păcurar	playsFor	FC_Dinamo_București
Ulises_de_la_Cruz	playsFor	Reading_F.C.
The_Last_Judgement_(1961_film)	isLocatedIn	France
Vadym_Deonas	playsFor	MFC_Mykolaiv
Landon_Donovan	playsFor	Everton_F.C.
David_Bentley	playsFor	Tottenham_Hotspur_F.C.
Bertie_Cozic	playsFor	Exeter_City_F.C.
Hans_Cieslarczyk	playsFor	Germany_national_football_team
Itzik_Kornfein	playsFor	Israel_national_under-18_football_team
Dan_Alexa	playsFor	Anorthosis_Famagusta_FC
Philippe_Brunel	playsFor	FC_Sochaux-Montbéliard
Ismaël_Béko_Fofana	playsFor	Zob_Ahan_Isfahan_F.C.
Hélder_Barbosa	playsFor	Portugal_national_under-19_football_team
Tommy_Rigg	playsFor	Consett_A.F.C.
Simon_Walton	playsFor	Sheffield_United_F.C.
Glenn_Helder	playsFor	MTK_Budapest_FC
Rafael_Márquez_Lugo	playsFor	C.F._Pachuca
Bakary_Diakité	playsFor	Foolad_F.C.
VFC_Plauen	isLocatedIn	Saxony
Peter_Kyle	playsFor	Tottenham_Hotspur_F.C.
Danijel_Aleksić	playsFor	SpVgg_Greuther_Fürth
Bannered_routes_of_U.S._Route_1	isLocatedIn	Washington,_D.C.
Division_No._6,_Alberta	isLocatedIn	Canada
Myles_Hogarth	playsFor	Alloa_Athletic_F.C.
Angelo_Peruzzi	playsFor	S.S._Lazio
Gabriele_Paoletti	playsFor	A.C.R._Messina
Jan-André_Sievers	playsFor	Hamburger_SV_II
Goran_Ljubojević	playsFor	Naft_Tehran_F.C.
Neil_Davis_(footballer)	playsFor	Redditch_United_F.C.
Marlin_Piana	playsFor	Troyes_AC
Marshall_McLuhan	influences	Terence_McKenna
Roman_Neustädter	playsFor	1._FSV_Mainz_05
Andreas_Ibertsberger	wasBornIn	Salzburg
Bruno_Rafael_Bronetta_da_Silva	playsFor	Kavala_F.C.
Aleksandar_Sarić	playsFor	Red_Star_Belgrade
Arno_Steffenhagen	wasBornIn	Berlin
Aristotle	influences	Karl_Marx
Lee_Colkin	playsFor	Hucknall_Town_F.C.
Mark_Walters	playsFor	England_national_football_team
Scott_Fitzgerald_(footballer_born_1969)	playsFor	Wimbledon_F.C.
Onur_Karakabak	playsFor	Turkey_national_youth_football_team
Patrick_Suffo	playsFor	FC_Barcelona_B
Cheng_Siu_Chung	playsFor	Eastern_AA
Stoppila_Sunzu	playsFor	Zambia_national_football_team
Luis_Robson	playsFor	Consadole_Sapporo
Gerardo_Reinoso	playsFor	Correcaminos_UAT
Christian_Kinkela	playsFor	Stade_Lavallois
Michel_Foucault	influences	Gilles_Deleuze
Alfred_Jermaniš	playsFor	NK_Mura
Farid_Guliyev	wasBornIn	Baku
Sercan_Güvenışık	playsFor	SC_Preußen_Münster
Friedrich_III_of_Germany	isMarriedTo	Victoria,_Princess_Royal
Dean_Austin	playsFor	Crystal_Palace_F.C.
Niall_Henderson	playsFor	Dumbarton_F.C.
Tony_Cottee	playsFor	West_Ham_United_F.C.
Boban_Babunski	playsFor	PFC_CSKA_Sofia
Fabian_Teușan	playsFor	CS_Jiul_Petroșani
Cristián_Ariel_Morales	playsFor	Cobreloa
Richard_Gere	hasWonPrize	David_di_Donatello
Jimmy_Case	playsFor	Liverpool_F.C.
Davide_Sinigaglia	playsFor	A.C._Lumezzane
Martin_Butler	playsFor	Burton_Albion_F.C.
Jonhes_Elias_Pinto_Dos_Santos	playsFor	Brasiliense_Futebol_Clube
H._R._McMaster	wasBornIn	Philadelphia
Pascal_Chimbonda	playsFor	Le_Havre_AC
Francisco_José_Carrasco	playsFor	Spain_national_under-23_football_team
Gheorghe_Stratulat	playsFor	ACS_Poli_Timișoara
Zezinando	playsFor	Sporting_Clube_de_Portugal
Ali_Reza_Mansourian	wasBornIn	Tehran
James_W._Holsinger	hasWonPrize	Legion_of_Merit
Imre_Varadi	playsFor	Sheffield_United_F.C.
Isaac_Okoronkwo	playsFor	Al_Rayyan_SC
Emmanuel_Osei_Kuffour	playsFor	Tractor_Sazi_F.C.
Sören_Bertram	playsFor	Germany_national_youth_football_team
Evandro_Russo_Ramos	playsFor	Mogi_Mirim_Esporte_Clube
Gottfried_Wilhelm_Leibniz	influences	Denis_Diderot
Fabio_Quagliarella	playsFor	U.C._Sampdoria
Ariel_López	playsFor	San_Lorenzo_de_Almagro
Tomasz_Stolpa	playsFor	Enköpings_SK
Arthur_Schopenhauer	wasBornIn	Gdańsk
Aleksandr_Gogoberishvili	playsFor	Qarabağ_FK
Slavonski_Brod	isLocatedIn	Croatia
Sam_Allardyce	playsFor	Coventry_City_F.C.
Robbie_Farrell	playsFor	Home_Farm_F.C.
Rudolf_Carnap	isInterestedIn	Philosophy_of_science
Paul_Koulibaly	playsFor	FC_Dinamo_București
Vyacheslav_Sviderskyi	playsFor	Swindon_Town_F.C.
Daniel_González_Calvo	playsFor	Deportes_Antofagasta
Norbert_Tóth	playsFor	Lombard-Pápa_TFC
Paul_Robinson_(footballer,_born_1984)	playsFor	Newcastle_Blue_Star_F.C.
Adam_Yates	playsFor	Crewe_Alexandra_F.C.
Stanley_Menzo	playsFor	AGOVV_Apeldoorn
Douglas_Galvão_Silva	playsFor	Mineiros_Esporte_Clube
Adam_Rundle	playsFor	Whitby_Town_F.C.
Craig_Bellamy	playsFor	Norwich_City_F.C.
Leopold_Kielholz	playsFor	FC_Basel
John_Williams	wroteMusicFor	JFK_(film)
Spas_Delev	playsFor	PFC_Pirin_Blagoevgrad
Luciano_Lopes_de_Souza	playsFor	União_Agrícola_Barbarense_Futebol_Clube
Paul_McGrillen	playsFor	Falkirk_F.C.
James_Wilson_(footballer_born_1989)	playsFor	Wales_national_under-19_football_team
Lloyd_Opara	playsFor	St_Albans_City_F.C.
João_Paulo_da_Silva	playsFor	Avaí_Futebol_Clube
Jeff_Baicher	playsFor	New_England_Revolution
Vitaliy_Shevchenko	wasBornIn	Baku
Brian_Rice	playsFor	Greenock_Morton_F.C.
Daniel_P._Hanley	edited	EDtv
Oleh_Matveyev	playsFor	FC_Metalurh_Zaporizhya
Christopher_Nöthe	playsFor	FC_St._Pauli
Luke_Medley	playsFor	Havant_&_Waterlooville_F.C.
Bartosz_Ślusarski	playsFor	West_Bromwich_Albion_F.C.
Benoit_Mandelbrot	graduatedFrom	University_of_Paris
Nathan_Elder	playsFor	Brentford_F.C.
Gaetano_Giallanza	playsFor	Norwich_City_F.C.
Papa_Bouba_Diop	playsFor	Birmingham_City_F.C.
Yevhen_Borovyk	playsFor	FC_Metalurh_Zaporizhya
Andrés_Mendoza_(footballer)	playsFor	Columbus_Crew
John_Shalikashvili	hasWonPrize	Order_of_the_White_Lion
Wilmer_Cabrera	playsFor	Boyacá_Chicó_F.C.
F.C._Porto	isLocatedIn	Porto
Fallah_Johnson	playsFor	Liberia_Petroleum_Refining_Company_Oilers
Graham_Potter	playsFor	York_City_F.C.
Yago_Fernández	playsFor	Sporting_Clube_de_Portugal
Eninho	playsFor	Changchun_Yatai_F.C.
Edson_Minga	playsFor	AmaZulu_F.C.
Éric_Abidal	playsFor	AS_Lyon-Duchère
Ricardo_Esteves	wasBornIn	Lisbon
Pascal_Nouma	playsFor	Olympique_de_Marseille
Viktor_Brovchenko	playsFor	FC_Lokomotiv_Nizhny_Novgorod
Everaldo_Batista	playsFor	SpVgg_Greuther_Fürth
Boban_Stojanović	playsFor	FK_Radnički_Obrenovac
Francesco_Sanetti	playsFor	S.S._Teramo_Calcio
Paul_France	playsFor	Burnley_F.C.
Stuart_Wardley	playsFor	Bedford_Town_F.C.
Mickaël_Pagis	playsFor	Stade_Lavallois
Carl_Veart	playsFor	Crystal_Palace_F.C.
Leyton_Maxwell	playsFor	Carmarthen_Town_A.F.C.
Edmur_Ribeiro	playsFor	Associação_Portuguesa_de_Desportos
Juan_Calatayud	playsFor	Atlético_Malagueño
Diego_Cochas	playsFor	Cúcuta_Deportivo
Mileta_Radulović	playsFor	FK_BASK
João_Francisco_de_Sales	playsFor	Clube_Atlético_Linense
Euzebiusz_Smolarek	wasBornIn	Łódź
José_Manuel_Moreno	playsFor	Argentina_national_football_team
Frank_Ordenewitz	playsFor	Germany_national_football_team
Cristian_Nasuti	playsFor	Club_Atlético_Platense
Joílson_Rodrigues_da_Silva	playsFor	Zob_Ahan_Isfahan_F.C.
Anastasios_Kyriakos	playsFor	Aris_F.C._(Thessaloniki)
Adam_Sarota	playsFor	Australia_national_association_football_team
Junior_Agogo	playsFor	Oldham_Athletic_A.F.C.
Juary	playsFor	Associação_Portuguesa_de_Desportos
Kevin_Campbell_(footballer)	playsFor	West_Bromwich_Albion_F.C.
Brett_Studman	playsFor	FFA_Centre_of_Excellence
Abdelkader_Ferhaoui	wasBornIn	Oran
Jorge_Borelli	playsFor	Club_Atlético_Platense
Darío_Sala	playsFor	Los_Andes_de_Lomas_de_Zamora
Dylan_Macallister	playsFor	Australia_national_under-23_association_football_team
Erhan_Albayrak	playsFor	MKE_Ankaragücü
Jason_St_Juste	playsFor	Whitehawk_F.C.
Asa_Charlton	playsFor	Hinckley_United_F.C.
Igor_Lazič	playsFor	NK_Celje
Sebastián_Roco	playsFor	Everton_de_Viña_del_Mar
Ion_Erice_Domínguez	playsFor	CD_Guadalajara_(Spain)
George_Owu	playsFor	Asante_Kotoko_SC
Amr_Zaki	playsFor	Wigan_Athletic_F.C.
Johnny_Carson	influences	Garry_Shandling
Vakhtang_Khvadagiani	playsFor	FC_Torpedo_Kutaisi
Joel_Sánchez_(Mexican_footballer)	playsFor	C.D._Guadalajara
Raúl_Vicente_Amarilla	playsFor	Yokohama_Flügels
Oleksandr_Ivanov	wasBornIn	Kharkiv
Tarmo_Neemelo	playsFor	S.V._Zulte_Waregem
Lee_Hodges_(footballer,_born_1978)	playsFor	West_Ham_United_F.C.
Alain_Raguel	playsFor	Atromitos_F.C.
Septimus_Atterbury	playsFor	Swindon_Town_F.C.
Zdravko_Kuzmanović	playsFor	Switzerland_national_under-21_football_team
Andreu_Guerao_Mayoral	playsFor	FC_Barcelona_B
Stefan_Bell	playsFor	1._FSV_Mainz_05
Steve_Bowey	playsFor	Bristol_Rovers_F.C.
Fábio_Coentrão	playsFor	Harimau_Muda_A
Vladislav_Baskov	playsFor	FC_Arsenal_Tula
William_Godwin	influences	Oscar_Wilde
Luciano_Lopes_de_Souza	wasBornIn	Maceió
Oliver_Westerbeek	playsFor	KFC_Uerdingen_05
Joey_Fink	playsFor	Tampa_Bay_Rowdies_(1975–93)
Maurice_Ross	playsFor	Wolverhampton_Wanderers_F.C.
Tim_Jerat	playsFor	SpVgg_Unterhaching
Hugo_Simões	wasBornIn	Lisbon
Nestor_Subiat	playsFor	FC_Lugano
Willy_Brandt	hasWonPrize	Order_of_the_White_Lion
Oliver_Stone	hasWonPrize	Academy_Award
Reinhold_Mathy	playsFor	FC_Wettingen
