Sidney_Sam	hasGender	male
Josh_Dawkin	hasGender	male
Ürümqi_Diwopu_International_Airport	isConnectedTo	Istanbul_Atatürk_Airport
Jimmy_Gallagher	hasGender	male
Goran_Stanić	hasGender	male
Giuseppe_Taglialatela	hasGender	male
Leonel_Altobelli	hasGender	male
Danny_Alcock	hasGender	male
Helmut_Rahner	hasGender	male
Hristian_Popov	hasGender	male
Eric_Idle	hasGender	male
John_Krause	hasGender	male
Hernán_Rodrigo_López	hasGender	male
Jacques_Hadamard	hasGender	male
Koltsovo_Airport	isConnectedTo	Barcelona–El_Prat_Airport
Thomas_Newman	hasGender	male
Mauricio_Molina	hasGender	male
Slim_Pickens	hasGender	male
Goce_Sedloski	hasGender	male
Kunming_Changshui_International_Airport	isConnectedTo	Wenzhou_Longwan_International_Airport
Juan_Manuel_Gálvez_International_Airport	isConnectedTo	Hartsfield–Jackson_Atlanta_International_Airport
Rudi_Gores	hasGender	male
Antalya_Airport	isConnectedTo	Graz_Airport
Ramazan_Özcan	hasGender	male
Beirut–Rafic_Hariri_International_Airport	isConnectedTo	Sarajevo_International_Airport
Verona_Villafranca_Airport	isConnectedTo	Karpathos_Island_National_Airport
Najwan_Ghrayib	hasGender	male
José_Calado	hasGender	male
Yutaka_Takahashi	hasGender	male
Leandro_Ricardo_Vieira	hasGender	male
Goma_Lambu	hasGender	male
Frédéric_Piquionne	hasGender	male
Chris_Billy	hasGender	male
Jean-Jacques_Pierre	hasGender	male
Larnaca_International_Airport	isConnectedTo	Exeter_International_Airport
Kristian_Nicht	hasGender	male
Lewis_Holtby	hasGender	male
Jake_Sedgemore	hasGender	male
Johan_Boskamp	hasGender	male
Heraklion_International_Airport	isConnectedTo	Prague_Václav_Havel_Airport
Feliciano_Magro	hasGender	male
Gareth_Davies_(footballer_born_1973)	hasGender	male
Carlos_Carneiro_(footballer)	hasGender	male
Zhora_Hovhannisyan	hasGender	male
Robert_Fleck	hasGender	male
Thiago_Corrêa	hasGender	male
Zlatko_Vujović	hasGender	male
Calgary_International_Airport	isConnectedTo	San_Francisco_International_Airport
Emmet_McLoughlin	hasGender	male
Kojiro_Kaimoto	hasGender	male
Rachid_Tiberkanine	hasGender	male
Greenville–Spartanburg_International_Airport	isConnectedTo	Dallas/Fort_Worth_International_Airport
Miguel_Palencia	hasGender	male
Facundo_Pérez_Castro	hasGender	male
Joseph_Elanga	hasGender	male
John_Toshack	hasGender	male
Rémy_Riou	hasGender	male
Munich_Airport	isConnectedTo	Falcone–Borsellino_Airport
Enes_Demirović	hasGender	male
Alan_Gough	hasGender	male
Christos_Karipidis	hasGender	male
Aleksei_Ionov	hasGender	male
William_Bradford_(Plymouth_Colony_governor)	hasGender	male
Murmansk_Airport	isConnectedTo	Sheremetyevo_International_Airport
Diogo_Douglas_Santos_Andrade_Barbosa	hasGender	male
Christian_Perez_(footballer_born_1963)	hasGender	male
Zavon_Hines	hasGender	male
Hannover_Airport	isConnectedTo	Lisbon_Portela_Airport
Port_Columbus_International_Airport	isConnectedTo	Orlando_International_Airport
Dmytro_Semochko	hasGender	male
Kevin_Roelandts	hasGender	male
Aytekin_Viduşlu	hasGender	male
Ross_McCormack	hasGender	male
Nemanja_Vučićević	hasGender	male
Ostend-Bruges_International_Airport	isConnectedTo	Málaga_Airport
Mykhaylo_Fomenko	hasGender	male
Málaga_Airport	isConnectedTo	Rygge
Koltsovo_Airport	isConnectedTo	Suvarnabhumi_Airport
Leonardo_da_Vinci–Fiumicino_Airport	isConnectedTo	Hartsfield–Jackson_Atlanta_International_Airport
Osvaldo_Nartallo	hasGender	male
Kadala_Airport	isConnectedTo	Sheremetyevo_International_Airport
Miloš_Pavlović_(footballer)	hasGender	male
Szeto_Man_Chun	hasGender	male
Bernard_Dong_Bortey	hasGender	male
Veigar_Páll_Gunnarsson	hasGender	male
Helmut_Rahn	hasGender	male
Georgi_Nemsadze	hasGender	male
Ruud_Boffin	hasGender	male
Marcone_Amaral_Costa	hasGender	male
Peter_Fear	hasGender	male
Ante_Razov	hasGender	male
Richard_O'Connor_(footballer)	hasGender	male
Don_Davis_(composer)	hasGender	male
Chengdu_Shuangliu_International_Airport	isConnectedTo	Nanchang_Changbei_International_Airport
James_McNulty_(footballer)	hasGender	male
Michael_Woods_(footballer)	hasGender	male
Yuriy_Dmytrulin	hasGender	male
Joos_Valgaeren	hasGender	male
Hannover_Airport	isConnectedTo	Burgas_Airport
Gerard_Ambassa_Guy	hasGender	male
Shanghai_Pudong_International_Airport	isConnectedTo	San_Francisco_International_Airport
Ferdinando_Sforzini	hasGender	male
Vladislav_Lemish	hasGender	male
Nestor_Combin	hasGender	male
Pablo_Alejandro_Izaguirre	hasGender	male
Ashley_Kelly	hasGender	male
Naples_International_Airport	isConnectedTo	Athens_International_Airport
Renato_Gaúcho	hasGender	male
Aamir_Khan	hasGender	male
Nelson_Abeijón	hasGender	male
Hassan_Abdel-Fattah	hasGender	male
Aleksandar_Luković	hasGender	male
New_Chitose_Airport	isConnectedTo	Incheon_International_Airport
Carlos_Castro_Mora	hasGender	male
Paul_Linz	hasGender	male
Baghdad_International_Airport	isConnectedTo	Al_Najaf_International_Airport
Munich_Airport	isConnectedTo	Erkilet_International_Airport
Billy_Semple	hasGender	male
Derek_Kevan	hasGender	male
Marcel_Hagmann	hasGender	male
Singapore_Changi_Airport	isConnectedTo	Beijing_Capital_International_Airport
Florian_Maurice	hasGender	male
Nouakchott_International_Airport	isConnectedTo	Madrid–Barajas_Airport
San_Francisco_International_Airport	isConnectedTo	Jackson_Hole_Airport
Orges_Shehi	hasGender	male
Han_Dong-won	hasGender	male
Ákos_Füzi	hasGender	male
Michael_Tönnies	hasGender	male
Tom_Parratt	hasGender	male
Trondheim_Airport,_Værnes	isConnectedTo	Gdańsk_Lech_Wałęsa_Airport
Marc_Valiente	hasGender	male
Ferenc_Plattkó	hasGender	male
Toronto_Pearson_International_Airport	isConnectedTo	Minneapolis–Saint_Paul_International_Airport
Hannover_Airport	isConnectedTo	Split_Airport
Madeira_Airport	isConnectedTo	Faro_Airport
Nilberto_da_Silva_Melo	hasGender	male
Charlie_Chaplin	hasGender	male
Andy_Preece	hasGender	male
Venice_Marco_Polo_Airport	isConnectedTo	Bordeaux–Mérignac_Airport
Nicolas_Vallar	hasGender	male
Chris_Swailes	hasGender	male
Gheorghe_Andronic	hasGender	male
Usinsk_Airport	isConnectedTo	Syktyvkar_Airport
Dushanbe_International_Airport	isConnectedTo	Chelyabinsk_Airport
Juan_Carlos_Arguedas	hasGender	male
Belfast_International_Airport	isConnectedTo	Murcia–San_Javier_Airport
Danny_Boshell	hasGender	male
Tosh_McKinlay	hasGender	male
Arvid_Smit	hasGender	male
Artyom_Yenin	hasGender	male
Darren_Tilley	hasGender	male
Cornel_Cornea	hasGender	male
Bert_Patenaude	hasGender	male
Weihai_Dashuibo_Airport	isConnectedTo	Beijing_Capital_International_Airport
Eurico_de_Aguiar_Salles_Airport	isConnectedTo	Salgado_Filho_International_Airport
Emerson_Panigutti	hasGender	male
Eduardo_Rubio	hasGender	male
Kurumoch_International_Airport	isConnectedTo	Antalya_Airport
East_Midlands_Airport	isConnectedTo	Ibiza_Airport
Keith_Scott_(footballer)	hasGender	male
Pula_Airport	isConnectedTo	Lyon–Saint_Exupéry_Airport
East_Midlands_Airport	isConnectedTo	Guernsey_Airport
Melbourne_Airport	isConnectedTo	Singapore_Changi_Airport
Gary_Hobson	hasGender	male
Édgar_Andrade	hasGender	male
Lisandro_Sacripanti	hasGender	male
Armando_Gun	hasGender	male
Dylan_Gissi	hasGender	male
Gary_Phillips_(footballer)	hasGender	male
Charles_Akonnor	hasGender	male
Dietmar_Danner	hasGender	male
Kacper_Tatara	hasGender	male
Christopher_Largen	hasGender	male
César_Aparecido_Rodrigues	hasGender	male
Fábio_Bilica	hasGender	male
Ahmed_Mubarak_Al-Mahaijri	hasGender	male
Dallas/Fort_Worth_International_Airport	isConnectedTo	Incheon_International_Airport
Marek_Čech_(Slovak_footballer)	hasGender	male
René_Dereuddre	hasGender	male
Paphos_International_Airport	isConnectedTo	Athens_International_Airport
Los_Cabos_International_Airport	isConnectedTo	Hartsfield–Jackson_Atlanta_International_Airport
Mats_Hummels	hasGender	male
James_Quinn_(footballer)	hasGender	male
Hassouneh_Al-Sheikh	hasGender	male
Serdar_Topraktepe	hasGender	male
Simon_Eldershaw	hasGender	male
Cagliari_Elmas_Airport	isConnectedTo	Pisa_International_Airport
Guly_do_Prado	hasGender	male
Luchino_Visconti	hasGender	male
Peter_McParland	hasGender	male
Sandy_Tait	hasGender	male
Jamie_Taylor	hasGender	male
Bram_Verbist	hasGender	male
Dalaman_Airport	isConnectedTo	Exeter_International_Airport
Gonzalo_Peralta	hasGender	male
Ivan_Vargić	hasGender	male
Scott_Sinclair	hasGender	male
Deniz_Baykara	hasGender	male
Istanbul_Atatürk_Airport	isConnectedTo	Malta_International_Airport
Zé_Elias	hasGender	male
Bruno_Herrero_Arias	hasGender	male
Bordeaux–Mérignac_Airport	isConnectedTo	Falcone–Borsellino_Airport
Bruno_César	hasGender	male
Damascus_International_Airport	isConnectedTo	Cairo_International_Airport
Evando	hasGender	male
Jason_Beardsley	hasGender	male
Kim_Olsen	hasGender	male
Danny_Foster_(footballer)	hasGender	male
Simon_Storey	hasGender	male
Greenville–Spartanburg_International_Airport	isConnectedTo	Washington_Dulles_International_Airport
Otto_Addo	hasGender	male
Marco_Abreu	hasGender	male
Manny_Oudin	hasGender	male
Paulino_Martínez_Soria	hasGender	male
Jason_Perry_(footballer)	hasGender	male
Tony_Butler_(footballer)	hasGender	male
Warren_Hawke	hasGender	male
Tobias_Grahn	hasGender	male
Shanghai_Pudong_International_Airport	isConnectedTo	Indira_Gandhi_International_Airport
Martin_Kolář	hasGender	male
John_Paul_II_International_Airport_Kraków–Balice	isConnectedTo	East_Midlands_Airport
Sam_Stockley	hasGender	male
Veselin_Đoković	hasGender	male
Kaio_Felipe_Gonçalves	hasGender	male
Anthony_Mann	hasGender	male
Pulkovo_Airport	isConnectedTo	Burgas_Airport
Eindhoven_Airport	isConnectedTo	Henri_Coandă_International_Airport
Brian_Parkin	hasGender	male
Terrence_Boyd	hasGender	male
Chișinău_International_Airport	isConnectedTo	Athens_International_Airport
Darko_Maletić	hasGender	male
Huenes_Marcelo_Lemos	hasGender	male
Naples_International_Airport	isConnectedTo	Skiathos_Island_National_Airport
Dan_Kennedy_(soccer)	hasGender	male
Helsinki_Airport	isConnectedTo	Bergen_Airport,_Flesland
Orlando_International_Airport	isConnectedTo	Eppley_Airfield
Ricardo_Jerez,_Jr.	hasGender	male
Nantes_Atlantique_Airport	isConnectedTo	Mohammed_V_International_Airport
Chris_Hargreaves	hasGender	male
Marek_Štěch	hasGender	male
Hamad_International_Airport	isConnectedTo	Frankfurt_Airport
Rhodes_International_Airport	isConnectedTo	Dresden_Airport
James_Riley_(soccer)	hasGender	male
Federico_Moretti	hasGender	male
Edgar_Aguilera	hasGender	male
Heraclitus	hasGender	male
Vannevar_Bush	hasGender	male
Dallas_Love_Field	isConnectedTo	George_Bush_Intercontinental_Airport
Jeff_Saibene	hasGender	male
Bengt_Andersson_(footballer)	hasGender	male
Roberto_Brum	hasGender	male
József_Eisenhoffer	hasGender	male
Pasquale_Rocco	hasGender	male
Tomi_Petrescu	hasGender	male
Vicente_Miera	hasGender	male
Frank_Fielding	hasGender	male
Ibiza_Airport	isConnectedTo	East_Midlands_Airport
Ádám_Hrepka	hasGender	male
Owen_Roberts_International_Airport	isConnectedTo	Newark_Liberty_International_Airport
Marius_Popa	hasGender	male
Ismaël_Alassane	hasGender	male
Harbin_Taiping_International_Airport	isConnectedTo	Beijing_Capital_International_Airport
Gran_Canaria_Airport	isConnectedTo	Gatwick_Airport
Philippe_Noiret	hasGender	male
Omsk_Tsentralny_Airport	isConnectedTo	Paphos_International_Airport
Sarajevo_International_Airport	isConnectedTo	Cologne_Bonn_Airport
Charles_de_Gaulle_Airport	isConnectedTo	Exeter_International_Airport
San_Francisco_International_Airport	isConnectedTo	Vancouver_International_Airport
Kevin_Miller_(ice_hockey)	hasGender	male
Francesco_Cossiga	hasGender	male
Kuala_Lumpur_International_Airport	isConnectedTo	Kota_Kinabalu_International_Airport
Albert_Kidd	hasGender	male
Francisco_Javier_Rodríguez_Vílchez	hasGender	male
Hamad_International_Airport	isConnectedTo	Jomo_Kenyatta_International_Airport
Rabat–Salé_Airport	isConnectedTo	Girona–Costa_Brava_Airport
Serdal_Güvenç	hasGender	male
Orlando_International_Airport	isConnectedTo	Indianapolis_International_Airport
Ciro_Immobile	hasGender	male
Mattias_Andersson_(footballer)	hasGender	male
Rômulo_Souza_Orestes_Caldeira	hasGender	male
Andy_Harris_(footballer)	hasGender	male
Steve_Carell	hasGender	male
Willie_Donachie	hasGender	male
Kadala_Airport	isConnectedTo	Tolmachevo_Airport
Chicago_Midway_International_Airport	isConnectedTo	Washington_Dulles_International_Airport
Pablo_Brenes	hasGender	male
London_Heathrow_Terminal_1	isConnectedTo	Brussels
Dallas/Fort_Worth_International_Airport	isConnectedTo	San_Jose_International_Airport
Jair_Céspedes	hasGender	male
Antônio_Wilson_Vieira_Honório	hasGender	male
Charles_de_Gaulle_Airport	isConnectedTo	Istanbul_Atatürk_Airport
Edward_Weah_Dixon	hasGender	male
Stélvio_Rosa_da_Cruz	hasGender	male
Sergiu_Radu	hasGender	male
Germano_Vailati	hasGender	male
Hamad_International_Airport	isConnectedTo	O._R._Tambo_International_Airport
O._R._Tambo_International_Airport	isConnectedTo	Entebbe_International_Airport
William_P._Hobby_Airport	isConnectedTo	Baltimore–Washington_International_Airport
Bradley_International_Airport	isConnectedTo	Los_Angeles_International_Airport
Belgorod_International_Airport	isConnectedTo	Vnukovo_International_Airport
George_Michael	hasGender	male
Guilin_Liangjiang_International_Airport	isConnectedTo	Kuala_Lumpur_International_Airport
Chaudhary_Charan_Singh_Airport	isConnectedTo	King_Abdulaziz_International_Airport
Chris_Holroyd	hasGender	male
Steve_David	hasGender	male
Dimitar_Makriev	hasGender	male
Aaron_Ledgister	hasGender	male
Ian_Turner_(footballer)	hasGender	male
Edinburgh_Airport	isConnectedTo	Venice_Marco_Polo_Airport
Oleg_Smolyaninov	hasGender	male
William_P._Hobby_Airport	isConnectedTo	Jacksonville_International_Airport
Mark_Stein_(footballer)	hasGender	male
Andreas_Ottl	hasGender	male
Andre_Boucaud	hasGender	male
Cologne_Bonn_Airport	isConnectedTo	Gatwick_Airport
Salvatore_Esposito	hasGender	male
Albert_I_of_Belgium	hasGender	male
Joe_Miller_(footballer)	hasGender	male
Chiranjeevi	hasGender	male
Kuala_Lumpur_International_Airport	isConnectedTo	Nagoya
Danijel_Štefulj	hasGender	male
Samuel_Kuffour	hasGender	male
Steve_Finney	hasGender	male
Marko_Simeunovič	hasGender	male
Lucas_Daniel_Wilchez	hasGender	male
Minneapolis–Saint_Paul_International_Airport	isConnectedTo	Jacksonville_International_Airport
Tony_Witter	hasGender	male
Leonardo_da_Vinci–Fiumicino_Airport	isConnectedTo	Washington_Dulles_International_Airport
Andrei_Piatnitski	hasGender	male
Justin_Morrow	hasGender	male
Raúl_Enrique_Estévez	hasGender	male
Roberto_Colombo_(footballer)	hasGender	male
John_Heitinga	hasGender	male
Fredson_Câmara_Pereira	hasGender	male
Adda_Djeziri	hasGender	male
Larnaca_International_Airport	isConnectedTo	East_Midlands_Airport
Angelo_Carbone	hasGender	male
Catania–Fontanarossa_Airport	isConnectedTo	Frankfurt_Airport
Scott_Sutter	hasGender	male
Dejan_Joksimović	hasGender	male
Carlos_de_Jésus_Júnior	hasGender	male
Vilnius_Airport	isConnectedTo	Minsk_National_Airport
Ulan-Ude_Airport	isConnectedTo	Incheon_International_Airport
Grégory_Wimbée	hasGender	male
Vienna_International_Airport	isConnectedTo	Salzburg_Airport
International_Airport_Irkutsk	isConnectedTo	Barcelona–El_Prat_Airport
Dallas/Fort_Worth_International_Airport	isConnectedTo	Los_Angeles_International_Airport
Jorge_Jesus	hasGender	male
Ajith_Kumar	hasGender	male
Stephen_King	hasGender	male
Atilio_López	hasGender	male
Oh_Beom-seok	hasGender	male
Stepan_Yurchyshyn	hasGender	male
Jacksonville_International_Airport	isConnectedTo	Minneapolis–Saint_Paul_International_Airport
Pierce_Brosnan	hasGender	male
Vanderlei_José_Alves	hasGender	male
Vágar_Airport	isConnectedTo	Sola
Angola	imports	wordnet_food_100021265
George_O'Boyle	hasGender	male
Hamed_Namouchi	hasGender	male
Lal_Bahadur_Shastri_Airport	isConnectedTo	Chhatrapati_Shivaji_International_Airport
Matej_Mavrič	hasGender	male
Taiyuan_Wusu_International_Airport	isConnectedTo	Xining_Caojiabao_Airport
Sejad_Halilović	hasGender	male
Göteborg_Landvetter_Airport	isConnectedTo	Rhodes_International_Airport
Søren_Berg	hasGender	male
Koltsovo_Airport	isConnectedTo	Heraklion_International_Airport
Sofia_Airport	isConnectedTo	Vienna_International_Airport
Oleksandr_Haydash	hasGender	male
Christian_La_Grotteria	hasGender	male
Emmanuel_Kenmogne	hasGender	male
Darío_Fernández	hasGender	male
Steve_Berry_(footballer)	hasGender	male
Tristan_Plummer	hasGender	male
Carlos_Mozer	hasGender	male
Richmond_International_Airport	isConnectedTo	George_Bush_Intercontinental_Airport
Cédric_Moukouri	hasGender	male
Pisa_International_Airport	isConnectedTo	Bari_Karol_Wojtyła_Airport
Zema_Abbey	hasGender	male
Bruce_Abdoulaye	hasGender	male
Alain_Goma	hasGender	male
Adel_El_Hadi	hasGender	male
Portland_International_Airport	isConnectedTo	Vancouver_International_Airport
Salvatore_Amirante	hasGender	male
Haneda_Airport	isConnectedTo	Chūbu_Centrair_International_Airport
Giorgi_Gakhokidze	hasGender	male
Alfreð_Finnbogason	hasGender	male
Max_Vieri	hasGender	male
Tommy_Gaynor	hasGender	male
Evilásio_Leite_da_Costa	hasGender	male
Oliver_Allen_(footballer)	hasGender	male
Marcin_Żewłakow	hasGender	male
Israel	imports	wordnet_petroleum_114980579
Vladislav_Zlatinov	hasGender	male
Shanghai_Pudong_International_Airport	isConnectedTo	London_Heathrow_Airport
London_City_Airport	isConnectedTo	Venice_Marco_Polo_Airport
Sergei_Podpaly	hasGender	male
Isidoro_San_José	hasGender	male
Chania_International_Airport	isConnectedTo	Stockholm_Skavsta_Airport
Martin_Stocklasa	hasGender	male
Tony_Towner	hasGender	male
Bobby_Gould	hasGender	male
Geovanni_Deiberson_Maurício	hasGender	male
Eppley_Airfield	isConnectedTo	Salt_Lake_City_International_Airport
Pavel_Hapal	hasGender	male
Tommy_Dunne_(footballer_born_1972)	hasGender	male
Bob_Kelso_(footballer)	hasGender	male
Driss_El-Asmar	hasGender	male
Henri_Coandă_International_Airport	isConnectedTo	Tehran_Imam_Khomeini_International_Airport
Kos_Island_International_Airport	isConnectedTo	Leeds_Bradford_International_Airport
Philippe_Vercruysse	hasGender	male
Thomas_Villadsen	hasGender	male
Congonhas-São_Paulo_Airport	isConnectedTo	Londrina_Airport
Andrey_Yeshchenko	hasGender	male
George_Nemchik	hasGender	male
Arturo_Lupoli	hasGender	male
Split_Airport	isConnectedTo	Nantes_Atlantique_Airport
Athens_International_Airport	isConnectedTo	Ben_Gurion_Airport
Beirut–Rafic_Hariri_International_Airport	isConnectedTo	Al_Najaf_International_Airport
Split_Airport	isConnectedTo	Frankfurt_Airport
Robert_Paris	hasGender	male
Repulse_Bay_Airport	isConnectedTo	Winnipeg_James_Armstrong_Richardson_International_Airport
Pedro_Contreras	hasGender	male
Taiwan_Taoyuan_International_Airport	isConnectedTo	San_Francisco_International_Airport
Cristóbal_Parralo	hasGender	male
Mevlüt_Erdinç	hasGender	male
Jack_Abbott_(author)	hasGender	male
Pavel_Kharchik	hasGender	male
Albert_Baning	hasGender	male
Edson_Rolando_Silva_Sousa	hasGender	male
Leonardo_da_Vinci–Fiumicino_Airport	isConnectedTo	Newcastle_Airport
Pinto_Martins_–_Fortaleza_International_Airport	isConnectedTo	Frankfurt_Airport
Rubin_Okotie	hasGender	male
Tocumen_International_Airport	isConnectedTo	Newark_Liberty_International_Airport
Tenerife_South_Airport	isConnectedTo	Leonardo_da_Vinci–Fiumicino_Airport
Carlos_Llamosa	hasGender	male
Neco_Martínez	hasGender	male
Zekirija_Ramadan	hasGender	male
İbrahim_Ege	hasGender	male
Marcelo_Macedo	hasGender	male
Ben_Williams_(footballer_born_1982)	hasGender	male
Madrid–Barajas_Airport	isConnectedTo	Melilla_Airport
Saif_Ali_Khan	hasGender	male
Gerry_Baker	hasGender	male
Vladislav_Ivanov_(footballer)	hasGender	male
Temur_Ketsbaia	hasGender	male
Salgado_Filho_International_Airport	isConnectedTo	Santa_Genoveva_Airport
Chengdu_Shuangliu_International_Airport	isConnectedTo	Nanyang_Jiangying_Airport
Gábor_Gerstenmájer	hasGender	male
Isle_of_Man_Airport	isConnectedTo	Newcastle_Airport
Poon_Yiu_Cheuk	hasGender	male
Lublin_Airport	isConnectedTo	Sandefjord_Airport,_Torp
Heydar_Aliyev_International_Airport	isConnectedTo	Vienna_International_Airport
Óscar_López_Hernández	hasGender	male
Zvartnots_International_Airport	isConnectedTo	Saratov_Tsentralny_Airport
Héctor_Almandoz	hasGender	male
Romanus_Orjinta	hasGender	male
Bernard_Genghini	hasGender	male
Jackie_Sinclair	hasGender	male
Seo_Jung-won	hasGender	male
Osmar_Ferreyra	hasGender	male
Lyon–Saint_Exupéry_Airport	isConnectedTo	Ibiza_Airport
Ronny_Levy	hasGender	male
Chengdu_Shuangliu_International_Airport	isConnectedTo	Nantong_Xingdong_Airport
Glasgow_Prestwick_Airport	isConnectedTo	Chania_International_Airport
Yakutsk_Airport	isConnectedTo	Kadala_Airport
Tenerife_South_Airport	isConnectedTo	Bordeaux–Mérignac_Airport
Srebrenko_Posavec	hasGender	male
Cyril_Chapuis	hasGender	male
Elizabeth_II	isLeaderOf	Australia
Julien_Hornuss	hasGender	male
Chania_International_Airport	isConnectedTo	Trondheim_Airport,_Værnes
William_Maxwell_(footballer)	hasGender	male
Joel_Schumacher	hasGender	male
Fabián_Estay	hasGender	male
Jon_Ashton	hasGender	male
Thomas_Aquinas	hasGender	male
Norio_Omura	hasGender	male
Pablo_Lanz	hasGender	male
Marcel_Podszus	hasGender	male
Dimitris_Zouliotis	hasGender	male
Ricardo_Pinto_(footballer)	hasGender	male
Ertan_Demiri	hasGender	male
Yemelyanovo_International_Airport	isConnectedTo	Goa_International_Airport
Cosmin_Pașcovici	hasGender	male
Rijeka_Airport	isConnectedTo	Stuttgart_Airport
Edinburgh_Airport	isConnectedTo	Stockholm_Arlanda_Airport
Qingdao_Liuting_International_Airport	isConnectedTo	Gimhae_International_Airport
Élie_Metchnikoff	hasGender	male
Árpád_Fekete	hasGender	male
Curtis_LeMay	hasGender	male
Titi_Buengo	hasGender	male
Nicky_Nicolau	hasGender	male
Greg_Vanney	hasGender	male
Hans_Aabech	hasGender	male
Chris_Timons	hasGender	male
Bruno_Gama	hasGender	male
Philippe_Pétain	hasGender	male
Graham_Barrett	hasGender	male
Finidi_George	hasGender	male
Darío_Flores	hasGender	male
Vienna_International_Airport	isConnectedTo	Athens_International_Airport
Calgary_International_Airport	isConnectedTo	Denver_International_Airport
Keflavík_International_Airport	isConnectedTo	Sola
Tan_Son_Nhat_International_Airport	isConnectedTo	Boryspil_International_Airport
Arkadiusz_Onyszko	hasGender	male
Darren_Hare	hasGender	male
Bologna_Guglielmo_Marconi_Airport	isConnectedTo	Girona–Costa_Brava_Airport
Charles_de_Gaulle_Airport	isConnectedTo	Zvartnots_International_Airport
Colin_Todd	hasGender	male
Albert_Streit	hasGender	male
John_Impey	hasGender	male
Gary_Forrester	hasGender	male
Sunday_Ibrahim	hasGender	male
Kevin_Dillon_(footballer)	hasGender	male
Henry_Fa'arodo	hasGender	male
Gary_Waddock	hasGender	male
Radek_Šírl	hasGender	male
Serhiy_Harashchenkov	hasGender	male
Wilson_Mathías	hasGender	male
Igor_Souza	hasGender	male
Malpensa_Airport	isConnectedTo	Tehran_Imam_Khomeini_International_Airport
Surgut_International_Airport	isConnectedTo	Dushanbe_International_Airport
Laurie_Abrahams	hasGender	male
Chhatrapati_Shivaji_International_Airport	isConnectedTo	Tehran_Imam_Khomeini_International_Airport
Helsinki_Airport	isConnectedTo	Pisa_International_Airport
Emmanuel_Ekpo	hasGender	male
Oleksiy_Yakymenko	hasGender	male
Änis_Ben-Hatira	hasGender	male
Darren_Kelly	hasGender	male
Stefan_Bailey	hasGender	male
Luigi_Lavecchia	hasGender	male
Volgograd_International_Airport	isConnectedTo	Krasnodar_International_Airport
Hermanni_Vuorinen	hasGender	male
Zahir_Zerdab	hasGender	male
Tore_André_Flo	hasGender	male
Grégory_Tadé	hasGender	male
Calgary_International_Airport	isConnectedTo	Minneapolis–Saint_Paul_International_Airport
Chen_Tao_(footballer)	hasGender	male
Zhao_Xuri	hasGender	male
Amido_Baldé	hasGender	male
Hyun_Young-min	hasGender	male
Miloš_Šestić	hasGender	male
Franz_Carr	hasGender	male
Chūbu_Centrair_International_Airport	isConnectedTo	Kagoshima_Airport
Miroslav_Grumić	hasGender	male
Eduardo_Ferreira	hasGender	male
Dinei_(footballer_born_1983)	hasGender	male
Altimont_Butler	hasGender	male
Ciampino–G._B._Pastine_International_Airport	isConnectedTo	Glasgow_Prestwick_Airport
Viru_Viru_International_Airport	isConnectedTo	Marechal_Rondon_International_Airport
Adrian_Popa_(footballer_born_1988)	hasGender	male
Mark_Birighitti	hasGender	male
Sandro_Silva	hasGender	male
Bristol_Airport	isConnectedTo	Edinburgh_Airport
Antalya_Airport	isConnectedTo	Atyrau_Airport
Erich_Ribbeck	hasGender	male
Andreas_Sørensen	hasGender	male
Paweł_Buśkiewicz	hasGender	male
Max_Weber	hasGender	male
Darryl_Powell	hasGender	male
Stefan_Kuntz	hasGender	male
Wilfrid_Loizeau	hasGender	male
Andreas_Augustsson	hasGender	male
Kobi_Hassan	hasGender	male
Hennadiy_Perepadenko	hasGender	male
Jock_Wightman	hasGender	male
Málaga_Airport	isConnectedTo	Oslo_Airport,_Gardermoen
Cardiff_Airport	isConnectedTo	Edinburgh_Airport
Roger_Magnusson	hasGender	male
Erikson_Noguchipinto	hasGender	male
Sylvain_Marchal	hasGender	male
Stanley_B._Prusiner	hasGender	male
Har_Gobind_Khorana	hasGender	male
Tenerife_South_Airport	isConnectedTo	Sandefjord_Airport,_Torp
Gaston_Doumergue	hasGender	male
Don_Mueang_International_Airport	isConnectedTo	Chennai_International_Airport
Tommy_Fleming_(soccer)	hasGender	male
Treviso_Airport	isConnectedTo	Moss_Airport,_Rygge
Burgas_Airport	isConnectedTo	Warsaw_Chopin_Airport
Javed_Jaffrey	hasGender	male
Frankfurt_Airport	isConnectedTo	Edinburgh_Airport
Cha_Du-ri	hasGender	male
Heraklion_International_Airport	isConnectedTo	Stockholm_Arlanda_Airport
Carlos_Adrián_Morales	hasGender	male
Dushanbe_International_Airport	isConnectedTo	Begishevo_Airport
Andy_Walker_(footballer_born_1965)	hasGender	male
Klaus_Berggreen	hasGender	male
Luis_del_Sol	hasGender	male
Massih_Wassey	hasGender	male
Stefano_Seedorf	hasGender	male
Tomáš_Necid	hasGender	male
Gimhae_International_Airport	isConnectedTo	Tan_Son_Nhat_International_Airport
Reinaldo_Elias_da_Costa	hasGender	male
Roman_Kontsedalov	hasGender	male
Bill_Pickering	hasGender	male
Mackay_Airport	isConnectedTo	Melbourne_Airport
Clifford_Geertz	hasGender	male
Róbert_Vittek	hasGender	male
Romain_Larrieu	hasGender	male
Hans-Jürgen_Kurrat	hasGender	male
Mariscal_Sucre_International_Airport	isConnectedTo	Madrid–Barajas_Airport
Lee_Keun-ho	hasGender	male
Cairns_Airport	isConnectedTo	Melbourne_Airport
Steve_Kabba	hasGender	male
Darío_Pereyra	hasGender	male
William_P._Hobby_Airport	isConnectedTo	Fort_Lauderdale–Hollywood_International_Airport
G._K._Chesterton	hasGender	male
Ibrahima_Diallo	hasGender	male
Jorge_Chávez_International_Airport	isConnectedTo	Salgado_Filho_International_Airport
Fidel_V._Ramos	hasGender	male
Vasileios_Pliatsikas	hasGender	male
Robert_Acquafresca	hasGender	male
Mika_Nurmela	hasGender	male
Elkin_Murillo	hasGender	male
Manú_(footballer)	hasGender	male
Georg_Zellhofer	hasGender	male
Terry_Cooke	hasGender	male
Pulkovo_Airport	isConnectedTo	Malpensa_Airport
Derek_Jacobi	hasGender	male
Herve_Xavier_Zengue	hasGender	male
Peter_Thomas_(footballer_born_1944)	hasGender	male
Ebrima_Ebou_Sillah	hasGender	male
Werner_Lorant	hasGender	male
Leonardo_Fernández	hasGender	male
Everton_Bilher	hasGender	male
Łukasz_Tumicz	hasGender	male
Mário_Sérgio	hasGender	male
Donatas_Vencevičius	hasGender	male
Ronny_Goodlass	hasGender	male
Harry_Osman	hasGender	male
Al_Najaf_International_Airport	isConnectedTo	Mashhad_International_Airport
Mike_Newell_(footballer)	hasGender	male
Mark_Prudhoe	hasGender	male
Belfast_International_Airport	isConnectedTo	Gatwick_Airport
Juan_Manuel_Barrero_Barrero	hasGender	male
Matty_McNeil	hasGender	male
Graham_Fenton	hasGender	male
Mohammad-Esmail_Nazari	hasGender	male
Federico_Fazio	hasGender	male
Matt_Richards_(footballer_born_1984)	hasGender	male
Kahului_Airport	isConnectedTo	Oakland_International_Airport
Wellington_Katzor_de_Oliveira	hasGender	male
Ibrahim_Ba	hasGender	male
Gábor_Király	hasGender	male
Juan_Quarterone	hasGender	male
Kurumoch_International_Airport	isConnectedTo	Saratov_Tsentralny_Airport
Laurent_Lanteri	hasGender	male
Esenboğa_International_Airport	isConnectedTo	Heraklion_International_Airport
Luboš_Kozel	hasGender	male
Tiago_Luís	hasGender	male
Baltimore–Washington_International_Airport	isConnectedTo	Albuquerque_International_Sunport
Rio_Alderton	hasGender	male
Phil_Alexander	hasGender	male
Marcelo_Labarthe	hasGender	male
Alexandre_Luiz_Goulart	hasGender	male
Tomáš_Došek	hasGender	male
Mario_Tičinović	hasGender	male
Alfred_Molina	hasGender	male
Fernando_Horácio_Ávalos	hasGender	male
Germán_Carty	hasGender	male
Behzad_Gholampour	hasGender	male
Habib_Bellaïd	hasGender	male
Jorge_Araujo	hasGender	male
Eddy_Baggio	hasGender	male
Cairo_International_Airport	isConnectedTo	Munich_Airport
Burgess_Meredith	hasGender	male
Frankfurt_Airport	isConnectedTo	Noi_Bai_International_Airport
Selemani_Ndikumana	hasGender	male
John_Doyle_(soccer)	hasGender	male
Cairo_International_Airport	isConnectedTo	Budapest_Ferenc_Liszt_International_Airport
Yantai_Laishan_International_Airport	isConnectedTo	Beijing_Capital_International_Airport
Muhamad_Kaironnisam_Sahabudin_Hussain	hasGender	male
Los_Cabos_International_Airport	isConnectedTo	Phoenix_Sky_Harbor_International_Airport
Martinique_Aimé_Césaire_International_Airport	isConnectedTo	Piarco_International_Airport
Allan_Wanga	hasGender	male
Glyn_Garner	hasGender	male
Jajá	hasGender	male
Felipe_de_Souza_Campos	hasGender	male
Macoumba_Kandji	hasGender	male
Dani_Rodrigues	hasGender	male
Baghdad_International_Airport	isConnectedTo	Hamad_International_Airport
Zakhar_Dubensky	hasGender	male
José_Antonio_Roca	hasGender	male
Tyler_Hemming	hasGender	male
Brian_Healy_(footballer)	hasGender	male
Andrei_Zygmantovich	hasGender	male
Hennie_Meijer	hasGender	male
Windsor_Noncent	hasGender	male
Paphos_International_Airport	isConnectedTo	Glasgow_Airport
Bassala_Touré	hasGender	male
Giuseppe_Baldini	hasGender	male
Benik_Afobe	hasGender	male
Johnny_Fullam	hasGender	male
Alan_Edward_Davidson	hasGender	male
Roshchino_International_Airport	isConnectedTo	Salekhard_Airport
Antalya_Airport	isConnectedTo	Dresden_Airport
Steve_Purdy	hasGender	male
Louis_Gomis_(footballer_born_1974)	hasGender	male
Eric_Young_(footballer)	hasGender	male
Dave_Hickson	hasGender	male
Cardiff_Airport	isConnectedTo	Larnaca_International_Airport
Rui_Miguel	hasGender	male
Ruslan_Fomin	hasGender	male
Salim_Tuama	hasGender	male
Erick_Flores	hasGender	male
Gallego_(footballer)	hasGender	male
Madrid–Barajas_Airport	isConnectedTo	Ciampino–G._B._Pastine_International_Airport
Copenhagen_Airport	isConnectedTo	Innsbruck_Airport
Dariusz_Wdowczyk	hasGender	male
Andy_O'Brien_(footballer)	hasGender	male
Sabiha_Gökçen_International_Airport	isConnectedTo	Narimanovo_Airport
Hamad_International_Airport	isConnectedTo	Houari_Boumediene_Airport
Ademola_Okulaja	hasGender	male
Shenyang_Taoxian_International_Airport	isConnectedTo	Changsha_Huanghua_International_Airport
Nzelo_Hervé_Lembi	hasGender	male
John_Paul_II_International_Airport_Kraków–Balice	isConnectedTo	Frankfurt_Airport
Nathan_Ashton	hasGender	male
Sophiane_Baghdad	hasGender	male
El_Dorado_International_Airport	isConnectedTo	Rafael_Hernández_Airport
Juan_Sebastián_Botero	hasGender	male
Alan_Sheehan	hasGender	male
Paul_Byrne_(footballer_born_1986)	hasGender	male
Tim_Wiese	hasGender	male
José_María_Movilla	hasGender	male
Robbie_Threlfall	hasGender	male
Shaun_Maher	hasGender	male
Emeka_Nwadike	hasGender	male
Michele_Ischia	hasGender	male
Rhodes_International_Airport	isConnectedTo	Newcastle_Airport
Ousseni_Zongo	hasGender	male
Scott_Cannon	hasGender	male
Daniel_Fernández_Artola	hasGender	male
Richard_Sukuta-Pasu	hasGender	male
David_Freeman_(Irish_footballer)	hasGender	male
Gonzalo_Garavano	hasGender	male
Christophe_Dugarry	hasGender	male
Obiora_Odita	hasGender	male
László_Bálint	hasGender	male
San_Francisco_International_Airport	isConnectedTo	Tri-Cities_Airport_(Washington)
Boudewijn_de_Geer	hasGender	male
Pyotr_Gitselov	hasGender	male
Les_Chapman	hasGender	male
Warren_Feeney	hasGender	male
Copenhagen_Airport	isConnectedTo	Turku_Airport
Newcastle_Airport	isConnectedTo	Gatwick_Airport
Adamu_Mohammed	hasGender	male
Ivan_Radovanović	hasGender	male
R._D._Burman	hasGender	male
Chengdu_Shuangliu_International_Airport	isConnectedTo	Guangzhou_Baiyun_International_Airport
Al_Najaf_International_Airport	isConnectedTo	Baghdad_International_Airport
Jakob_Friis-Hansen	hasGender	male
André_Luiz_de_Oliveira_Regatieri	hasGender	male
Ticão	hasGender	male
Bristol_Airport	isConnectedTo	Larnaca_International_Airport
Nabil_Abidallah	hasGender	male
Washington_Dulles_International_Airport	isConnectedTo	Vancouver_International_Airport
Mustafa_Merry	hasGender	male
Mohd_Saufi_Ibrahim	hasGender	male
Richard_Money	hasGender	male
Justin_Walker_(footballer)	hasGender	male
Cristián_Muñoz	hasGender	male
Billy_Manuel	hasGender	male
Slavko_Perović_(footballer)	hasGender	male
Marko_Vejinović	hasGender	male
Peter_Hawkins_(footballer)	hasGender	male
Oleksandr_Kosyrin	hasGender	male
Munich_Airport	isConnectedTo	Vienna_International_Airport
Riccardo_Colombo	hasGender	male
Stavanger_Airport,_Sola	isConnectedTo	Salzburg_Airport
Vnukovo_International_Airport	isConnectedTo	Talagi_Airport
Ihor_Korniyets	hasGender	male
Isaac_Romo	hasGender	male
Judd_Apatow	hasGender	male
David_Tong	hasGender	male
Milton_Friedman	hasGender	male
Eusebio_Di_Francesco	hasGender	male
Tolmachevo_Airport	isConnectedTo	Munich_Airport
Miroslav_Čermelj	hasGender	male
Joe_Jordan_(footballer)	hasGender	male
Chelyabinsk_Airport	isConnectedTo	International_Airport_Irkutsk
Calgary_International_Airport	isConnectedTo	Manchester_Airport
Peter_Thorne_(footballer)	hasGender	male
Magnus_Eriksson_(footballer_born_1990)	hasGender	male
Júnior_Baiano	hasGender	male
Ilija_Katić	hasGender	male
Noi_Bai_International_Airport	isConnectedTo	Don_Mueang_International_Airport
Christchurch_International_Airport	isConnectedTo	Melbourne_Airport
Leon_Knight	hasGender	male
Jörg_Kretzschmar	hasGender	male
Malta_International_Airport	isConnectedTo	Linate_Airport
Toronto_Pearson_International_Airport	isConnectedTo	Beijing_Capital_International_Airport
Giorgio_Corona	hasGender	male
Naples_International_Airport	isConnectedTo	Tarbes–Lourdes–Pyrénées_Airport
Baltimore–Washington_International_Airport	isConnectedTo	Cleveland_Hopkins_International_Airport
Lounès_Gaouaoui	hasGender	male
Boldizsár_Bodor	hasGender	male
Claudio_Reyna	hasGender	male
Menorca_Airport	isConnectedTo	Robin_Hood_Airport_Doncaster_Sheffield
Brima_Koroma	hasGender	male
Nicolás_Peric	hasGender	male
Rob_Elvins	hasGender	male
Aleksandar_Kristić	hasGender	male
Heraklion_International_Airport	isConnectedTo	Pulkovo_Airport
Kadala_Airport	isConnectedTo	Ulan-Ude_Airport
Shai_Biruk	hasGender	male
King_Abdulaziz_International_Airport	isConnectedTo	Asmara_International_Airport
Surgut_International_Airport	isConnectedTo	Pulkovo_Airport
Diego_Balbinot	hasGender	male
Paul_Crichton	hasGender	male
Fazrul_Nawaz	hasGender	male
King_Abdulaziz_International_Airport	isConnectedTo	Penang_International_Airport
Kevin_McDonald_(footballer,_born_1985)	hasGender	male
Daniel_Antúnez	hasGender	male
Orlando_International_Airport	isConnectedTo	Southwest_Florida_International_Airport
Kansai_International_Airport	isConnectedTo	Melbourne_Airport
Barry_Ferguson_(Irish_footballer)	hasGender	male
Henry_Damián_Giménez	hasGender	male
Washington_Dulles_International_Airport	isConnectedTo	Jacksonville_International_Airport
Chris_Crowe	hasGender	male
Málaga_Airport	isConnectedTo	Il_Caravaggio_International_Airport
Henri_Coandă_International_Airport	isConnectedTo	Cologne_Bonn_Airport
Lyon–Saint_Exupéry_Airport	isConnectedTo	Brest_Bretagne_Airport
Martin_Fabuš	hasGender	male
Lino_Marzoratti	hasGender	male
Juan_Manuel_Cavallo	hasGender	male
Peter_Beadle	hasGender	male
Rhodes_International_Airport	isConnectedTo	Bristol_Airport
Fernando_Meneses	hasGender	male
Guangzhou_Baiyun_International_Airport	isConnectedTo	Kuala_Lumpur_International_Airport
Manolo_Pestrin	hasGender	male
Vitaliy_Denisov	hasGender	male
Dushanbe_International_Airport	isConnectedTo	Guangzhou_Baiyun_International_Airport
Pinto_Martins_–_Fortaleza_International_Airport	isConnectedTo	Recife/Guararapes–Gilberto_Freyre_International_Airport
Alfred_N'Diaye	hasGender	male
Ibrahim_Said	hasGender	male
Max_von_Laue	hasGender	male
Sabiha_Gökçen_International_Airport	isConnectedTo	Krasnodar_International_Airport
Theofanis_Gekas	hasGender	male
André-Joël_Eboué	hasGender	male
Claus_Jensen	hasGender	male
Óscar_Sánchez_Fuentes	hasGender	male
Burgas_Airport	isConnectedTo	Oslo_Airport,_Gardermoen
Ryan_Baldacchino	hasGender	male
Jakob_Poulsen	hasGender	male
Simon_Cox_(footballer,_born_1987)	hasGender	male
Rolando_Escobar	hasGender	male
Eindhoven_Airport	isConnectedTo	Barcelona–El_Prat_Airport
Pula_Airport	isConnectedTo	Nantes_Atlantique_Airport
Heleno_dos_Santos_Alves	hasGender	male
Teemu_Pukki	hasGender	male
Tintín_Márquez	hasGender	male
Dalaman_Airport	isConnectedTo	Ben_Gurion_Airport
Aberdeen_Airport	isConnectedTo	Tenerife_South_Airport
Joe_Cockroft	hasGender	male
Luigi_Di_Biagio	hasGender	male
Haris_Vučkić	hasGender	male
Cephalonia_International_Airport	isConnectedTo	Manchester_Airport
Pulkovo_Airport	isConnectedTo	Belgorod_International_Airport
Toronto_Pearson_International_Airport	isConnectedTo	Jorge_Chávez_International_Airport
Gilberto_Galdino_dos_Santos	hasGender	male
Jean_Fernandez	hasGender	male
Sergey_Viktorovich_Ryzhikov	hasGender	male
Malpensa_Airport	isConnectedTo	Indira_Gandhi_International_Airport
Luciano_Leguizamón	hasGender	male
Harold_Ellis_(basketball)	hasGender	male
Reto_Ziegler	hasGender	male
Chengdu_Shuangliu_International_Airport	isConnectedTo	Guiyang_Longdongbao_International_Airport
Poznań–Ławica_Airport	isConnectedTo	Warsaw_Chopin_Airport
Malpensa_Airport	isConnectedTo	Bari_Karol_Wojtyła_Airport
Fikru_Teferra	hasGender	male
Luis_Artime	hasGender	male
Leonardo_Migliónico	hasGender	male
Frank_Zappa	hasGender	male
Conor_Kenna	hasGender	male
Genki_Nagasato	hasGender	male
Maksym_Startsev	hasGender	male
Chicago_Midway_International_Airport	isConnectedTo	William_P._Hobby_Airport
Barcelona–El_Prat_Airport	isConnectedTo	El_Dorado_International_Airport
Nicolás_Diez	hasGender	male
Ciampino–G._B._Pastine_International_Airport	isConnectedTo	Paphos_International_Airport
Yakiv_Zalevskyi	hasGender	male
Pius_Ikedia	hasGender	male
Florian_Rudy	hasGender	male
Georgi_Sarmov	hasGender	male
Isaac_Cuenca	hasGender	male
Alan_Alda	hasGender	male
Naples_International_Airport	isConnectedTo	Nice_Côte_d'Azur_Airport
Istanbul_Atatürk_Airport	isConnectedTo	Bandaranaike_International_Airport
Ernst_Happel	hasGender	male
Fabrizio_Grillo	hasGender	male
Jajá_(Brazilian_footballer)	hasGender	male
Otto_Luttrop	hasGender	male
Burhanettin_Kaymak	hasGender	male
Istanbul_Atatürk_Airport	isConnectedTo	Los_Angeles_International_Airport
Damian_Spencer	hasGender	male
Juma_Mossi	hasGender	male
Valentine_Atem	hasGender	male
Levent_Osman	hasGender	male
Fred_Benson	hasGender	male
Óscar_Fabbiani	hasGender	male
Frankfurt_Airport	isConnectedTo	Split_Airport
Talal_Khalfan	hasGender	male
Majdi_Siddiq	hasGender	male
Riccardo_Meggiorini	hasGender	male
Hage_Geingob	hasGender	male
Mick_O'Brien_(footballer_born_1893)	hasGender	male
Peter_Skouras	hasGender	male
Wasiu_Taiwo	hasGender	male
Dublin_Airport	isConnectedTo	Chania_International_Airport
Lek_Kćira	hasGender	male
Viktor_Pasulko	hasGender	male
Málaga_Airport	isConnectedTo	Glasgow_Prestwick_Airport
Wuhan_Tianhe_International_Airport	isConnectedTo	San_Francisco_International_Airport
Ilyos_Zeytulayev	hasGender	male
Davy_Larmour	hasGender	male
Toronto_Pearson_International_Airport	isConnectedTo	Halifax_Stanfield_International_Airport
Valentīns_Lobaņovs	hasGender	male
Canada	imports	wordnet_chemical_114806838
Bologna_Guglielmo_Marconi_Airport	isConnectedTo	Bordeaux–Mérignac_Airport
Christoph_Daum	hasGender	male
Géza_Kalocsay	hasGender	male
Philadelphia_International_Airport	isConnectedTo	Minneapolis–Saint_Paul_International_Airport
Tim_O'Shea_(footballer)	hasGender	male
Aden_International_Airport	isConnectedTo	Istanbul_Atatürk_Airport
Frankfurt_Airport	isConnectedTo	Aberdeen_Airport
Frankfurt_Airport	isConnectedTo	Heraklion_International_Airport
Leon_Jeanne	hasGender	male
Bjarni_Guðjónsson	hasGender	male
Ethiopia	imports	wordnet_motor_vehicle_103791235
Kalamata_International_Airport	isConnectedTo	Ben_Gurion_Airport
Derlei	hasGender	male
Vata_Matanu_Garcia	hasGender	male
Joe_Haverty	hasGender	male
Alex_Pearce	hasGender	male
Arsène_Oka	hasGender	male
Tulsa_International_Airport	isConnectedTo	George_Bush_Intercontinental_Airport
Joris_Mathijsen	hasGender	male
Gary_Rogers	hasGender	male
Mircea_Lucescu	hasGender	male
Sofia_Airport	isConnectedTo	Prague_Václav_Havel_Airport
Pulkovo_Airport	isConnectedTo	Larnaca_International_Airport
Andy_Ritchie_(Scottish_footballer)	hasGender	male
Salzburg_Airport	isConnectedTo	Flesland
Marius_Stankevičius	hasGender	male
Timothy_van_der_Meulen	hasGender	male
Ederson_Honorato_Campos	hasGender	male
Shenzhen_Bao'an_International_Airport	isConnectedTo	Chongqing_Jiangbei_International_Airport
Gábor_Demjén	hasGender	male
Simone_Pavan	hasGender	male
Münster_Osnabrück_International_Airport	isConnectedTo	Bremen_Airport
Ante_Jurić	hasGender	male
Kansai_International_Airport	isConnectedTo	Fukuoka_Airport
Sandefjord_Airport,_Torp	isConnectedTo	Sola
Marco_Aurélio_Pereira_Alves	hasGender	male
Richard_Wood_(footballer)	hasGender	male
Robert_Rico	hasGender	male
Luís_Alberto_da_Silva_Lemos	hasGender	male
Giuseppe_Vives	hasGender	male
Franck_Songo'o	hasGender	male
Peter_Babnič	hasGender	male
Agnaldo_Cordeiro_Pereira	hasGender	male
Mircea_Cărtărescu	hasGender	male
Jaroslav_Šilhavý	hasGender	male
East_Midlands_Airport	isConnectedTo	Chania_International_Airport
Vnukovo_International_Airport	isConnectedTo	Leonardo_da_Vinci–Fiumicino_Airport
Foeke_Booy	hasGender	male
Niall_Thompson	hasGender	male
Nicola_Pozzi	hasGender	male
Marek_Czakon	hasGender	male
Shenzhen_Bao'an_International_Airport	isConnectedTo	Guiyang_Longdongbao_International_Airport
George_Ley	hasGender	male
Alessandro_Scanziani	hasGender	male
Omar_Daley	hasGender	male
Julio_José_Iglesias_Rouget	hasGender	male
Tolmachevo_Airport	isConnectedTo	Vladivostok_International_Airport
Leite_Lopes_Airport	isConnectedTo	Marechal_Rondon_International_Airport
Prabhu_(actor)	hasGender	male
Beirut–Rafic_Hariri_International_Airport	isConnectedTo	Gazipaşa_Airport
Roy_Hodgson	hasGender	male
Nicolae_Iorga	hasGender	male
Rafael_Gonçalves_Toledo	hasGender	male
Martin_Rueda	hasGender	male
Aaron_Ramsey	hasGender	male
Johnny_Warren	hasGender	male
Belfast_International_Airport	isConnectedTo	Larnaca_International_Airport
Paolo_Barison	hasGender	male
Dzaoudzi_Pamandzi_International_Airport	isConnectedTo	Jomo_Kenyatta_International_Airport
Robin_Hood_Airport_Doncaster_Sheffield	isConnectedTo	George_Best_Belfast_City_Airport
Julio_Alcorsé	hasGender	male
Serhiy_Snytko	hasGender	male
Mario_Saralegui	hasGender	male
Michael_Zeyer	hasGender	male
Uli_Hoeneß	hasGender	male
Sebastián_Grazzini	hasGender	male
Sergey_Grishin_(footballer,_born_1973)	hasGender	male
Kuala_Lumpur_International_Airport	isConnectedTo	Kansai_International_Airport
Preki	hasGender	male
Vincenzo_Sarno	hasGender	male
Vladimir_Arnold	hasGender	male
Brian_Joicey	hasGender	male
Split_Airport	isConnectedTo	Stavanger_Airport,_Sola
Matteo_Darmian	hasGender	male
Glasgow_Prestwick_Airport	isConnectedTo	Barcelona–El_Prat_Airport
Nice_Côte_d'Azur_Airport	isConnectedTo	Manchester_Airport
Dan_Connor_(footballer)	hasGender	male
Bobby_Mimms	hasGender	male
Alberto_Comazzi	hasGender	male
Shenzhen_Bao'an_International_Airport	isConnectedTo	Singapore_Changi_Airport
Lee_Wai_Man	hasGender	male
James_McKeown	hasGender	male
Jorge_Curbelo	hasGender	male
Mohamed_Diamé	hasGender	male
Xu_Liang	hasGender	male
Matt_Hocking	hasGender	male
Rodger_Wylde	hasGender	male
Lyon–Saint_Exupéry_Airport	isConnectedTo	Split_Airport
Hamad_International_Airport	isConnectedTo	Dallas/Fort_Worth_International_Airport
Hans_Denissen	hasGender	male
Delfí_Geli	hasGender	male
Munich_Airport	isConnectedTo	Ben_Gurion_Airport
Skopje_\u0022Alexander_the_Great\u0022_Airport	isConnectedTo	Dortmund_Airport
Ian_Henderson_(footballer)	hasGender	male
Levan_Tskitishvili	hasGender	male
Carlos_Alberto_Torres	hasGender	male
Chris_Adamson	hasGender	male
Jerome_Jordan	hasGender	male
Sabiha_Gökçen_International_Airport	isConnectedTo	Erkilet_International_Airport
Luís_Fernando_Martinez	hasGender	male
Stavanger_Airport,_Sola	isConnectedTo	Aberdeen_Airport
Juan_José_Blanco	hasGender	male
Nasir_Lamine	hasGender	male
Pavel_Rosa	hasGender	male
Krasnodar_International_Airport	isConnectedTo	Vladivostok_International_Airport
Andy_Crosby	hasGender	male
Obinna_Nwaneri	hasGender	male
Girona–Costa_Brava_Airport	isConnectedTo	Luton_Airport
Andy_Thorn_(footballer)	hasGender	male
Nejc_Pečnik	hasGender	male
Danny_Mills	hasGender	male
Yacine_Amaouche	hasGender	male
Misrata_Airport	isConnectedTo	Mohammed_V_International_Airport
Peter_Shilton	hasGender	male
Lee_Holmes	hasGender	male
Junior_Lewis	hasGender	male
Peter_Clarke_(footballer)	hasGender	male
Tarik_El_Taib	hasGender	male
Mokhtar_Benmoussa	hasGender	male
Michael_Tommy_(footballer)	hasGender	male
Leonardo_da_Vinci–Fiumicino_Airport	isConnectedTo	Warsaw_Chopin_Airport
Jacques_Derrida	hasGender	male
François_Marque	hasGender	male
Tenerife_South_Airport	isConnectedTo	Salzburg_Airport
Geert_Meijer	hasGender	male
Ignacio_Camacho	hasGender	male
Ottawa_Macdonald–Cartier_International_Airport	isConnectedTo	Frankfurt_Airport
Frank_Morgan	hasGender	male
Haneda_Airport	isConnectedTo	New_Chitose_Airport
Serhiy_Kuznetsov_(footballer_born_1950)	hasGender	male
Marcelino_Galoppo	hasGender	male
Hunter_Freeman	hasGender	male
Bruno_Giordano	hasGender	male
Qiqihar_Sanjiazi_Airport	isConnectedTo	Guangzhou_Baiyun_International_Airport
Pascal_Mendy	hasGender	male
Alejandro_Lanari	hasGender	male
Borislav_Dichev	hasGender	male
Baltimore–Washington_International_Airport	isConnectedTo	Kansas_City_International_Airport
Pierre_Kanstrup	hasGender	male
Renato_Pilipović	hasGender	male
Luis_de_la_Fuente	hasGender	male
Ürümqi_Diwopu_International_Airport	isConnectedTo	Tehran_Imam_Khomeini_International_Airport
Henri_Bienvenu	hasGender	male
John_Gardiner_(footballer_born_1958)	hasGender	male
Kevin_Summerfield	hasGender	male
Rob_Beckwith	hasGender	male
Iliya_Nikolov	hasGender	male
Subrahmanyan_Chandrasekhar	hasGender	male
Bledar_Kola	hasGender	male
Giulio_Andreotti	isLeaderOf	Christian_Democracy_(Italy)
Ronald_Pablo_Baroni	hasGender	male
Jérémie_Bréchet	hasGender	male
Queen_Alia_International_Airport	isConnectedTo	Indira_Gandhi_International_Airport
Long_Island_MacArthur_Airport	isConnectedTo	Orlando_International_Airport
Mirosław_Dreszer	hasGender	male
Jonny_Brain	hasGender	male
Bledar_Devolli	hasGender	male
Marcelo_Antônio_Guedes_Filho	hasGender	male
Jacek_Gmoch	hasGender	male
Egidijus_Majus	hasGender	male
Piarco_International_Airport	isConnectedTo	Maurice_Bishop_International_Airport
Göteborg_City_Airport	isConnectedTo	Warsaw_Chopin_Airport
Los_Angeles_International_Airport	isConnectedTo	Minneapolis–Saint_Paul_International_Airport
Tampa_International_Airport	isConnectedTo	Dallas_Love_Field
Peter_Dzúrik	hasGender	male
Pedro_Miguel_da_Silva_Mendes	hasGender	male
Damián_Escudero	hasGender	male
William_Thomson,_1st_Baron_Kelvin	hasGender	male
Saša_Jovanović	hasGender	male
Andy_Taylor_(footballer,_born_1986)	hasGender	male
Vilnius_Airport	isConnectedTo	Liverpool_John_Lennon_Airport
Manuel_Preciado_Rebolledo	hasGender	male
Lucas_Severino	hasGender	male
Paolo_Sammarco	hasGender	male
İlhan_Mansız	hasGender	male
Thomas_Hitzlsperger	hasGender	male
Ingmar_Bergman	hasGender	male
Toronto_Pearson_International_Airport	isConnectedTo	Prague_Václav_Havel_Airport
Sacha_Opinel	hasGender	male
Rajko_Tavčar	hasGender	male
Karim_Bridji	hasGender	male
Vince_Hilaire	hasGender	male
Göteborg_Landvetter_Airport	isConnectedTo	Split_Airport
Lance_Key	hasGender	male
Guangzhou_Baiyun_International_Airport	isConnectedTo	Frankfurt_Airport
Trabzon_Airport	isConnectedTo	Stuttgart_Airport
Alecsandro	hasGender	male
Vladimir_Burduli	hasGender	male
Clint_Gosling	hasGender	male
Rene_Mihelič	hasGender	male
Liverpool_John_Lennon_Airport	isConnectedTo	Bordeaux–Mérignac_Airport
Leigh_Richmond_Roose	hasGender	male
Catania–Fontanarossa_Airport	isConnectedTo	Venice_Marco_Polo_Airport
Bobô_(footballer_born_1962)	hasGender	male
Lajos_Détári	hasGender	male
Boudewijn_Zenden	hasGender	male
Stuart_Bimson	hasGender	male
Radosav_Bulić	hasGender	male
Osamu_Hayaishi	hasGender	male
Pulkovo_Airport	isConnectedTo	Heydar_Aliyev_International_Airport
Steve_Melton	hasGender	male
Jason_Robards	hasGender	male
Adriano_Ferreira_Silvestre	hasGender	male
Javier_Farinós	hasGender	male
Ben_Strevens	hasGender	male
Rajinikanth	hasGender	male
Eduardo_Berizzo	hasGender	male
Terence_Stamp	hasGender	male
Malick_Badiane	hasGender	male
Emil_Kremenliev	hasGender	male
Bertie_Brayley	hasGender	male
Wellington_Damião_Nogueira_Marinho	hasGender	male
Washington_Dulles_International_Airport	isConnectedTo	Seattle–Tacoma_International_Airport
Sergei_Bragin	hasGender	male
Roberto_Daniel_Gasparini	hasGender	male
Domingo_Tarasconi	hasGender	male
Zurab_Arziani	hasGender	male
Thiago_Martins	hasGender	male
Cristián_Uribe	hasGender	male
Ricardo_Emídio_Ramalho_Silva	hasGender	male
Steve_Guppy	hasGender	male
Madrid–Barajas_Airport	isConnectedTo	Charles_de_Gaulle_Airport
Tommy_Kinsella	hasGender	male
Leonardo_da_Vinci–Fiumicino_Airport	isConnectedTo	Falcone–Borsellino_Airport
Budapest_Ferenc_Liszt_International_Airport	isConnectedTo	Kyiv_International_Airport_(Zhuliany)
Sergei_Kiriakov	hasGender	male
Jim_Cumbes	hasGender	male
Umeå_Airport	isConnectedTo	Gran_Canaria_Airport
Alexander_Madlung	hasGender	male
Eoghan_Hickey	hasGender	male
Billy_Felton	hasGender	male
Andorra	imports	wordnet_food_100021265
Walter_Wagner_(footballer)	hasGender	male
Michael_Valkanis	hasGender	male
Liverpool_John_Lennon_Airport	isConnectedTo	Salzburg_Airport
Adam_Federici	hasGender	male
Jerry_Brown	hasGender	male
Igor_Lolo	hasGender	male
Frankfurt_Airport	isConnectedTo	Charlotte_Douglas_International_Airport
Andy_Tod	hasGender	male
Maik_Taylor	hasGender	male
Vienna_International_Airport	isConnectedTo	Sarajevo_International_Airport
Simon_Mignolet	hasGender	male
Malpensa_Airport	isConnectedTo	Lyon–Saint_Exupéry_Airport
Rini_Coolen	hasGender	male
Bhumibol_Adulyadej	isLeaderOf	Thailand
Alberto_Méndez_(footballer)	hasGender	male
Iván_Rocha	hasGender	male
Munich_Airport	isConnectedTo	Brindisi_–_Salento_Airport
East_Midlands_Airport	isConnectedTo	Adnan_Menderes_Airport
Guangzhou_Baiyun_International_Airport	isConnectedTo	Jieyang_Chaoshan_International_Airport
Budapest_Ferenc_Liszt_International_Airport	isConnectedTo	Bristol_Airport
Ivo_Georgiev	hasGender	male
Mohammed_El_Berkani	hasGender	male
Noi_Bai_International_Airport	isConnectedTo	Fukuoka_Airport
Jersson_González	hasGender	male
Charles_de_Gaulle_Airport	isConnectedTo	Manchester_Airport
Chengdu_Shuangliu_International_Airport	isConnectedTo	Ürümqi_Diwopu_International_Airport
Federico_Fellini_International_Airport	isConnectedTo	Pulkovo_Airport
William_Faulkner	hasGender	male
Ivan_Hodúr	hasGender	male
Kevin_Dawson_(footballer,_born_1981)	hasGender	male
Tobie_Mimboe	hasGender	male
Almeida_Garrett	hasGender	male
André_Hainault	hasGender	male
Digão	hasGender	male
Copenhagen_Airport	isConnectedTo	Trondheim_Airport,_Værnes
Eupremio_Carruezzo	hasGender	male
Horacio_Casarín	hasGender	male
London_Heathrow_Terminal_3	isConnectedTo	Budapest
Craig_Morgan_(footballer)	hasGender	male
Roger_Keyes,_1st_Baron_Keyes	hasGender	male
Brian_McBride	hasGender	male
Henri_Toivomäki	hasGender	male
Robin_Williams	hasGender	male
Ralph_Fiennes	hasGender	male
Javier_Dorado	hasGender	male
Zvartnots_International_Airport	isConnectedTo	Kazan_International_Airport
Gerald_R._Ford_International_Airport	isConnectedTo	Dallas/Fort_Worth_International_Airport
Guilherme_Finkler	hasGender	male
Wim_Jonk	hasGender	male
Michael_Dellorusso	hasGender	male
Viru_Viru_International_Airport	isConnectedTo	Aeroparque_Jorge_Newbery
Donny_de_Groot	hasGender	male
Radovan_Radaković	hasGender	male
Singapore_Changi_Airport	isConnectedTo	Shenzhen_Bao'an_International_Airport
Dublin_Airport	isConnectedTo	Larnaca_International_Airport
Kai_Hesse	hasGender	male
Tocumen_International_Airport	isConnectedTo	Washington_Dulles_International_Airport
André_Gide	hasGender	male
Rodolfo_Esteban_Cardoso	hasGender	male
Toronto_Pearson_International_Airport	isConnectedTo	Dublin_Airport
Roger_Willis	hasGender	male
Changzhi_Wangcun_Airport	isConnectedTo	Taiyuan_Wusu_International_Airport
Valérien_Ismaël	hasGender	male
Antalya_Airport	isConnectedTo	Ulan-Ude_Airport
Paul_Benson	hasGender	male
Larnaca_International_Airport	isConnectedTo	Birmingham_Airport
Bernard_Tchoutang	hasGender	male
Danny_Buijs	hasGender	male
Toronto_Pearson_International_Airport	isConnectedTo	Benazir_Bhutto_International_Airport
Mitar_Mrkela	hasGender	male
Alaa_Abdul-Zahra	hasGender	male
Treviso_Airport	isConnectedTo	Catania–Fontanarossa_Airport
Kevin_Hagan	hasGender	male
Sean_Williams_(basketball)	hasGender	male
Marcin_Kowalczyk	hasGender	male
Fort_Lauderdale–Hollywood_International_Airport	isConnectedTo	Washington_Dulles_International_Airport
Alfredo_Obberti	hasGender	male
Tommy_Langley	hasGender	male
La_Palma_Airport	isConnectedTo	Frankfurt_Airport
Madrid–Barajas_Airport	isConnectedTo	Viru_Viru_International_Airport
Vasile_Ghindaru	hasGender	male
Michael_Jeter	hasGender	male
Ottavio_Bianchi	hasGender	male
Jorge_Henrique_de_Souza	hasGender	male
Paulo_Bento	hasGender	male
Huangshan_Tunxi_International_Airport	isConnectedTo	Tianjin_Binhai_International_Airport
Hugo_Porfírio	hasGender	male
Gledson	hasGender	male
Paulo_César_Arruda_Parente	hasGender	male
Keenan_Wynn	hasGender	male
Santiago_Ladino	hasGender	male
Rafael_Schmitz	hasGender	male
Indianapolis_International_Airport	isConnectedTo	Phoenix_Sky_Harbor_International_Airport
Kish_International_Airport	isConnectedTo	Mehrabad_International_Airport
Ashley_Hemmings	hasGender	male
Franco_Foda	hasGender	male
Ron_Barnes_(footballer)	hasGender	male
Scott_Flinders	hasGender	male
Michael_Moorcock	hasGender	male
Hanno_Balitsch	hasGender	male
Serkan_Çalik	hasGender	male
Philadelphia_International_Airport	isConnectedTo	Manchester_Airport
Ali_Turan	hasGender	male
Malpensa_Airport	isConnectedTo	Cairo_International_Airport
Washington_(footballer)	hasGender	male
Serhiy_Popov	hasGender	male
Beirut–Rafic_Hariri_International_Airport	isConnectedTo	Sabiha_Gökçen_International_Airport
Sebastián_Eguren	hasGender	male
Gheorghe_Craioveanu	hasGender	male
James_Baldwin	hasGender	male
Paul_Caligiuri	hasGender	male
Toronto_Pearson_International_Airport	isConnectedTo	Newark_Liberty_International_Airport
Eldon_Maquemba	hasGender	male
Stavanger_Airport,_Sola	isConnectedTo	Katowice_International_Airport
József_Pecsovszky	hasGender	male
Antonio_Gramsci	hasGender	male
David_Regis	hasGender	male
Michel_van_de_Korput	hasGender	male
Batram_Suri	hasGender	male
Fred_Kiernan	hasGender	male
Devi_Ahilyabai_Holkar_Airport	isConnectedTo	Indira_Gandhi_International_Airport
Gerald_Glatzmayer	hasGender	male
Haneda_Airport	isConnectedTo	San_Francisco_International_Airport
Talcott_Parsons	hasGender	male
Istanbul_Atatürk_Airport	isConnectedTo	Barcelona–El_Prat_Airport
Nick_Culkin	hasGender	male
Ewald_Lienen	hasGender	male
Billy_Walsh_(Irish_footballer)	hasGender	male
Daniel_Theorin	hasGender	male
Neil_Heaney	hasGender	male
Dallas/Fort_Worth_International_Airport	isConnectedTo	Wichita_Dwight_D._Eisenhower_National_Airport
Tommaso_Romito	hasGender	male
Guyana	imports	wordnet_machinery_103701640
Ivan_McKinley	hasGender	male
Paul_von_Hindenburg	hasGender	male
Kish_International_Airport	isConnectedTo	Tabriz_International_Airport
Sheremetyevo_International_Airport	isConnectedTo	Athens_International_Airport
Andrei_Solomatin	hasGender	male
Paul_Kitson_(American_soccer)	hasGender	male
Guillermo_Santo	hasGender	male
Alejandro_Delorte	hasGender	male
Phil_Woosnam	hasGender	male
Lyon–Saint_Exupéry_Airport	isConnectedTo	La_Rochelle_–_Île_de_Ré_Airport
Mahmud_Qurbanov	hasGender	male
Harry_Morgan	hasGender	male
Mikkel_Beckmann	hasGender	male
Carlos_Bocanegra	hasGender	male
Ljupko_Petrović	hasGender	male
Morten_Rasmussen_(footballer_born_January_1985)	hasGender	male
Ludwig_Feuerbach	hasGender	male
Andrés_Ríos	hasGender	male
Noor_Sabri	hasGender	male
Usinsk_Airport	isConnectedTo	Krasnodar_International_Airport
Fabricio_Alfaro	hasGender	male
Glen_Crowe	hasGender	male
Talagi_Airport	isConnectedTo	Sheremetyevo_International_Airport
Bari_Karol_Wojtyła_Airport	isConnectedTo	Catania–Fontanarossa_Airport
Liédson	hasGender	male
Charlotte_Douglas_International_Airport	isConnectedTo	Phoenix_Sky_Harbor_International_Airport
Bengt_Lindskog	hasGender	male
Diego_Bortolozzo	hasGender	male
Aberdeen_Airport	isConnectedTo	Sola
Ian_Bolton	hasGender	male
Paulo_Renato_Valério_Rodrigues	hasGender	male
Daire_Doyle	hasGender	male
Malpensa_Airport	isConnectedTo	Menorca_Airport
Josué_Castillejos	hasGender	male
Carlos_García_Badías	hasGender	male
John_Carpenter	hasGender	male
Toshiaki_Haji	hasGender	male
Hal_Holbrook	hasGender	male
Renan_Rocha	hasGender	male
Kenny_Arthur	hasGender	male
Bülent_Bölükbaşı	hasGender	male
Peter_Møller	hasGender	male
Tom_Jordan_(footballer)	hasGender	male
Nicolás_Asencio	hasGender	male
Valdenir_da_Silva_Vitalino	hasGender	male
Jacek_Bąk	hasGender	male
Mark_McGeown	hasGender	male
Brest_Bretagne_Airport	isConnectedTo	Lyon–Saint_Exupéry_Airport
Abedi_Pele	hasGender	male
Dimitar_Telkiyski	hasGender	male
Leonardo_da_Vinci–Fiumicino_Airport	isConnectedTo	Nantes_Atlantique_Airport
Marco_Bernacci	hasGender	male
Athirson_Mazolli_e_Oliveira	hasGender	male
Peter_Cawley	hasGender	male
Minneapolis–Saint_Paul_International_Airport	isConnectedTo	Seattle–Tacoma_International_Airport
Martin_Balsam	hasGender	male
Münster_Osnabrück_International_Airport	isConnectedTo	Tenerife_South_Airport
Iago_Iglesias	hasGender	male
Larnaca_International_Airport	isConnectedTo	Dublin_Airport
Anouar_Diba	hasGender	male
Jože_Benko	hasGender	male
Bandar_Abbas_International_Airport	isConnectedTo	Shahid_Sadooghi_Airport
Simon_Church	hasGender	male
Manuel_José_de_Jesus	hasGender	male
Paolo_Conti	hasGender	male
Law_Chun_Bong	hasGender	male
Marc_Goodfellow	hasGender	male
Richard_Rorty	hasGender	male
Göteborg_Landvetter_Airport	isConnectedTo	Umeå_Airport
Julius_Nyerere_International_Airport	isConnectedTo	Cairo_International_Airport
José_Luis_Borbolla	hasGender	male
Christopher_Flynn	hasGender	male
Frankfurt_Airport	isConnectedTo	Chennai_International_Airport
Youness_Bengelloun	hasGender	male
Nick_Hammond	hasGender	male
Grégory_Arnolin	hasGender	male
Split_Airport	isConnectedTo	London_Heathrow_Airport
Zetti	hasGender	male
Pula_Airport	isConnectedTo	Oslo_Airport,_Gardermoen
Jorge_Chávez_International_Airport	isConnectedTo	Rio_de_Janeiro–Galeão_International_Airport
Noh_Alam_Shah	hasGender	male
Minneapolis–Saint_Paul_International_Airport	isConnectedTo	Chicago_Midway_International_Airport
Mark_Schulte	hasGender	male
Recife/Guararapes–Gilberto_Freyre_International_Airport	isConnectedTo	Tocumen_International_Airport
Søren_Busk	hasGender	male
Narimanovo_Airport	isConnectedTo	Kazan_International_Airport
Portugal	imports	wordnet_clothing_103051540
Yegishe_Melikyan	hasGender	male
Fernando_Navas	hasGender	male
Sheremetyevo_International_Airport	isConnectedTo	Málaga_Airport
Alexsandro_Oliveira_Duarte	hasGender	male
Jafet_Soto	hasGender	male
Málaga_Airport	isConnectedTo	Liverpool_John_Lennon_Airport
Tibor_Kalina	hasGender	male
New_Chitose_Airport	isConnectedTo	Shanghai_Pudong_International_Airport
Max_Sánchez	hasGender	male
Lennart_Meri	hasGender	male
Víctor_Turcios	hasGender	male
Davoud_Haghi	hasGender	male
Mattia_Altobelli	hasGender	male
Eduardo_Costa	hasGender	male
Greater_Rochester_International_Airport	isConnectedTo	Orlando_International_Airport
Chris_Curran_(footballer_born_September_1971)	hasGender	male
Taiyuan_Wusu_International_Airport	isConnectedTo	Lhasa_Gonggar_Airport
Davron_Fayziev	hasGender	male
Alexander_Stroganov	hasGender	male
Mustapha_Bidoudane	hasGender	male
Gavin_Caines	hasGender	male
London_Heathrow_Terminal_3	isConnectedTo	Hong_Kong
Ryan_Green	hasGender	male
Stéphane_Adam	hasGender	male
José_Ramón_Alexanko	hasGender	male
Alex_Ferguson	hasGender	male
Grzegorz_Sandomierski	hasGender	male
César_Azpilicueta	hasGender	male
David_Jarolím	hasGender	male
Sultan_Syarif_Kasim_II_International_Airport	isConnectedTo	Kuala_Lumpur_International_Airport
David_Fincher	hasGender	male
René_Vandereycken	hasGender	male
Adnan_Menderes_Airport	isConnectedTo	Bremen_Airport
Giuseppe_Moro	hasGender	male
Chet_Culver	hasGender	male
Anthony_Bowie	hasGender	male
Igor_Sypniewski	hasGender	male
Thiago_Ribeiro	hasGender	male
Charles_de_Gaulle_Airport	isConnectedTo	Mohamed_Boudiaf_International_Airport
Ilya_Blyznyuk	hasGender	male
Christophe_Galtier	hasGender	male
Dallas_Love_Field	isConnectedTo	Nashville_International_Airport
Albin_Ekdal	hasGender	male
Chengdu_Shuangliu_International_Airport	isConnectedTo	Changsha_Huanghua_International_Airport
Singapore_Changi_Airport	isConnectedTo	Shenyang_Taoxian_International_Airport
Philadelphia_International_Airport	isConnectedTo	Ben_Gurion_Airport
Tom_Høgli	hasGender	male
Sean_Devine	hasGender	male
Aaron_O'Connor	hasGender	male
Emmanuel_Boakye	hasGender	male
Linate_Airport	isConnectedTo	Comiso_Airport
Néstor_Susaeta	hasGender	male
Menorca_Airport	isConnectedTo	Bournemouth_Airport
Alexander_von_Humboldt	hasGender	male
Raf_de_Gregorio	hasGender	male
Marcos_Antonio_Aparecido_Cipriano	hasGender	male
Paulo_César_Fonseca_do_Nascimento	hasGender	male
Ernst_Baumeister	hasGender	male
Mihailo_Petrović_(footballer)	hasGender	male
Gábor_Bukrán	hasGender	male
Enrique_Corrales	hasGender	male
Dunga	hasGender	male
Rubén_Capria	hasGender	male
Halifax_Stanfield_International_Airport	isConnectedTo	Toronto_Pearson_International_Airport
Choi_Sung-kuk	hasGender	male
Xi'an_Xianyang_International_Airport	isConnectedTo	Gimhae_International_Airport
Jay_Tabb	hasGender	male
Srđan_Pecelj	hasGender	male
Abdoulaye_Camara	hasGender	male
Marel_Baldvinsson	hasGender	male
Robin_Fraser	hasGender	male
Eindhoven_Airport	isConnectedTo	Gdańsk_Lech_Wałęsa_Airport
Minneapolis–Saint_Paul_International_Airport	isConnectedTo	T._F._Green_Airport
Omar_Berdiýew	hasGender	male
