Scott_Dann	playsFor	Blackburn_Rovers_F.C.
Dale_Ervine	playsFor	Wichita_Wings
Jiří_Hanke	playsFor	FC_Biel-Bienne
Bernardo_Corradi	playsFor	Montreal_Impact
Dušan_Kosič	playsFor	NK_Rudar_Velenje
Gabriele_Aldegani	playsFor	A.C._Chievo_Verona
Carmelo_González_(footballer)	playsFor	Hércules_CF
Matty_Mainwaring	playsFor	Chester_F.C.
Thompson_Usiyan	playsFor	Tulsa_Roughnecks_(1978–84)
Jimmy_Rooney	playsFor	Heidelberg_United_FC
Haris_Safwan_Kamal	playsFor	PLUS_F.C.
Leonel_Ríos	playsFor	Club_Atlético_Independiente
Billy_Mehmet	playsFor	Gençlerbirliği_S.K.
Zdeněk_Pospěch	playsFor	1._FSV_Mainz_05
Dennis_Pearce	playsFor	Stourport_Swifts_F.C.
Cofie_Bekoe	playsFor	Petrojet_FC
Paul_Reid_(Australian_association_footballer)	playsFor	Australia_national_association_football_team
Sandro_Calabro	playsFor	FC_St._Gallen
Marcelo_Santos_Oliveira	playsFor	Associação_Chapecoense_de_Futebol
Marco_Navas	playsFor	CD_Leganés
Moris_Carrozzieri	playsFor	A.S.D._Fidelis_Andria_1928
Péter_Orosz	playsFor	Lombard-Pápa_TFC
Mick_Channon	playsFor	Cape_Town_City_F.C.
Florin_Tene	playsFor	ACF_Gloria_Bistrița
Valentin_Badea	playsFor	Panserraikos_F.C.
Kai_Nyyssönen	playsFor	R._White_Daring_Molenbeek
Jorge_Toro	playsFor	U.C._Sampdoria
Goran_Lozanovski	playsFor	Adelaide_City_FC
Humboldt_University	isLocatedIn	Berlin
Anthony_Baffoe	playsFor	Stuttgarter_Kickers
Kauê_Caetano_da_Silva	playsFor	Torku_Konyaspor
Cristiano_Ávalos	playsFor	America_Football_Club_(RJ)
Tarik_El_Taib	playsFor	Misr_El-Makasa_SC
Emerson_Ferreira_da_Rosa	playsFor	Santos_FC
Darren_Murphy	playsFor	Cork_City_F.C.
Lee_Jarman	playsFor	Llanelli_A.F.C.
Prince_Efe_Ehiorobo	playsFor	Nigeria_national_football_team
Paul_Tisdale	playsFor	Northampton_Town_F.C.
Claudio_López_(footballer)	playsFor	Colorado_Rapids
Andy_Panko	wasBornIn	Harrisburg,_Pennsylvania
Edmílson_dos_Santos_Carmo_Júnior	playsFor	América_Futebol_Clube_(RN)
Bernard_Harrison	playsFor	Dorchester_Town_F.C.
Cacá_(footballer_born_1979)	playsFor	UD_Salamanca
Luciano_Valente_de_Deus	playsFor	Mogi_Mirim_Esporte_Clube
Jimmy_Glenn	playsFor	Columbus_Crew
Andrey_Nazário_Afonso	playsFor	Figueirense_Futebol_Clube
Michael_Black_(footballer)	playsFor	Millwall_F.C.
Harry_McShane_(footballer)	playsFor	Manchester_United_F.C.
Mick_Kennedy	playsFor	Stoke_City_F.C.
Jefferson_Montero	playsFor	Club_Sport_Emelec
Jaroslav_Drobný_(footballer)	playsFor	Czech_Republic_national_under-19_football_team
Hüseyin_Kartal	playsFor	Turkey_national_football_team
Ramón_da_Silva_Ramos	playsFor	Ceará_Sporting_Club
Jack_de_Gier	playsFor	Lierse_S.K.
Christian_Person	playsFor	1._FC_Magdeburg
Dominic_Kinnear	playsFor	Club_Necaxa
Alessandro_Moro	playsFor	A.S.D._Fidelis_Andria_1928
Étienne_N'tsunda	playsFor	F.C._Famalicão
Billy_Rafferty	wasBornIn	Glasgow
Jean-Louis_Valois	playsFor	Heart_of_Midlothian_F.C.
Bongani_Khumalo	playsFor	Arcadia_Shepherds_F.C.
Aron_Wilford	playsFor	Dandenong_Thunder_SC
Roy_Warhurst	playsFor	Oldham_Athletic_A.F.C.
Tony_Vaughan	playsFor	Stockport_County_F.C.
Andrey_Nazário_Afonso	playsFor	Associação_Portuguesa_de_Desportos
Toni_Kallio	playsFor	FC_Ilves
Roy_Beerens	playsFor	PSV_Eindhoven
Walter_Ayoví	playsFor	Ecuador_national_football_team
Patrick_Stewart	hasWonPrize	Laurence_Olivier_Award
Paolo_Orlandoni	playsFor	S.S.D._Pro_Sesto_Calcio
Oleh_Mazurenko	playsFor	MFC_Mykolaiv
Martin_Dugas	playsFor	FC_St._Pauli
Bruno_Fornaroli	playsFor	Danubio_F.C.
Mohamed_Kader	playsFor	Al_Jazira_Club
Bart_McGhee	playsFor	New_York_Field_Club
Viktor_Zemchenkov	playsFor	FC_Chernomorets_Novorossiysk
George_Moorhouse	playsFor	United_States_men's_national_soccer_team
Admir_Ćatović	playsFor	Syrianska_FC
Soslan_Dzhanayev	playsFor	FC_Spartak_Moscow
Darren_Mansaram	playsFor	Armthorpe_Welfare_F.C.
Alejandro_Meloño	playsFor	Deportivo_Quito
Jhon_van_Beukering	playsFor	Pelita_Bandung_Raya
Dmitri_Kharine	playsFor	PFC_CSKA_Moscow
Nursultan_Nazarbayev	hasWonPrize	Order_of_the_White_Double_Cross
Tom_McAdam	playsFor	Celtic_F.C.
James_Reid_(footballer_born_1879)	playsFor	Reading_F.C.
Saša_Radivojević	playsFor	FK_Borac_Čačak
Matías_Pérez_García	playsFor	Club_Universidad_de_Chile
Omri_Afek	playsFor	Bnei_Yehuda_Tel_Aviv_F.C.
Gianmatteo_Mareggini	playsFor	San_Frediano_Rondinella_S.S.
Kenny_Cooper	playsFor	Associação_Académica_de_Coimbra_–_O.A.F.
Marco_Zanchi	playsFor	Atalanta_B.C.
Tony_Field_(footballer_born_1946)	playsFor	Memphis_Rogues
Roger_Davies_(footballer)	playsFor	Burnley_F.C.
Jassim_Swadi	playsFor	Al-Zawra'a_SC
Martin_Heidegger	influences	Jürgen_Habermas
Paul_Sugrue	playsFor	Bridgend_Town_A.F.C.
Tony_Yeboah	playsFor	Al-Gharafa_Sports_Club
Dadá_Maravilha	playsFor	Esporte_Clube_Bahia
Iain_Dowie	playsFor	Luton_Town_F.C.
Emilko_Janković	playsFor	NK_Karlovac
Ennio_Morricone	hasWonPrize	Grammy_Award
Laurie_Calloway	playsFor	Wolverhampton_Wanderers_F.C.
Wayne_Cegielski	playsFor	Wales_national_under-21_football_team
Paweł_Kaczmarek	playsFor	Tur_Turek
Damiano_Longhi	playsFor	U.S._Fiorenzuola_1922
Leandro_Cruz_de_Oliveira	playsFor	Esporte_Clube_Juventude
Tony_Battersby	playsFor	Spalding_United_F.C.
José_Reinaldo_de_Lima	playsFor	Cruzeiro_Esporte_Clube
Kevin_Stonehouse	playsFor	Carlisle_United_F.C.
Aaron_Goulding	playsFor	Campbelltown_City_SC
Simon_Ainge	playsFor	England_national_football_C_team
Tampere	isLocatedIn	Western_Finland
Anthony_Tonkin	playsFor	Stockport_County_F.C.
Gerry_Harrison_(footballer)	playsFor	Huddersfield_Town_F.C.
Oscar_Luis_Vera	playsFor	Widzew_Łódź
Hugo_Luz	playsFor	F.C._Maia
Alex_Bennett_(footballer)	playsFor	Celtic_F.C.
Henri_Depireux	playsFor	RFC_Liège
Bruno_Recife	playsFor	Associação_Portuguesa_de_Desportos
Jaime_Valdés	playsFor	Chile_national_football_team
Marcelo_dos_Santos_Marinho	playsFor	Esporte_Clube_Bahia
Iain_Fraser_(soccer)	playsFor	Baltimore_Blast_(1980–92)
Waldir_Sáenz	playsFor	FBC_Melgar
Miami_Heat	isLocatedIn	Florida
Philippe_Noiret	hasWonPrize	César_Award
Italo_Calvino	hasWonPrize	Austrian_State_Prize_for_European_Literature
Diego_Barreto	playsFor	Newell's_Old_Boys
Manolo_Pestrin	playsFor	S.S._Virtus_Lanciano_1924
David_Speedie	playsFor	Stamford_A.F.C.
Ray_Bradbury	hasWonPrize	Prometheus_Award
František_Veselý	playsFor	SK_Rapid_Wien
Willer_Souza_Oliveira	playsFor	Wigry_Suwałki
Radislav_Dragićević	playsFor	Anagennisi_Karditsa_F.C.
Matheus_Henrique_do_Carmo_Lopes	playsFor	C.F._Os_Belenenses
Anderson_Luís_de_Azevedo_Rodrigues_Marques	playsFor	Ituano_Futebol_Clube
Ersen_Martin	playsFor	Beşiktaş_J.K.
Vlado_Šmit	playsFor	S.P.A.L._2013
Adrian_Hayes	playsFor	King's_Lynn_F.C.
Tabaré_Viúdez	wasBornIn	Montevideo
Fede_Vico	playsFor	K.V._Oostende
Gintaras_Staučė	playsFor	MSV_Duisburg
Manuel_Lanzarote_Bruno	playsFor	Atlético_Madrid_B
Cluj-Napoca	isLocatedIn	Romania
Daniel_Webb_(footballer)	playsFor	Salisbury_City_F.C.
Stuart_McMillan_(footballer)	playsFor	Chelsea_F.C.
Andreas_Ogris	wasBornIn	Vienna
Rodrigo_Mendes	playsFor	Clube_Atlético_Paranaense
Cha_Ji-ho	playsFor	Melbourne_Knights_FC
Dragan_Mrđa	playsFor	FK_Jedinstvo_Ub
Svetoslav_Petrov_(footballer_born_1978)	playsFor	PFC_Lokomotiv_Sofia
Philippe_Toledo	playsFor	Real_Zaragoza_B
Todor_Kolev_(footballer_born_1980)	playsFor	F.C._Etar
Rex_Harrison	hasWonPrize	David_di_Donatello
Mladen_Petrić	playsFor	Fulham_F.C.
Todor_Veselinović	playsFor	FC_Kärnten
Dariusz_Kubicki	playsFor	Carlisle_United_F.C.
Arthur_Conan_Doyle	influences	Michael_Crichton
Mutlu_Dervişoğlu	playsFor	Akçaabat_Sebatspor
Giuseppe_Pillon	playsFor	Pordenone_Calcio_S.S.D.
Graham_Lewis_(footballer)	playsFor	Lincoln_Moorlands_Railway_F.C.
Gijs_Luirink	playsFor	SC_Cambuur
Jorge_Acuña	playsFor	Ñublense
Watcharapong_Klahan	playsFor	BBCU_F.C.
Cuauhtémoc_Blanco	playsFor	Dorados_de_Sinaloa
Dave_Mehmet	playsFor	Millwall_F.C.
Catanha	playsFor	Marília_Atlético_Clube
Jimmy_Greaves	wasBornIn	London
Fábio_Júnior_Pereira	playsFor	Al-Wahda_S.C.C.
Scott_McDonald	playsFor	Millwall_F.C.
George_Wood_(footballer)	playsFor	Hereford_United_F.C.
Giovanni_Tomi	playsFor	A.C._Rimini_1912
Gordon_Greer	playsFor	Brighton_&_Hove_Albion_F.C.
Luciano_Amaral	playsFor	Criciúma_Esporte_Clube
Justin_Thompson_(soccer)	playsFor	Bury_F.C.
Airdrie,_North_Lanarkshire	isLocatedIn	Scotland
Bassey_Akpan	playsFor	Kwara_United_F.C.
Zlatko_Yankov	playsFor	Real_Valladolid
Álvaro_Gutiérrez_(footballer)	playsFor	Club_Nacional_de_Football
José_María_Vidal	playsFor	Real_Zaragoza
Jock_Dodds	playsFor	Lincoln_City_F.C.
Didier_Sénac	playsFor	France_national_football_team
Cambridge,_Massachusetts	isLocatedIn	United_States
Riccardo_Nardini	playsFor	U.S._Pistoiese_1921
Eugene_Galeković	playsFor	S.C._Beira-Mar
Associação_Atlética_Ponte_Preta	isLocatedIn	Campinas
Bosun_Ayeni	playsFor	Boldklubben_Frem
Wojciech_Kowalczyk	playsFor	UD_Las_Palmas
Ultra_Music_Festival	isLocatedIn	Argentina
Joaquín_del_Olmo	playsFor	Jaibos_Tampico_Madero
John_Williams_(footballer_born_1968)	playsFor	Redditch_United_F.C.
Russell_Crowe	isMarriedTo	Meg_Ryan
Robert_da_Silva_Almeida	playsFor	Clube_Atlético_Mineiro
Bruno_Moraes	playsFor	Gil_Vicente_F.C.
James_Pritchett_(footballer)	playsFor	New_Zealand_national_football_team
Thomas_Hunt_Morgan	hasWonPrize	Copley_Medal
Fabrice_Reuperné	playsFor	PAS_Giannina_F.C.
Dean_Kiely	playsFor	Portsmouth_F.C.
Eduard_Tsykhmeystruk	playsFor	PFC_Levski_Sofia
Andy_Walker_(footballer_born_1981)	playsFor	Colchester_United_F.C.
Aleksandar_Pantić_(footballer_born_1978)	playsFor	FK_Voždovac
Helmut_Rahn	playsFor	Germany_national_football_team
Aldo_Adorno	playsFor	Maccabi_Tel_Aviv_F.C.
Vladimir_Arnold	isCitizenOf	France
Marcos_Denner	playsFor	Tupi_Football_Club
Henri_Anier	playsFor	U.C._Sampdoria
Jeff_Hughes_(footballer)	playsFor	Larne_F.C.
Luis_García_(footballer,_born_1969)	playsFor	Monarcas_Morelia
Kieran_Charnock	playsFor	England_national_football_C_team
Bruno_Martelotto	playsFor	ATM_FA
Matty_Fryatt	playsFor	England_national_under-19_football_team
Samuel_Ipoua	playsFor	K._Sint-Truidense_V.V.
Marco_Airosa	playsFor	S.C._Olhanense
Paulo_César_Rodrigues_Lima	playsFor	C.D._FAS
Karim_Bellarabi	playsFor	SV_Werder_Bremen
Njego_Pesa	playsFor	New_York_Arrows
Ivan_Jazbinšek	playsFor	GNK_Dinamo_Zagreb
Paul_Tait_(footballer_born_1974)	playsFor	Hull_City_A.F.C.
Ferydoon_Zandi	playsFor	Esteghlal_F.C.
Hristu_Chiacu	playsFor	CS_Concordia_Chiajna
Michael_Rodríguez	playsFor	Brujas_F.C.
Ahmet_Dursun	playsFor	MKE_Ankaragücü
Niki_Mäenpää	playsFor	VVV-Venlo
Syarhey_Vyeramko	playsFor	FC_BATE_Borisov
Barry_Silkman	playsFor	Wimbledon_F.C.
Ljubinko_Drulović	playsFor	F.C._Porto
Samuel_Néva	playsFor	Le_Havre_AC
Matthew_Mbuta	playsFor	Cameroon_national_football_team
Lisbon	isLocatedIn	Portugal
Mustafa_Kocabey	playsFor	Torku_Konyaspor
Flavio_Barros	playsFor	America_Football_Club_(RJ)
Steve_Kirk	playsFor	East_Fife_F.C.
Keith_Burkinshaw	playsFor	Liverpool_F.C.
Ben_Foster_(footballer)	playsFor	Kidderminster_Harriers_F.C.
Paul_Marshall_(footballer)	playsFor	Blackpool_F.C.
Walter_Minhoca	playsFor	Betim_Esporte_Clube
Armen_Shahgeldyan	playsFor	FC_Ararat_Yerevan
William_Thomson,_1st_Baron_Kelvin	hasWonPrize	Royal_Medal
Matthías_Vilhjálmsson	playsFor	Iceland_national_under-21_football_team
Miroslav_Kadlec	playsFor	FK_Drnovice
Sherjill_MacDonald	playsFor	K.V.C._Westerlo
Javed_Jaffrey	playsFor	Willem_II_(football_club)
Robert_Gadocha	playsFor	FC_Nantes
Karel_Jarolím	playsFor	FC_Rouen
Dean_Bouzanis	playsFor	Liverpool_F.C.
José_Burtovoy	playsFor	Tiburones_Rojos_de_Veracruz
George_O'Callaghan	wasBornIn	Cork_(city)
Piotr_Madejski	playsFor	Miedź_Legnica
Roger_Suárez	playsFor	Nacional_Potosí
Dukla_Prague	isLocatedIn	Prague
Dermival_Almeida_Lima	playsFor	Paulista_Futebol_Clube
Jordão_(footballer_born_1971)	playsFor	Portugal_national_under-21_football_team
Frank_Sinclair	playsFor	Jamaica_national_football_team
Derek_Brazil	playsFor	Haverfordwest_County_A.F.C.
Daisuke_Sakata	playsFor	Yokohama_F._Marinos
Zach_Thornton	playsFor	Chivas_USA
Mancini_(Brazilian_footballer)	playsFor	Associação_Portuguesa_de_Desportos
Todor_Timonov	wasBornIn	Plovdiv
Steffen_Karl	playsFor	Vålerenga_Fotball
George_Kinsey	playsFor	England_national_football_team
Antonio_de_Nigris	playsFor	Club_Universidad_Nacional
Michael_Frontzeck	playsFor	SC_Freiburg
Cleidimar_Magalhães_Silva	playsFor	Santa_Cruz_Futebol_Clube
Tonet	playsFor	CF_Rayo_Majadahonda
Orosco_Anonam	playsFor	Naxxar_Lions_F.C.
Cheng_Siu_Chung	playsFor	Kitchee_SC
Ivan_Gvozdenović	playsFor	FC_Metz
Tomasz_Wisio	playsFor	Ergotelis_F.C.
Jairo_Patiño	playsFor	San_Luis_F.C.
Stefano_Morrone	playsFor	U.S._Città_di_Palermo
Marco_Grassi	playsFor	Olympique_Lyonnais
Ivan_Pudar	wasBornIn	Belgrade
Miloš_Milutinović	playsFor	FK_Partizan
Edmilson_Ferreira	playsFor	Joinville_Esporte_Clube
Maciej_Scherfchen	playsFor	Lech_Poznań
Ricardo_Vaz_Tê	playsFor	Barnsley_F.C.
Gianni_De_Rosa	playsFor	A.C._Perugia_Calcio
Aarhus_Gymnastikforening	owns	Aarhus
Jô	playsFor	Manchester_City_F.C.
Darko_Kolić	playsFor	Montreal_Impact
Ricardo_Mauricio_Martínez	playsFor	Cruz_Azul_Hidalgo
Nevio_Scala	playsFor	Vicenza_Calcio
India	isLocatedIn	Asia
Kathy_Bates	isMarriedTo	Bernard_Hill
Bertie_Brayley	playsFor	Concord_Rangers_F.C.
Arafat_Djako	playsFor	Bnei_Sakhnin_F.C.
Máté_Tóth	playsFor	Soproni_VSE
Kristoffer_Andersen	playsFor	Alemannia_Aachen
Ján_Kozák_(footballer_born_1954)	playsFor	R.F.C._Seraing
Ferenc_Horváth	playsFor	Újpest_FC
Radek_Dosoudil	playsFor	AC_Sparta_Prague
Rashid_Yussuff	playsFor	England_national_under-18_football_team
Graham_Branch	playsFor	Accrington_Stanley_F.C.
Ronnie_Dix	playsFor	England_national_football_team
Andrei_Agius	playsFor	U.S._Latina_Calcio
Leonardo_Andrés_Iglesias	playsFor	Atlético_de_Rafaela
Thomas_Vermaelen	playsFor	Belgium_national_under-21_football_team
Łukasz_Załuska	playsFor	Dundee_United_F.C.
Mehmet_Çakır	playsFor	MKE_Ankaragücü
Terry_Barwick	wasBornIn	Sheffield
João_Pedro_Henriques_Neto	wasBornIn	Porto
Marcelo_Baron_Polanczyk	playsFor	JEF_United_Ichihara_Chiba
Serhiy_Bezhenar	playsFor	SC_Tavriya_Simferopol
Fernando_Derveld	playsFor	FC_Dordrecht
Nemanja_Milisavljević	playsFor	FK_Vardar
Paolo_Guerrero	playsFor	Sport_Club_Corinthians_Paulista
Derek_Allan	playsFor	Kingstonian_F.C.
John_Hughes_(footballer,_born_1964)	wasBornIn	Edinburgh
Lee_Jenkins	playsFor	Swansea_City_A.F.C.
Juan_Barbas	playsFor	Club_Atlético_Alvarado
Frédéric_Danjou	playsFor	US_Créteil-Lusitanos
Daniel_Beichler	playsFor	SV_Sandhausen
Nicolas_Fabiano	playsFor	Racing_Club_de_France_football_Colombes_92
Nilmar	playsFor	El_Jaish_SC
Jorge_Anchén	wasBornIn	Montevideo
Fábio_Felício	playsFor	S.C._Olhanense
Kyriacos_Chailis	playsFor	Chalkanoras_Idaliou
Italian_Libya	isLocatedIn	Africa
Andriy_Polunin	playsFor	FC_Kryvbas_Kryvyi_Rih
Joe_Cockroft	playsFor	West_Ham_United_F.C.
Isaac_Cuenca	playsFor	Spain_national_under-23_football_team
Ray_Brady	playsFor	Home_Farm_F.C.
Bente_Nordby	playsFor	Djurgårdens_IF_Dam
Iñigo_Vélez	wasBornIn	Vitoria-Gasteiz
Paul_Konchesky	playsFor	Liverpool_F.C.
Joeano	playsFor	Beitar_Jerusalem_F.C.
Andy_Vargas	playsFor	Green_Gully_SC
Julio_Valentín_González	playsFor	12_de_Octubre_Football_Club
Chakhir_Belghazouani	playsFor	R._White_Star_Bruxelles
Fadil_Vokrri	playsFor	Bourges_18
Kristian_Rees	playsFor	Adelaide_City_FC
Andy_Williams_(Jamaican_footballer)	wasBornIn	Toronto
Dave_Kitson	playsFor	Arlesey_Town_F.C.
Francisco_Javier_Rodríguez	playsFor	Club_América
Ivan_Klasnić	playsFor	Croatia_national_under-21_football_team
Joseph_N'Do	playsFor	Bohemian_F.C.
Enzo_Scifo	playsFor	AS_Monaco_FC
Michael_Barnes_(footballer)	playsFor	Southport_F.C.
Edin_Junuzović	playsFor	NK_Rudar_Velenje
Kim_Tae-yeon_(footballer)	playsFor	Fagiano_Okayama_FC
Roberto_Carlos_(footballer)	playsFor	Fenerbahçe_S.K._(football)
Christ_Bongo	playsFor	FC_Aarau
Timo_Zahnleiter	playsFor	Wormatia_Worms
Frank_Simek	playsFor	Queens_Park_Rangers_F.C.
Jamie_McAllister	wasBornIn	Glasgow
Jermaine_Beckford	playsFor	Carlisle_United_F.C.
Jörg_Böhme	playsFor	Arminia_Bielefeld
George_Michael	isMarriedTo	Brooke_Shields
Danny_Blair	playsFor	Blackpool_F.C.
Dariusz_Kubicki	playsFor	Sunderland_A.F.C.
Denilson_Costa	playsFor	Club_Deportivo_Olimpia
Chuks_Aneke	playsFor	Crewe_Alexandra_F.C.
James_Thompson_(footballer)	playsFor	Sittingbourne_F.C.
Mario_Cvitanović	wasBornIn	Zagreb
Rafael_Moura	playsFor	Clube_Atlético_Paranaense
Baltazar_Maria_de_Morais_Júnior	playsFor	Botafogo_de_Futebol_e_Regatas
Dario_Damjanović	playsFor	FC_Luch-Energiya_Vladivostok
Jessica_Tandy	isMarriedTo	Jack_Hawkins
Wayne_Biggins	wasBornIn	Sheffield
Baruch_Spinoza	influences	Friedrich_Nietzsche
Francesco_Bolzoni	playsFor	Genoa_C.F.C.
Daniel_N'Gom_Kome	playsFor	Getafe_CF
Jermaine_Darlington	playsFor	Hendon_F.C.
Hervé_Bochud	playsFor	SC_Kriens
Mohammad_Parvin	playsFor	Paykan_F.C.
Marco_Streller	playsFor	1._FC_Köln
Robert_Prosinečki	playsFor	Real_Madrid_C.F.
Änis_Ben-Hatira	playsFor	Hamburger_SV_II
Goran_Lozanovski	playsFor	Collingwood_Warriors_S.C.
Ramon_Llull	playsFor	FC_Yantra
Maksym_Trusevych	playsFor	FC_Obolon_Kyiv
Roland_Kirchler	playsFor	WSG_Wattens
Álvaro_Santos	playsFor	Helsingborgs_IF
Maurice_Bishop_International_Airport	isLocatedIn	Grenada
Ufukhan_Bayraktar	playsFor	Turkey_national_under-19_football_team
Gordon_Strachan	playsFor	Scotland_national_under-21_football_team
Vladimir_Karalić	wasBornIn	Belgrade
Alejandro_Curbelo	playsFor	Alianza_F.C.
Isidro_Lángara	playsFor	Real_Oviedo
Emmanuel_Kenmogne	playsFor	A.F.C._Tubize
Lee_Phillips_(footballer_born_1980)	playsFor	Rushden_&_Diamonds_F.C.
Nicolae_Dică	playsFor	Calcio_Catania
Willian_Borges_da_Silva	playsFor	Brazil_national_under-20_football_team
Marin_Miok	playsFor	FK_Sevojno
Zoran_Zeljković	playsFor	APOP_Kinyras_FC
Evander_Sno	playsFor	N.E.C._(football_club)
Joílson_Rodrigues_da_Silva	playsFor	Iraty_Sport_Club
Ibad_Muhamadu	playsFor	Willem_II_(football_club)
Giovanni_Galli	playsFor	Italy_national_football_team
Cédric_Sabin	playsFor	Al_Ahli_SC_(Doha)
Iain_Campbell	playsFor	Alloa_Athletic_F.C.
Andrey_Yeshchenko	playsFor	Russia_national_under-21_football_team
Yuri_Drozdov	playsFor	FC_Lokomotiv-2_Moscow
Nicky_Southall	playsFor	Nottingham_Forest_F.C.
Leonardo_Pekarnik	playsFor	Envigado_F.C.
Christian_Wörns	playsFor	Germany_national_football_team
Rick_Titus_(soccer)	playsFor	Toronto_FC
Janet_Frame	wasBornIn	Dunedin
Martin_Kolář	playsFor	R.S.C._Anderlecht
Dick_Allman	playsFor	Maidstone_United_F.C._(1897)
Donetsk_International_Airport	isLocatedIn	Donetsk
Sunday_Ibrahim	playsFor	Strømsgodset_IF
Alon_Mizrahi	wasBornIn	Tel_Aviv
Nicky_Reid	playsFor	Manchester_City_F.C.
Anthony_LaPaglia	hasWonPrize	Primetime_Emmy_Award
Marco_Cellini	playsFor	A.C._Perugia_Calcio
Dino_da_Costa	playsFor	Ascoli_Calcio_1898
Paco_Flores	playsFor	UE_Sant_Andreu
Kostadin_Vidolov	playsFor	PFC_Lokomotiv_Plovdiv
Luke_McShane_(footballer)	playsFor	Kettering_Town_F.C.
Frank_Paulus	playsFor	Holstein_Kiel
Alan_Waddle	playsFor	Newport_County_A.F.C.
Stefano_Lucchini	playsFor	U.C._Sampdoria
Rashin_Wurie	playsFor	Sierra_Leone_national_football_team
Eurico_de_Aguiar_Salles_Airport	isLocatedIn	Vitória,_Espírito_Santo
Patrick_Milchraum	playsFor	Alemannia_Aachen
Tommy_Eglington	playsFor	Shamrock_Rovers_F.C.
Jorge_Ribeiro	playsFor	Boavista_F.C.
Marcelo_Ojeda	wasBornIn	Avellaneda
Mark_Robertson	playsFor	Sydney_FC
Marc_Joseph	playsFor	Bristol_City_F.C.
Marco_Rossi_(footballer_born_1987)	playsFor	A.C._Perugia_Calcio
Kevin_Keegan	playsFor	Newcastle_United_F.C.
Masahiro_Ohashi	playsFor	Kawasaki_Frontale
Mile_Sterjovski	playsFor	Sydney_United_58_FC
Uğur_İnceman	playsFor	Antalyaspor
James_H._Kasler	hasWonPrize	Purple_Heart
Marcus_Vinícius_da_Cruz_Alves_Nóbrega	playsFor	Boavista_F.C.
Marco_Rizi	playsFor	Detroit_Rockers
Bryn_Halliwell	playsFor	Dunfermline_Athletic_F.C.
Sylvain_Legwinski	playsFor	France_national_under-21_football_team
Yu_Dabao	playsFor	Dalian_Aerbin_F.C.
Jorginho_Putinatti	playsFor	Marília_Atlético_Clube
Norbert_Eder	playsFor	Germany_national_football_B_team
Srđan_Andrić	playsFor	Panathinaikos_F.C.
Feliciano_Magro	playsFor	Italy_national_under-20_football_team
Tansel_Başer	wasBornIn	Melbourne
Nabatingue_Toko	playsFor	Racing_Club_de_France_football_Colombes_92
Mark_Patterson_(footballer_born_1965)	playsFor	Sheffield_United_F.C.
Scott_McCulloch	playsFor	Forfar_Athletic_F.C.
George_Travers	playsFor	Leicester_City_F.C.
A._R._Rawlinson	hasWonPrize	Order_of_the_British_Empire
Matías_Fernández	playsFor	Sporting_Clube_de_Portugal
Frank_Magerman	playsFor	SC_Eendracht_Aalst
Björn_Runström	playsFor	1._FC_Kaiserslautern
Luis_Suárez_Miramontes	playsFor	FC_Barcelona
Jorge_Ribeiro	playsFor	S.L._Benfica_B
Franck_Ribéry	playsFor	Stade_Brestois_29
Chet_Culver	playsFor	Misr_El-Makasa_SC
Youness_Mokhtar	playsFor	PEC_Zwolle
Mauro_Cejas	playsFor	Newell's_Old_Boys
Aleksejs_Višņakovs	playsFor	Skonto_FC
Henri_Dumat	playsFor	Troyes_AC
Trevor_Matthewson	playsFor	Gresley_F.C.
Samuel_Wowoah	playsFor	Halmstads_BK
J._L._Austin	influences	Jürgen_Habermas
Bruno_Quadros	playsFor	Cruzeiro_Esporte_Clube
Costas_Malekkos	playsFor	PAEEK
Matija_Smrekar	playsFor	Croatia_national_under-19_football_team
Mick_Kennedy	wasBornIn	City_of_Salford
Marco_Ferreira	playsFor	F.C._Tirsense
Milanko_Rašković	playsFor	FK_Borac_Čačak
Johan_Sotil	playsFor	Alianza_Lima
Éamon_Zayed	playsFor	Sporting_Fingal_F.C.
Jean_(footballer)	playsFor	Marília_Atlético_Clube
André_Muff	playsFor	FC_Basel
Vladimir_Beara	playsFor	FC_Viktoria_Köln
Marco_Storari	playsFor	Cagliari_Calcio
Nicky_Forster	playsFor	Ipswich_Town_F.C.
Balázs_Molnár	playsFor	Elche_CF
Geremi_Njitap	playsFor	Racing_Club_Bafoussam
Alecsandro	playsFor	Clube_de_Regatas_do_Flamengo
Nathan_Peat	playsFor	Hull_City_A.F.C.
Regi_Blinker	playsFor	RBC_Roosendaal
Eugen_Neagoe	playsFor	Veria_F.C.
Amitabh_Bachchan	isMarriedTo	Jaya_Bachchan
Ronald_Šiklić	playsFor	Dyskobolia_Grodzisk_Wielkopolski
Paolo_Conti	playsFor	U.C._Sampdoria
Adam_Murray	playsFor	Notts_County_F.C.
Paul_Beesley	playsFor	Chester_City_F.C.
Mansour_Boutabout	playsFor	Angers_SCO
Francisco_De_Paula_Bazán	playsFor	Cienciano
Joeano	wasBornIn	Fortaleza
Stéphane_Paille	playsFor	Olympique_Lyonnais
Maicon_dos_Santos	playsFor	Clube_Atlético_Metropolitano
Carlos_Reinoso	playsFor	Club_América
Andy_Jones_(footballer)	playsFor	Bristol_City_F.C.
David_Giubilato	playsFor	A.S.D._Fidelis_Andria_1928
Rafael_Gaúcho	wasBornIn	Porto_Alegre
Charlie_MacDonald	playsFor	Crawley_Town_F.C.
Pelé_(footballer,_born_1987)	playsFor	Portugal_national_under-21_football_team
Paulo_Sousa	playsFor	Portugal_national_under-21_football_team
Benjamin_Howard_Baker	playsFor	Everton_F.C.
Viktor_Paço	playsFor	NK_Maribor
Dejan_Petković	playsFor	FK_Radnički_Niš
Harry_Redknapp	wasBornIn	London
Valdas_Trakys	playsFor	VfL_Osnabrück
Renato_João_Inácio_Margaça	playsFor	Doxa_Katokopias_F.C.
Iván_Campo	playsFor	AEK_Larnaca_F.C.
Gabriel_Urdaneta	playsFor	Caracas_FC
Jermaine_Beckford	playsFor	Bolton_Wanderers_F.C.
Yuichi_Mizutani	playsFor	Cerezo_Osaka
Tiberio_Guarente	playsFor	Hellas_Verona_F.C.
Alain_Raguel	playsFor	Iraklis_Thessaloniki_F.C.
Erik_Edman	playsFor	Tottenham_Hotspur_F.C.
Musa_Büyük	playsFor	Trabzonspor
Vitorino_Hilton	playsFor	Servette_FC
Pantelis_Kapetanos	playsFor	Greece_national_football_team
Darius_Miceika	playsFor	FC_SKA-Energiya_Khabarovsk
Neil_Ross_(footballer)	playsFor	Macclesfield_Town_F.C.
Gerry_Peyton	playsFor	Burnley_F.C.
Travelzoo	isLocatedIn	Los_Angeles
Bert_Crossthwaite	playsFor	Stoke_City_F.C.
Eugen_Trică	playsFor	FC_Steaua_București
Brad_Maloney	playsFor	Australia_national_under-23_association_football_team
Leo_Gibson	playsFor	Cleveland_City_Stars
Oliver_Reck	playsFor	SV_Werder_Bremen
Jason_Brown_(footballer)	playsFor	Wales_national_under-21_football_team
Rafael_dos_Santos_de_Oliveira	playsFor	Ulsan_Hyundai_FC
Peter_Lübeke	playsFor	AFC_Ajax
Mario_Maloča	playsFor	HNK_Hajduk_Split
Roy_Carroll	playsFor	Northern_Ireland_national_football_team
Moussa_Koita	wasBornIn	Brasília
David_Watson_(footballer_born_1946)	playsFor	Fort_Lauderdale_Sun
Ernest_Rutherford	hasWonPrize	Faraday_Medal
Chris_Birchall	playsFor	Port_Vale_F.C.
Rubén_Suárez	playsFor	Guizhou_Renhe_F.C.
David_Bentley	playsFor	Blackburn_Rovers_F.C.
Michael_O'Neill_(footballer)	playsFor	Newcastle_United_F.C.
Periklis_Papapostolou	playsFor	PAE_Kerkyra
Nigel_Pepper	playsFor	Southend_United_F.C.
Renzo_Sheput	wasBornIn	Lima
Jean-Louis_Akpa_Akpro	playsFor	Rochdale_A.F.C.
Paulo_Sérgio_Moreira_Gonçalves	playsFor	Associação_Académica_de_Coimbra_–_O.A.F.
Keith_Devlin	graduatedFrom	University_of_Bristol
Paulo_Jorge_Sousa_Gomes	playsFor	C.D._Tondela
Salvatore_Ferraro	playsFor	Inter_Milan
Billy_Felton	playsFor	Manchester_City_F.C.
Jayson_Leutwiler	playsFor	FC_Concordia_Basel
Angelo_Di_Livio	playsFor	Calcio_Padova
Dorge_Kouemaha	playsFor	Cameroon_national_football_team
Thomas_Hengen	playsFor	Borussia_Dortmund
Shabazz_Baidoo	playsFor	Lewes_F.C.
Paul_Harsley	playsFor	Northampton_Town_F.C.
Jorge_Pellegrini	playsFor	Instituto_Atlético_Central_Córdoba
Alireza_Mohammad	playsFor	Zob_Ahan_Isfahan_F.C.
Alex_Afonso	playsFor	Clube_Atlético_Bragantino
Hatthaporn_Suwan	playsFor	Sisaket_F.C.
Stuart_Brightwell	playsFor	Hartlepool_United_F.C.
Ray_Burse	playsFor	Columbus_Crew
Abel_Thermeus	playsFor	AS_Monaco_FC
Damián_Escudero	playsFor	Real_Valladolid
Martin_Cranie	playsFor	England_national_under-19_football_team
Ilija_Mitić	wasBornIn	Belgrade
Andrea_Campagnolo	playsFor	Genoa_C.F.C.
Daniel_Georgiev	playsFor	PFC_CSKA_Sofia
Jean-Paul_Sartre	influences	Edward_Said
José_Carlos_Leite_de_Sousa	playsFor	F.C._Arouca
Roland_Tüske	playsFor	Vasas_SC
Antonio_Narciso	playsFor	Unione_Triestina_2012_S.S.D.
Mark_Bunn_(English_footballer)	playsFor	Norwich_City_F.C.
Dudu_Omagbemi	playsFor	Penang_FA
Yuriy_Voynov	playsFor	FC_Zenit_Saint_Petersburg
José_Roberto_Gomes_Santana	playsFor	Tuna_Luso_Brasileira
Branko_Oblak	playsFor	Yugoslavia_national_football_team
Darko_Karadžić	playsFor	FK_Rudar_Pljevlja
Sergey_Viktorovich_Ryzhikov	playsFor	Russia_national_football_team
Timothy_Derijck	playsFor	F.C._Verbroedering_Dender_Eendracht_Hekelgem
Gláucio_de_Jesus_Carvalho	playsFor	Avispa_Fukuoka
Tony_Parks	playsFor	Gillingham_F.C.
Rubén_Blades	isPoliticianOf	Panama
Gabriel_Mendez	playsFor	Sydney_Olympic_FC
Antonio_Rodríguez_Martínez	playsFor	Racing_de_Santander
Philco_(footballer)	playsFor	Figueirense_Futebol_Clube
Vincent_Sasso	playsFor	S.C._Beira-Mar
Osvaldo_Nartallo	playsFor	Beşiktaş_J.K.
Netan_Sansara	playsFor	PAEEK
Wenanty_Fuhl	playsFor	Wiener_Sport-Club
Vidak_Bratić	playsFor	FK_Vojvodina
Nacho_Monreal	playsFor	Spain_national_football_team
Miroslav_Milutinović	playsFor	FK_Inđija
Miklós_Horthy	hasWonPrize	Order_of_the_Chrysanthemum
Michael_Zullo	playsFor	Australia_national_under-23_association_football_team
Gábor_Bukrán	playsFor	Royal_Antwerp_F.C.
Luciano_Almeida	playsFor	Criciúma_Esporte_Clube
Francis_Awaritefe	playsFor	South_Melbourne_FC
Kevin_Reeves	playsFor	England_national_football_B_team
Diego_Trotta	playsFor	Atlético_Mexiquense
M'Baye_Niang	playsFor	A.C._Milan
Marco_Zoro	playsFor	A.C.R._Messina
Andy_O'Brien_(footballer)	playsFor	Vancouver_Whitecaps_FC
Richard_Pacquette	playsFor	Mansfield_Town_F.C.
Fernando_Sanz	wasBornIn	Madrid
Marco_Calamita	playsFor	VfR_Aalen
Aymeric_Laporte	playsFor	France_national_under-17_football_team
Bob_Kelso_(footballer)	playsFor	Dundee_F.C.
Julio_César_Suazo	playsFor	Deportes_Savio
Juan_Povedano_Martínez	playsFor	CD_Leganés
Milan_Obradović	playsFor	FC_Metalist_Kharkiv
Danny_Graham_(footballer)	playsFor	Derby_County_F.C.
Allan_Johnston	playsFor	Scotland_national_football_B_team
Eddie_Kelly_(footballer)	playsFor	A.F.C._Bournemouth
Ergin_Keleş	playsFor	Adanaspor
Astrit_Ajdarević	playsFor	Standard_Liège
Federico_Martorell	playsFor	Club_Atlético_Platense
Joshua_Logan	graduatedFrom	Princeton_University
Leandro_Guaita	playsFor	SV_Wehen_Wiesbaden
Papa_Waigo	playsFor	Al-Wahda_S.C.C.
Nick_Barmby	wasBornIn	Kingston_upon_Hull
Renan_Rocha	playsFor	Clube_Atlético_Paranaense
Barrow_A.F.C.	isLocatedIn	Barrow-in-Furness
Cássio_Oliveira	playsFor	Sport_Club_Internacional
Ian_Howat	wasBornIn	Wrexham
Evando	playsFor	Grêmio_Barueri_Futebol
Goran_Hunjak	playsFor	NK_Zagreb
Vardan_Mazalov	playsFor	FC_Anzhi_Makhachkala
Theodoros_Tripotseris	playsFor	Panathinaikos_F.C.
David_Woozley	playsFor	Farnborough_F.C.
Richard_Alderson	wasBornIn	Darlington
Tom_De_Sutter	playsFor	Belgium_national_under-21_football_team
Zlatko_Dedić	playsFor	Frosinone_Calcio
Haris_Škoro	playsFor	Yugoslavia_national_football_team
Perry_Van_der_Beck	playsFor	St._Louis_Steamers_(1979–88)
Henrik_Smedegaard	playsFor	Denmark_national_under-17_football_team
Zoran_Stojadinović	playsFor	UE_Figueres
Ľubomír_Moravčík	playsFor	JEF_United_Ichihara_Chiba
Piyawat_Thongman	playsFor	Bangkok_Glass_F.C.
Edno	playsFor	Avaí_Futebol_Clube
Senad_Tiganj	playsFor	SV_Wacker_Burghausen
Amado_Guevara	playsFor	Honduras_national_football_team
Robert_Olejnik	playsFor	Lincoln_City_F.C.
Carl_Pentney	playsFor	Bishop's_Stortford_F.C.
Claudio_Bieler	playsFor	Club_Atlético_Colón
Stuart_Lee	playsFor	Tampa_Bay_Rowdies_(1975–93)
Marijo_Marić	playsFor	SpVgg_Unterhaching
Ville_Taulo	playsFor	AC_Bellinzona
Gene_Hackman	wasBornIn	San_Bernardino,_California
Petar_Đenić	playsFor	Alki_Larnaca_F.C.
Luca_Belingheri	playsFor	A.C._Cesena
Peter_Zoïs	playsFor	Thurrock_F.C.
Pablo_Chinchilla	playsFor	L.D._Alajuelense
Miloš_Ristanović	playsFor	FK_Remont_Čačak
Ireland	isLocatedIn	Western_Europe
Héctor_Mancilla	playsFor	Club_Atlas
Sébastien_Siani	playsFor	Union_Douala
Steve_Jones_(footballer_born_March_1970)	playsFor	A.F.C._Bournemouth
Chișinău	isLocatedIn	Europe
Peter_Sellers	actedIn	Casino_Royale_(1967_film)
Ray_Bradbury	hasWonPrize	Daytime_Emmy_Award
Neale_Fenn	playsFor	Lincoln_City_F.C.
José_Fonte	playsFor	F.C._Penafiel
Ebrahim_Ghasempour	playsFor	Al_Rayyan_SC
Luis_Swisher	playsFor	Antigua_GFC
Michael_Simpkins	playsFor	Buxton_F.C.
Miami	isLocatedIn	United_States
John_Gielgud	hasWonPrize	Golden_Globe_Award
Daniel_Šmejkal	playsFor	1._FK_Příbram
Franck_Signorino	playsFor	Stade_Lavallois
Alecko_Eskandarian	playsFor	Chivas_USA
Giacomo_Mari	playsFor	U.S._Cremonese
Jamie_Forrester	playsFor	Lincoln_Moorlands_Railway_F.C.
Tristan_Lahaye	playsFor	Chamois_Niortais_F.C.
Holger_Fach	playsFor	KFC_Uerdingen_05
Mauro_Cantoro	playsFor	Club_Universitario_de_Deportes
Walter_Whittaker	playsFor	Swansea_City_A.F.C.
Gustavo_Oberman	playsFor	Club_Olimpo
Tomasz_Brzyski	playsFor	Legia_Warsaw
Mohamed_Diamé	playsFor	Rayo_Vallecano
Carlos_Alberto_Dias	playsFor	Tokyo_Verdy
Fahad_Al_Rashidi	playsFor	Al-Salmiya_SC
Alex_Rae_(footballer_born_1969)	wasBornIn	Glasgow
Balázs_Dzsudzsák	playsFor	FC_Dynamo_Moscow
Attila_Filkor	playsFor	A.S._Bari
Cor_Pot	playsFor	Fort_Lauderdale_Strikers_(1977–83)
Daniel_Jungwirth	playsFor	FC_Erzgebirge_Aue
Sergei_Kormiltsev	playsFor	FC_Dynamo_Kyiv
Kurt_Welzl	playsFor	Grazer_AK
Santiago_Solari	playsFor	San_Lorenzo_de_Almagro
Stanley_Menzo	wasBornIn	Paramaribo
Miguel_Monteiro	playsFor	Sporting_Clube_de_Portugal
Vasili_Kulkov	playsFor	Millwall_F.C.
Harlow	isLocatedIn	United_Kingdom
Alan_Rickman	actedIn	Dogma_(film)
Vlado_Papić	playsFor	HNK_Hajduk_Split
Anthony_Obodai	playsFor	Ghana_national_under-17_football_team
Hristo_Stoichkov	wasBornIn	Plovdiv
Damian_Mori	playsFor	Melbourne_Knights_FC
Harry_Lovatt	playsFor	Stafford_Rangers_F.C.
Luis_Aragonés	playsFor	Real_Betis
Sam_McMahon	playsFor	Hinckley_United_F.C.
Taner_Demirbaş	playsFor	Sakaryaspor
Karapet_Mikaelyan	playsFor	FC_Nika_Moscow
Artem_Kontsevoy	playsFor	FC_Chernomorets_Novorossiysk
Fereydoon_Fazli	playsFor	Tractor_Sazi_F.C.
Carlos_Adrián_Valdez	playsFor	Reggina_Calcio
Jørn_Andersen	playsFor	Fortuna_Düsseldorf
Antonis_Katsis	playsFor	AEK_Larnaca_F.C.
Thomas_Mann	influences	Saul_Bellow
Chumbinho	playsFor	Coritiba_Foot_Ball_Club
Elder_José_Figueroa	playsFor	Once_Municipal
Emanuel_Pogatetz	playsFor	Hannover_96
Gerry_Harrison_(footballer)	playsFor	Hull_City_A.F.C.
Christian_Stumpf	playsFor	FC_Linz
Don_Hutchison	playsFor	Sheffield_United_F.C.
Matt_O'Mahoney	playsFor	Bristol_Rovers_F.C.
Volodymyr_Polyovyi	playsFor	Ukraine_national_under-17_football_team
Danny_Westwood	playsFor	Canterbury_City_F.C.
Andy_Dibble	playsFor	Sheffield_United_F.C.
Jean-François_Gillet	playsFor	Standard_Liège
Dan_Ito	playsFor	Brunei_DPMM_FC
Peter_Hynes	playsFor	Tamworth_F.C.
Gabriele_Paonessa	playsFor	F.C._Crotone
Harry_Hooper_(footballer,_born_1933)	playsFor	Wolverhampton_Wanderers_F.C.
Tom_Soetaers	playsFor	Belgium_national_under-19_football_team
Stephen_McPhee	playsFor	Hull_City_A.F.C.
Baihakki_Khaizan	wasBornIn	Singapore
Mikkel_Thygesen	playsFor	Denmark_national_under-19_football_team
Aleksandar_Komadina	playsFor	FC_Khimki
Adrian_Sosnovschi	playsFor	FC_Dynamo_Kyiv
Marko_Pantelić	playsFor	FC_Lausanne-Sport
Paul_Mardon	playsFor	West_Bromwich_Albion_F.C.
Franz_Kafka	influences	John_Fowles
Ivica_Vrdoljak	playsFor	NK_Lučko
Washington_Luiz_Mascarenhas_Silva	playsFor	Esporte_Clube_Vitória
Denis_Calincov	playsFor	R.S.C._Anderlecht
Sasho_Petrovski	playsFor	Viborg_FF
Dejair_Jorge_Ferreira	playsFor	Clube_Atlético_Mineiro
Aleksandar_Đurić	playsFor	Warriors_F.C.
Gennadiy_Nizhegorodov	playsFor	FC_Lokomotiv_Nizhny_Novgorod
Ernesto_Mascheroni	playsFor	Club_Atlético_River_Plate_(Montevideo)
Eli_Wallach	actedIn	Dollars_Trilogy
Václav_Daněk	playsFor	Le_Havre_AC
Mao_Zedong	playsFor	Llanelli_A.F.C.
Janko_Tumbasević	playsFor	FK_Zeta
Marijan_Nikolić	playsFor	NK_Kamen_Ingrad
Silvio_Carrario	playsFor	Unión_de_Santa_Fe
Renato_Arapi	playsFor	Silkeborg_IF
I_Gusti_Bayu_Sutha	playsFor	Pelita_Bandung_Raya
Ričardas_Beniušis	playsFor	FK_DAC_1904_Dunajská_Streda
Marian_Ivan	playsFor	AEP_Paphos_F.C.
Karim_Niizigiyimana	playsFor	Armée_Patriotique_Rwandaise_F.C.
Ricardo_Manuel_Fernandes	playsFor	S.C._Salgueiros
Kosovo	hasWonPrize	Wollaston_Medal
Ciprian_Tătărușanu	playsFor	CS_Juventus_București
Dramane_Coulibaly	playsFor	Tours_FC
Hank_Azaria	actedIn	Celebrity_(film)
Fernando_Martel	playsFor	Santiago_Wanderers
Flemming_Povlsen	playsFor	Aarhus_Gymnastikforening
Marko_Šimić_(footballer_born_1988)	playsFor	ND_Mura_05
Micky_Quinn	playsFor	Stockport_County_F.C.
Luciano_Zavagno	playsFor	RC_Strasbourg
Jay_DeMerit	playsFor	United_States_men's_national_soccer_team
Massimo_Donati	playsFor	Celtic_F.C.
William_Viali	playsFor	U.S._Città_di_Palermo
Silvio_Carrario	playsFor	Quilmes_Atlético_Club
Paul_Doolin	playsFor	Portadown_F.C.
Zaal_Eliava	playsFor	Skonto_FC
Jorge_Madureira	playsFor	Associação_Académica_de_Coimbra_–_O.A.F.
Friedrich_Wilhelm_Joseph_Schelling	influences	Slavoj_Žižek
Jeffrey_Hoogervorst	playsFor	FC_Barcelona_B
Neil_Clarke_(American_soccer)	playsFor	Todd_Shipyards_(soccer_team)
Luis_Anaya	playsFor	C.D._FAS
Fábio_Santos_Romeu	playsFor	Brazil_national_under-20_football_team
Renato_Buso	playsFor	Juventus_F.C.
Ray_Johnston	playsFor	Gloucester_City_A.F.C.
Federico_Giunti	playsFor	Beşiktaş_J.K.
Goran_Lozanovski	playsFor	Australia_national_under-23_association_football_team
Yılmaz_Özlem	playsFor	İnegölspor
Valeri_Yevgenyevich_Sorokin	playsFor	FC_Tom_Tomsk
Colin_Powell	graduatedFrom	City_College_of_New_York
Elias_Vattis	playsFor	Ethnikos_Achna_FC
Paul_Verlaine	wasBornIn	Metz
Hernán_Barcos	playsFor	Grêmio_Foot-Ball_Porto_Alegrense
Iván_Guerrero	playsFor	Fort_Lauderdale_Strikers
Oliver_Bozanić	playsFor	Australia_national_under-23_association_football_team
Paraskevas_Christou	playsFor	AEK_Larnaca_F.C.
Martín_Arzuaga	playsFor	Junior_F.C.
George_Owino	playsFor	Saint_George_SC
Dante_López	playsFor	F.C._Crotone
Cameroon	hasOfficialLanguage	English_language
Nir_Nachum	playsFor	Hapoel_Rishon_LeZion_F.C.
Jorge_López_Montaña	playsFor	RCD_Mallorca
Florin_Bratu	playsFor	FC_Nantes
Queens	isLocatedIn	United_States
Jerry_Brown	wasBornIn	San_Francisco
Juan_Manuel_Azconzábal	playsFor	Estudiantes_de_La_Plata
Ray_Wilkins	playsFor	England_national_under-21_football_team
Fernando_Sales	playsFor	Hércules_CF
John_Ball_(soccer)	playsFor	California_Cougars
Alexander_Buch	playsFor	SV_Elversberg
Lee_Marvin	hasWonPrize	Golden_Globe_Award
Albert_Quixall	playsFor	England_national_football_team
Ansi_Agolli	playsFor	FC_Luzern
Maksym_Lisovyi	playsFor	FC_Borysfen_Boryspil
Nikola_Jerkan	playsFor	Real_Oviedo
Guy_Whittingham	playsFor	Watford_F.C.
Frank_Saborowski	playsFor	Germany_national_football_B_team
Dariusz_Jackiewicz	playsFor	Odra_Wodzisław
Marco_Capparella	playsFor	Calcio_Catania
Simon_Azoulay_Pedersen	playsFor	Silkeborg_IF
Predrag_Spasić	playsFor	CA_Marbella
Charles_Maurras	influences	Maurice_Blanchot
Doug_Allder	playsFor	Millwall_F.C.
Miroslav_Kadlec	playsFor	1._FC_Kaiserslautern
John_Oster	playsFor	Sunderland_A.F.C.
Vojislav_Vranjković	playsFor	CS_Turnu_Severin
Jan_Halvor_Halvorsen	playsFor	IK_Start
Marco_Pascolo	playsFor	FC_Zürich
Njogu_Demba-Nyrén	playsFor	Panathinaikos_F.C.
Leon_Mike	playsFor	England_national_under-16_football_team
Hansi_Müller	playsFor	Germany_national_football_B_team
Leonardo_Rodríguez	playsFor	Club_Atlético_Vélez_Sarsfield
David_Kannemeyer	playsFor	SuperSport_United_F.C.
Revaz_Kemoklidze	playsFor	FC_Torpedo_Kutaisi
Ádám_Szalai	playsFor	FC_Schalke_04
Andy_Johnson_(Welsh_footballer)	playsFor	West_Bromwich_Albion_F.C.
Abdullahi_Ishaka	playsFor	Shkumbini_Peqin
Wendel_Santana_Pereira_Santos	playsFor	Goiás_Esporte_Clube
Clark_Keltie	playsFor	Gateshead_F.C.
Robert_Benchley	influences	Steve_Martin
David_Casablanca	playsFor	S.C._Freamunde
Ragnar_Margeirsson	playsFor	SK_Sturm_Graz
Shlomi_Edri	playsFor	Hapoel_Haifa_F.C.
Ernie_Taylor_(footballer_born_1925)	playsFor	Sunderland_A.F.C.
Richard_Edghill	wasBornIn	Oldham
Jarosław_Białek	playsFor	Widzew_Łódź
Antonio_Soldevilla	playsFor	CD_Alcoyano
Joe_Bacuzzi	playsFor	Chelsea_F.C.
Nik_Mrdja	playsFor	Central_Coast_Mariners_FC
Paul_Millar	playsFor	Bangor_F.C.
Jody_Banim	playsFor	Torquay_United_F.C.
Johann_Carrasso	playsFor	France_national_under-21_football_team
Alen_Bašić	playsFor	FK_Željezničar_Sarajevo
Vannevar_Bush	graduatedFrom	Tufts_University
Carlos_Ochoa	playsFor	Club_Necaxa
Mutiu_Adepoju	wasBornIn	Ibadan
David_Targamadze	playsFor	PFC_Oleksandriya
Michele_Di_Piedi	playsFor	Doncaster_Rovers_F.C.
Jimmy_Gilmour	playsFor	Kilmarnock_F.C.
Andy_King_(footballer,_born_1956)	playsFor	Palloseura_Kemi_Kings
Gordon_Schildenfeld	playsFor	PAOK_FC
Alecsandro	playsFor	Clube_Atlético_Mineiro
Madeira_Airport	isLocatedIn	Funchal
Joey_Worthen	playsFor	Carolina_RailHawks
York_City_F.C.	isLocatedIn	York
George_Leandro_Abreu_de_Lima	playsFor	Associação_Desportiva_São_Caetano
Levan_Silagadze	playsFor	FC_Lokomotivi_Tbilisi
Sergio_Amaury_Ponce	playsFor	Deportivo_Toluca_F.C.
Vladimir_Nabokov	influences	Mohsin_Hamid
Aleksandar_Radosavljević_(footballer_born_1979)	playsFor	NK_Celje
Craig_Herbert	playsFor	Barwell_F.C.
Marco_Gómez	playsFor	San_Luis_F.C.
Nicole_Kidman	actedIn	Dogville
C.D._Olivais_e_Moscavide	isLocatedIn	Lisbon
Slavčo_Georgievski	playsFor	Inter_Baku_PIK
Michael_Petkovic	playsFor	Sivasspor
Spike_Lee	graduatedFrom	New_York_University
Tamás_Takács	playsFor	Hungary_national_under-21_football_team
William_Ferreira	playsFor	Club_Universidad_de_Guadalajara
Fredy_Guarín	playsFor	Colombia_national_under-17_football_team
Walter_Zenga	playsFor	Inter_Milan
Javier_Muñoz_Mustafá	playsFor	CD_Tenerife
Neil_Etheridge	playsFor	England_national_under-16_football_team
Steve_Whitworth	playsFor	England_national_football_team
Gunnar_Nielsen_(footballer)	playsFor	Blackburn_Rovers_F.C.
Gaetano_De_Rosa	playsFor	Reggina_Calcio
Oribe_Peralta	playsFor	Club_León
Rodrigo_Palacio	playsFor	Inter_Milan
Michael_Curcija	playsFor	FK_Partizan
Jorge_Araujo	playsFor	Cienciano
Shimon_Abuhatzira	playsFor	Maccabi_Haifa_F.C.
David_Healy_(footballer)	playsFor	Bury_F.C.
Mahir_Sağlık	playsFor	VfL_Wolfsburg
Roberto_Nurse	playsFor	Club_León
Santiago_Aragón	wasBornIn	Málaga
Jeroen_Boere	playsFor	De_Graafschap
Daniel_Van_Buyten	playsFor	Belgium_national_football_team
Yervand_Sukiasyan	playsFor	Kavala_F.C.
Ernest_Hemingway	hasWonPrize	Nobel_Prize_in_Literature
Phil_King_(footballer)	playsFor	Kidderminster_Harriers_F.C.
Gabriel_Loeschbor	playsFor	Independiente_Rivadavia
Paris_Elia	playsFor	Alki_Larnaca_F.C.
Albert_Luque	playsFor	Newcastle_United_F.C.
Andy_McLaren	playsFor	Dundee_United_F.C.
Troy_Perkins	playsFor	Portland_Timbers
Cedric_van_der_Gun	playsFor	AFC_Ajax
Gianluca_Signorini	playsFor	Parma_F.C.
Serhiy_Bilozir	playsFor	FC_Arsenal_Kyiv
Nwankwo_Kanu	playsFor	Arsenal_F.C.
Demy_de_Zeeuw	playsFor	FC_Spartak_Moscow
Bobsam_Elejiko	playsFor	FSV_Wacker_90_Nordhausen
Gustavo_Fuentes	playsFor	C.A._Cerro
Hugo_Henrique_Assis_do_Nascimento	playsFor	Sport_Club_Corinthians_Paulista
Lai_Yiu_Cheong	playsFor	Sun_Hei_SC
José_Luis_Loreto	playsFor	Spain_national_under-18_football_team
Glen_Southam	playsFor	Boreham_Wood_F.C.
Robert_Malm	playsFor	Nîmes_Olympique
Disney_Junior_(Latin_America)	isLocatedIn	Venezuela
Bratislav_Živković	playsFor	FK_BASK
Klaus_Wunder	playsFor	Germany_national_football_B_team
Dragoslav_Stepanović	playsFor	Eintracht_Frankfurt
Johnny_Vegas_Fernández	playsFor	Peru_national_football_team
Martin_Harnik	playsFor	Fortuna_Düsseldorf
Mamadou_Samassa_(footballer_born_1986)	playsFor	Mali_national_football_team
Pierre-Alain_Frau	playsFor	Olympique_Lyonnais
Billy_Semple	playsFor	Albion_Rovers_F.C.
Gibraltar	hasOfficialLanguage	English_language
Archie_Turner	playsFor	England_national_football_team
Rocco_Placentino	playsFor	S.S._Teramo_Calcio
Isaías_Marques_Soares	playsFor	Coventry_City_F.C.
Eduard_Tsykhmeystruk	playsFor	FC_Borysfen_Boryspil
Iulian_Filipescu	wasBornIn	Slatina,_Romania
Nick_Burton	playsFor	Harrow_Borough_F.C.
Derek_Holmes	playsFor	Rotherham_United_F.C.
Taiwo_Atieno	playsFor	Walsall_F.C.
Javier_Claut	wasBornIn	Buenos_Aires
Ali_Mousavi	playsFor	Foolad_F.C.
Mark_Milligan	playsFor	Blacktown_City_FC
Pape_Samba_Ba	playsFor	KS_Polkowice
Khalid_Boulahrouz	playsFor	Netherlands_national_under-21_football_team
David_Nakhid	playsFor	Emirates_Club
Damir_Memišević	playsFor	FK_Željezničar_Sarajevo
Denis_Caniza	playsFor	Paraguay_national_football_team
Tommy_Briggs	playsFor	Coventry_City_F.C.
Anderson_Roberto_da_Silva_Luiz	playsFor	Sport_Club_Corinthians_Paulista
Scott_Phelan	playsFor	England_national_under-17_football_team
Sergio_Escudero_(footballer_born_1983)	playsFor	Coritiba_Foot_Ball_Club
Matías_Manrique	playsFor	Arsenal_de_Sarandí
Franco_Miranda	playsFor	St._Mirren_F.C.
Richard_Cresswell	playsFor	York_City_F.C.
Mark_Corcoran	playsFor	Stranraer_F.C.
Paul_Baker	wasBornIn	Newcastle_upon_Tyne
Heiner_Backhaus	playsFor	Hannover_96
Kevin_Bobson	wasBornIn	Amsterdam
Ivan_Trabalík	playsFor	Aris_Limassol_F.C.
Trond_Andersen	playsFor	AaB_Fodbold
Richard_Dryden	playsFor	Bristol_City_F.C.
Yukihiko_Sato	playsFor	Montedio_Yamagata
Peter_Debye	hasWonPrize	Rumford_Medal
Martin_Buglione	playsFor	Erith_&_Belvedere_F.C.
Friedrich_Nietzsche	influences	Hermann_Hesse
Oscar_Luis_Vera	playsFor	Unión_de_Santa_Fe
Kemal_Aslan	playsFor	Gaziantep_Büyükşehir_Belediyespor
Karl_Sesta	wasBornIn	Vienna
Marco_Delvecchio	playsFor	F.B.C._Unione_Venezia
Neil_McBain	playsFor	Everton_F.C.
Martin_Buglione	playsFor	Sittingbourne_F.C.
Oswald_Spengler	influences	Zaki_al-Arsuzi
Lee_Hendrie	playsFor	Brighton_&_Hove_Albion_F.C.
Ali_Bouafia	playsFor	US_Créteil-Lusitanos
Francis_Jeffers	playsFor	Motherwell_F.C.
Líder_Mármol	playsFor	C.F._Atlante
Radomir_Antić	playsFor	FK_Partizan
Rasmus_Jönsson	playsFor	FSV_Frankfurt
Anton_Chekhov	isCitizenOf	Russian_Empire
Nicky_Adler	playsFor	SV_Sandhausen
Jorge_Cadete	playsFor	Brescia_Calcio
Luciano_Olguín	playsFor	K.S.K._Beveren
Roman_Eremenko	playsFor	FF_Jaro
Matteo_Gentili	playsFor	Reggina_Calcio
Ali_Wahaib_Shnaiyn	playsFor	Al-Naft
Luis_Hernández_(footballer)	playsFor	Mexico_national_football_team
Winnipeg	isLocatedIn	Canada
Paul_McShane_(footballer)	playsFor	Brighton_&_Hove_Albion_F.C.
Wellington_Katzor_de_Oliveira	playsFor	Associação_Desportiva_São_Caetano
Willie_Fernie_(footballer)	playsFor	Scottish_Football_League_XI
Hubert_Baumgartner	playsFor	FC_Admira_Wacker_Mödling
Fabio_Caracciolo	playsFor	Lommel_United
Alysson_Marendaz_Marins	playsFor	Centro_de_Futebol_Zico_Sociedade_Esportiva
Oladipupo_Martins	playsFor	Inter_Milan
Miguel_Llera	playsFor	CD_San_Fernando
Andrey_Zhelyazkov	playsFor	Beerschot_AC
Aaran_Lines	playsFor	VfL_Osnabrück
Dame_Diouf	playsFor	SV_Arminia_Hannover
Davorin_Kablar	playsFor	FC_Pasching
Kahê	playsFor	Associação_Portuguesa_de_Desportos
Arthur_Stepanyan	playsFor	FC_Amkar_Perm
Dejan_Radosavljević	playsFor	FK_Jagodina
Jon_Inge_Høiland	playsFor	IFK_Göteborg
Richard_Morales	playsFor	Uruguay_national_football_team
Abdoul_Salam_Sow	playsFor	Skoda_Xanthi_F.C.
Josimar_Mosquera	playsFor	Atlético_Nacional
José_Luis_Capdevila	playsFor	Real_Valladolid
Dunga	playsFor	Sport_Club_Internacional
Maximiliano_Flotta	playsFor	Deportivo_Alavés
Oļegs_Laizāns	playsFor	FC_Yenisey_Krasnoyarsk
Steve_Tosh	playsFor	Livingston_F.C.
Thomas_Villadsen	playsFor	FC_Ceahlăul_Piatra_Neamț
Joe_Nibloe	playsFor	Scottish_Football_League_XI
Richard_Hodgson	playsFor	Nottingham_Forest_F.C.
François_Omam-Biyik	playsFor	Stade_Rennais_F.C.
Jamie_Harris	playsFor	Drogheda_United_F.C.
Lawrence_Durrell	influences	Roger_Zelazny
Reinhard_Stumpf	playsFor	Karlsruher_SC
Adrian_Ropotan	playsFor	FC_Dynamo_Moscow
Sergei_Omelianovitch	playsFor	K.S.K._Ronse
Balázs_Rabóczki	playsFor	Budapest_Honvéd_FC
Brimah_Razak	playsFor	CD_Guadalajara_(Spain)
Billy_Woods_(Irish_footballer)	playsFor	Republic_of_Ireland_national_under-21_football_team
Jérémy_Toulalan	playsFor	France_national_under-21_football_team
Rafael_Scheidt	playsFor	Guizhou_Renhe_F.C.
Leo_Roget	playsFor	Rushden_&_Diamonds_F.C.
Geert_den_Ouden	playsFor	Valletta_F.C.
David_Silva_(Cape_Verdean_footballer)	playsFor	PFC_Lokomotiv_Mezdra
George_Gebro	playsFor	AEL_Limassol
Mobi_Oparaku	wasBornIn	Owerri
Leszek_Pisz	playsFor	Śląsk_Wrocław
Amine_Linganzi	playsFor	AS_Saint-Étienne
Tomasz_Zdebel	playsFor	Gençlerbirliği_S.K.
Dwight_Pezzarossi	playsFor	Club_Comunicaciones
Mohammed_Ghaddar	playsFor	Lebanon_national_football_team
Bernardo_Sainz	playsFor	Monarcas_Morelia
Ivica_Osim	playsFor	Valenciennes_FC
Markus_Weinzierl	playsFor	FC_Bayern_Munich_II
Cristian_Marrugo	playsFor	Deportes_Tolima
Giani_Kiriţă	playsFor	Samsunspor
Alain_Delon	actedIn	Spirits_of_the_Dead
Gregory_Peck	actedIn	How_the_West_Was_Won_(film)
Paul_Carden	playsFor	Rochdale_A.F.C.
Nicola_Beati	playsFor	F.C._Crotone
Slavko_Matić	playsFor	PFC_Slavia_Sofia
Baruch_Spinoza	influences	Moses_Mendelssohn
Shaun_Bajada	playsFor	Marsaxlokk_F.C.
Carlos_Roca_(footballer)	playsFor	Northwich_Victoria_F.C.
Wênio	playsFor	Sport_Club_Corinthians_Alagoano
Gottlob_Frege	isInterestedIn	Philosophy_of_language
Chris_Dagnall	playsFor	Scunthorpe_United_F.C.
Filipe_da_Costa	wasBornIn	Lisbon
Sergei_Hohlov-Simson	playsFor	FC_Kuressaare
Gerald_Klews	playsFor	Hamburger_SV_II
Oli_(footballer)	playsFor	Cádiz_CF
Jean_Deloffre	playsFor	Paris_Saint-Germain_F.C.
Paul_Moody_(footballer)	playsFor	Aldershot_Town_F.C.
Fandi_Ahmad	playsFor	Pahang_FA
Adam_Casey	playsFor	APIA_Leichhardt_Tigers_FC
Shaun_Bartlett	playsFor	Bloemfontein_Celtic_F.C.
Jack_Robinson_(footballer_born_1870)	playsFor	New_Brighton_Tower_F.C.
Jagoš_Vuković	playsFor	Roda_JC_Kerkrade
René_Lewejohann	playsFor	Bonner_SC
Carl_Muggleton	playsFor	Stoke_City_F.C.
David_Degen	playsFor	Switzerland_national_under-19_football_team
Michal_Hipp	playsFor	MFK_Košice
Grzegorz_Szamotulski	playsFor	Hutnik_Warszawa
Peter_Barnes_(footballer)	playsFor	Wimbledon_F.C.
Giovane_Élber	playsFor	Borussia_Mönchengladbach
Tommy_Kinsella	playsFor	Drumcondra_F.C.
Tobias_Nickenig	playsFor	VfL_Osnabrück
Stéphane_Noro	playsFor	CS_Sedan_Ardennes
Mauricio_Wright	playsFor	C.S._Herediano
Artur_Maloyan	playsFor	FC_Anzhi_Makhachkala
Leon_Mike	wasBornIn	Manchester
José_Araquistáin	playsFor	Real_Sociedad
Jarosław_Białek	playsFor	St_Patrick's_Athletic_F.C.
Moreno_Aoas_Vidal	playsFor	Fortaleza_Esporte_Clube
Jajá	playsFor	Sport_Club_Internacional
Igor_Budiša	playsFor	FC_Shinnik_Yaroslavl
Halle_Berry	wasBornIn	Cleveland
Maimonides	playsFor	Reggina_Calcio
Peter_Cawley	playsFor	Koparit
Albert_Guðmundsson_(footballer_born_1958)	playsFor	Edmonton_Drillers_(1979–82)
Leandro_de_Deus_Santos	playsFor	Borussia_Dortmund_II
Patrick_Kisnorbo	wasBornIn	Melbourne
Fred_Hoyle	hasWonPrize	Gold_Medal_of_the_Royal_Astronomical_Society
Daniel_Jensen	playsFor	F.C._Copenhagen
Mark_Carter_(footballer)	playsFor	Barnet_F.C.
Stefan_Reuter	playsFor	Borussia_Dortmund
Bülent_Kocabey	playsFor	Karşıyaka_S.K.
Andrei_Kanchelskis	playsFor	FC_Krylia_Sovetov_Samara
Barry_Robson	playsFor	Middlesbrough_F.C.
Andy_Impey	playsFor	Nottingham_Forest_F.C.
Ahmed_Abou_Moslem	playsFor	Al_Ahly_SC
Désiré_Mbonabucya	playsFor	K.V.K._Tienen
Pays_de_la_Loire	isLocatedIn	France
Alain_Gaspoz	playsFor	FC_Winterthur
Darío_Caballero	playsFor	Cerro_Porteño
Cliff_Akurang	playsFor	Barnet_F.C.
Nelinho_Quina	playsFor	Peru_national_under-20_football_team
Javi_Ruiz	playsFor	UD_Almería
Washington_(footballer)	playsFor	Sociedade_Esportiva_e_Recreativa_Caxias_do_Sul
Simon_Walton	playsFor	England_national_under-16_football_team
Bert_Patenaude	playsFor	United_States_men's_national_soccer_team
Sagiv_Cohen_(footballer)	playsFor	Hapoel_Ironi_Acre_F.C.
Kuala_Lumpur_International_Airport	isLocatedIn	Selangor
Mario_Evaristo	playsFor	Sportivo_Barracas
Hakan_Bayraktar	playsFor	Fenerbahçe_S.K.
Zoltán_Bükszegi	playsFor	Alki_Larnaca_F.C.
Moritz_Leitner	playsFor	VfB_Stuttgart
David_Riley	playsFor	Boston_United_F.C.
Jonas_Axeldal	playsFor	Malmö_FF
Idrissa_Keita	playsFor	C.D._Santa_Clara
Alex_Manninger	playsFor	SK_Vorwärts_Steyr
Yuvan_Shankar_Raja	wasBornIn	Chennai
Igor_Demo	wasBornIn	Nitra
Andy_Goram	playsFor	Motherwell_F.C.
Aaron_Brown_(footballer_born_1983)	playsFor	Yeovil_Town_F.C.
Paco_(footballer)	playsFor	Rayo_Vallecano
Francesco_Graziani	playsFor	A.S._Roma
Wasiu_Taiwo	playsFor	De_Graafschap
Gary_Mills_(footballer,_born_1961)	playsFor	Boston_United_F.C.
University_of_Leeds	isLocatedIn	England
Esteban_Fuertes	playsFor	Club_Atlético_Colón
Dion_Esajas	playsFor	PEC_Zwolle
Jorge_Francisco_Vargas	playsFor	Chile_national_football_team
Mladen_Lazarević	playsFor	FC_Ordabasy
Scott_Willis_(footballer)	playsFor	Doncaster_Rovers_F.C.
Claudio_Ranieri	wasBornIn	Rome
Germán_Carty	playsFor	Sporting_Cristal
Helton_Dos_Reis	playsFor	AS_Saint-Étienne
Rahim_Zafer	playsFor	Daegu_FC
William_Machado_de_Oliveira	playsFor	América_Futebol_Clube_(MG)
Martín_Cardetti	playsFor	Club_Atlético_River_Plate
Rafael_Uiterloo	playsFor	A.V.V._Zeeburgia
Serhiy_Popov	playsFor	FC_Metalurh_Zaporizhya
Aiman_Napoli	playsFor	A.C._Prato
Bruno_Lança_Andrade	playsFor	Wuhan_Optics_Valley_F.C.
Kevin_Welsh	playsFor	New_Jersey_Americans_(soccer)
Spira_Grujić	playsFor	FC_Twente
Chris_O'Grady	playsFor	Bradford_City_A.F.C.
Jairo_Álvarez_Gutiérrez	playsFor	Real_Oviedo
Daniel_Parejo	playsFor	Spain_national_under-20_football_team
Salman_Khan	hasWonPrize	National_Film_Awards_(India)
Sebastián_Vázquez	playsFor	Liverpool_F.C._(Montevideo)
Kyle_Perry	playsFor	Northwich_Victoria_F.C.
Cyril_Domoraud	playsFor	Torku_Konyaspor
Thomas_Henry_Huxley	isCitizenOf	United_Kingdom
Jeremiah_White	wasBornIn	Washington,_D.C.
Rafael_Bastos	playsFor	S.C._Braga
Anthony_Williams_(footballer)	playsFor	Bury_F.C.
Jason_van_Blerk	playsFor	Runcorn_F.C._Halton
Muamer_Vugdalič	playsFor	Niki_Volos_F.C.
Georgie_Mee	playsFor	Derby_County_F.C.
Stephen_Henderson_(footballer,_born_1988)	playsFor	Weymouth_F.C.
João_Paulo_Pinto_Ribeiro	playsFor	G.D._Estoril_Praia
Ben_Muirhead	playsFor	Rochdale_A.F.C.
Hugo_Viana	playsFor	CA_Osasuna
Ivan_Lendrić	playsFor	HNK_Hajduk_Split
Aleksandre_Kobakhidze	playsFor	Inter_Baku_PIK
Jean_Simmons	isMarriedTo	Stewart_Granger
Dr._Seuss	playsFor	Chicago_Fire_Soccer_Club
José_Manuel_Rey	playsFor	Club_Sport_Emelec
José_del_Solar	playsFor	Peru_national_football_team
Mateja_Kežman	playsFor	FC_BATE_Borisov
John_Travolta	actedIn	Primary_Colors_(film)
Trevor_Birch	playsFor	Skelmersdale_United_F.C.
Henri_Lefebvre	influences	Jean_Baudrillard
Steven_Watt_(footballer)	playsFor	Ross_County_F.C.
Il_Caravaggio_International_Airport	isLocatedIn	Bergamo
Manit_Noywech	playsFor	Persijap_Jepara
Brian_McGorry	playsFor	Peterborough_United_F.C.
Piotr_Ruszkul	playsFor	GKP_Gorzów_Wielkopolski
Frank_O'Neill_(footballer)	playsFor	Waterford_United_F.C.
Scott_Willis_(footballer)	playsFor	Vauxhall_Motors_F.C.
Roman_Jakóbczak	playsFor	Pogoń_Szczecin
Borko_Veselinović	playsFor	FK_Javor_Ivanjica
Benik_Afobe	playsFor	Millwall_F.C.
Daniel_Sikorski	playsFor	SKN_St._Pölten
Emiliano_Insúa	playsFor	Argentina_national_under-20_football_team
Adie_Mike	playsFor	Gainsborough_Trinity_F.C.
Jim_McLaughlin_(footballer)	playsFor	Birmingham_City_F.C.
Ivan_Golac	playsFor	A.F.C._Bournemouth
Tony_Kelly_(footballer)	playsFor	Millwall_F.C.
Graham_Hyde	playsFor	Peterborough_United_F.C.
Ismaël_Bouzid	playsFor	Algeria_national_football_team
Radislav_Dragićević	playsFor	FK_Borac_Čačak
Lubomir_Velichkov	playsFor	FC_Sportist_Svoge
Scott_Brown_(footballer,_born_May_1985)	playsFor	Chester_F.C.
Alan_Mahon	playsFor	Burnley_F.C.
Harry_Hadley	playsFor	Croydon_Common_F.C.
Kiril_Pavlyuchek	playsFor	Belarus_national_under-21_football_team
Siniša_Dobrašinović	playsFor	FK_Rudar_Pljevlja
Philippe_Redon	playsFor	FC_Rouen
Andreas_Granqvist	playsFor	Wigan_Athletic_F.C.
Paul_Erdős	worksAt	Princeton_University
Bahman_Tahmasebi	playsFor	Sepahan_Isfahan_F.C.
Jaroslav_Nesvadba	playsFor	NK_Inter_Zaprešić
Oren_Nissim	playsFor	Hapoel_Nir_Ramat_HaSharon_F.C.
Said_Husejinović	playsFor	FK_Sarajevo
Risto_Kallaste	playsFor	SK_Tallinna_Sport
Daniel_Wass	playsFor	Brøndby_IF
Paul_Ritchie_(footballer_born_1975)	playsFor	Carolina_RailHawks
Rafael_van_der_Vaart	playsFor	Netherlands_national_under-19_football_team
Jimmy_Glass	playsFor	Dulwich_Hamlet_F.C.
Connor_Wickham	wasBornIn	Hereford
Auguste_Comte	influences	Charles_Maurras
Florin_Bratu	playsFor	FC_Rapid_București
Aleksandr_Maslov	playsFor	FC_Rostov
Sandro_Burki	playsFor	BSC_Young_Boys
Jorge_Cadete	playsFor	S.L._Benfica
Miloš_Ninković	wasBornIn	Belgrade
Iurie_Miterev	playsFor	FC_Mashuk-KMV_Pyatigorsk
Yasin_Çakmak	playsFor	Turkey_national_football_team
Sonny_Guadarrama	playsFor	Santos_Laguna
Vasilis_Avramidis	playsFor	Niki_Volos_F.C.
Rinaldo_Martino	wasBornIn	Rosario,_Santa_Fe
Egon_Piechaczek	playsFor	Ruch_Chorzów
Scott_Benedetti	playsFor	Colorado_Foxes
Alfredo_Di_Stéfano	playsFor	Argentina_national_football_team
Keith_Walwyn	playsFor	Carlisle_United_F.C.
Kévin_Bru	playsFor	PFC_Levski_Sofia
Miguel_Ángel_Nieto	playsFor	Real_Madrid_C
Branko_Oblak	playsFor	FC_Schalke_04
Murat_Şahin	playsFor	Fenerbahçe_S.K.
Francisco_Lojacono	playsFor	Club_de_Gimnasia_y_Esgrima_La_Plata
Bertie_Brayley	playsFor	Swindon_Town_F.C.
François_Truffaut	playsFor	Rochdale_A.F.C.
Sascha_Herröder	playsFor	Viktoria_Aschaffenburg
José_Emilio_Amavisca	playsFor	Racing_de_Santander
Aleksei_Igonin	playsFor	Russia_national_football_team
Ray_Newland	playsFor	Clydebank_F.C.
Lior_Asulin	playsFor	Maccabi_Petah_Tikva_F.C.
Lucas_Favalli	playsFor	Apollon_Kalamarias
Derek_Kevan	playsFor	Stockport_County_F.C.
Hans-Peter_Berger	playsFor	Leixões_S.C.
Ángel_Guirado	playsFor	Córdoba_CF
André_Paulino	playsFor	Associação_Desportiva_Cabofriense
Koper	isLocatedIn	Slovenia
Édson_Andrade_Almeida	playsFor	São_Paulo_FC
Branko_Ilić	playsFor	FC_Moscow
Marius_Stankevičius	playsFor	U.C._Sampdoria
Marco_Ferreira	playsFor	F.C._Paços_de_Ferreira
Mohd_Farderin_Kadir	playsFor	Malaysia_national_under-23_football_team
Michael_Sternkopf	playsFor	Kickers_Offenbach
Burhanettin_Kaymak	playsFor	SV_Wehen_Wiesbaden
Emanuele_Del_Vecchio	playsFor	Hellas_Verona_F.C.
Roberto_Maltagliati	playsFor	A.S.D._SolbiaSommese_Calcio
Robbie_Fowler	playsFor	Cardiff_City_F.C.
Edgar_Ramos_(footballer)	playsFor	Patriotas_F.C.
Francis_Ford_Coppola	created	Is_Paris_Burning?
Junior_Bent	wasBornIn	Huddersfield
Vyacheslav_Shevchuk	playsFor	FC_Torpedo_Moscow
David_Cross	actedIn	Kung_Fu_Panda
Steve_von_Bergen	playsFor	Neuchâtel_Xamax
Daniel_Beichler	playsFor	Hertha_BSC
Nassim_Mendil	playsFor	Paganese_Calcio_1926
Ayden_Duffy	playsFor	Cambridge_United_F.C.
Ivan_Gvozdenović	playsFor	FK_Vojvodina
Jon_Macken	playsFor	Northwich_Victoria_F.C.
Panayiotis_Spyrou	wasBornIn	Nicosia
Jack_Lemmon	playsFor	Ñublense
Rafael_Barber	playsFor	UB_Conquense
Mehdi_Nafti	playsFor	Real_Murcia
Louis_Brain	playsFor	Dandenong_Thunder_SC
Róbert_Zsolnai	playsFor	Budapest_Honvéd_FC
Matthieu_Bochu	playsFor	Ravenna_F.C.
Victor_Zvunka	playsFor	Olympique_de_Marseille
Peter_Coyne	playsFor	Ashton_United_F.C.
Scot_Gemmill	playsFor	Leicester_City_F.C.
Mark_Gayle	playsFor	Walsall_F.C.
Felipe_Caicedo	playsFor	Al_Jazira_Club
Vinnie_Jones	playsFor	Sheffield_United_F.C.
Francesco_Antonioli	playsFor	A.C._Pisa_1909
Matthew_Bingley	wasBornIn	Sydney
Eric_Black	wasBornIn	Bellshill
Douglas_Marques	playsFor	Grêmio_Barueri_Futebol
Carl_XVI_Gustaf_of_Sweden	isMarriedTo	Queen_Silvia_of_Sweden
Frank_Ordenewitz	playsFor	SV_Werder_Bremen_II
Dean_West	playsFor	Stamford_A.F.C.
Pelin_Çelik	playsFor	Turkey_women's_national_volleyball_team
Jonjo_Shelvey	playsFor	Arsenal_F.C.
Oli_(footballer)	playsFor	Real_Betis
Adrian_Falub	playsFor	FC_Universitatea_Cluj
Daniel_Wass	playsFor	Fredrikstad_FK
Andriy_Poroshyn	playsFor	FC_Daugava
Gavin_Tomlin	playsFor	Port_Vale_F.C.
Kezie_Ibe	playsFor	Yeovil_Town_F.C.
Dalton_Alan_Munaretto	playsFor	Esporte_Clube_Cruzeiro
Charles_Dickens	influences	Joyce_Carol_Oates
Cristian_González_Aidinovich	playsFor	Maccabi_Tel_Aviv_F.C.
Lee_Harrison	playsFor	Charlton_Athletic_F.C.
Trevor_Morgan_(footballer)	playsFor	Happy_Valley_AA
Martin_Frýdek	playsFor	SC_Xaverov
Peter_Falk	wasBornIn	New_York_City
Paul_Armstrong	playsFor	Airdrieonians_F.C._(1878)
Uche_Okafor	playsFor	K.R.C._Mechelen
Ediz_Bahtiyaroğlu	playsFor	Bucaspor
Kristian_Sørli	playsFor	Viking_FK
Chicago_Blackhawks	isLocatedIn	Chicago
Justo_Villar	playsFor	Club_Sol_de_América
Hakan_Aslantaş	playsFor	Kayserispor
Mike_Sheron	wasBornIn	Liverpool
Almir_Lopes_de_Luna	playsFor	América_Futebol_Clube_(RN)
Sergey_Mironov_(footballer)	playsFor	FC_Zenit_Saint_Petersburg
Filip_Despotovski	playsFor	FC_Vorskla_Poltava
Andy_Papoulias	playsFor	Carolina_Lightnin'
Gabe_Garcia_(soccer)	playsFor	Hershey_Wildcats
Mohammed_Abdellaoue	playsFor	Hannover_96
Jimmy_Hinch	playsFor	Southport_F.C.
Marcel_Augusto_Ortolan	playsFor	Associação_Académica_de_Coimbra_–_O.A.F.
Marco_Delvecchio	playsFor	Brescia_Calcio
John_Akinde	playsFor	Dagenham_&_Redbridge_F.C.
Karol_Dobiaš	playsFor	Bohemians_1905
Billy_McEwan_(footballer,_born_1951)	playsFor	Brighton_&_Hove_Albion_F.C.
Simon_Cox_(footballer,_born_1987)	playsFor	Brentford_F.C.
Joseph_Stiglitz	graduatedFrom	Amherst_College
Filippo_Maniero	playsFor	U.S._Città_di_Palermo
Rónald_Gómez	playsFor	L.D._Alajuelense
Dennis_Wit	playsFor	Jacksonville_Tea_Men
Clemerson_de_Araújo_Soares	playsFor	Fluminense_FC
Peter_Billing	playsFor	Northwich_Victoria_F.C.
Anton_Žlogar	playsFor	NK_Olimpija_Ljubljana_(defunct)
Hanover	isLocatedIn	Germany
Alex_Varas	playsFor	Santiago_Wanderers
Dagoberto_Moll	playsFor	Elche_CF
Jack_Peart	playsFor	Derby_County_F.C.
Marco_Giampaolo	playsFor	S.C._Siracusa
Lars_Lunde	playsFor	FC_Bayern_Munich
Stephen_McPhail	playsFor	Millwall_F.C.
Wes_Daly	playsFor	Hendon_F.C.
Jan_Blažek	playsFor	AEL_1964_FC
Christian_Möckel	playsFor	TSG_1899_Hoffenheim
Michal_Hanek	playsFor	ŠK_Slovan_Bratislava
Thomas_Aquinas	influences	Dante_Alighieri
Edcarlos	playsFor	Clube_Atlético_Mineiro
Yuichiro_Nagai	playsFor	Urawa_Red_Diamonds
Denny_Landzaat	playsFor	Willem_II_(football_club)
Josimar_de_Carvalho_Ferreira	playsFor	Associação_Atlética_Portuguesa_(RJ)
Germán_Arangio	playsFor	América_de_Cali
Jaime_Vladimir_Cubías	playsFor	El_Salvador_national_football_team
Eduardo_Ramos_Martins	playsFor	Pierikos_F.C.
Albert_Borzenkov	playsFor	FC_Dynamo_Stavropol
Carlos_Llamosa	playsFor	United_States_men's_national_soccer_team
Nzelo_Hervé_Lembi	playsFor	K.S.C._Lokeren_Oost-Vlaanderen
Per_Nilsson_(footballer)	playsFor	Sweden_national_under-17_football_team
Tony_Philliskirk	playsFor	Burnley_F.C.
Davor_Vugrinec	wasBornIn	Varaždin
Dieter_Ramusch	playsFor	Grazer_AK
Balázs_Rabóczki	wasBornIn	Budapest
Fola_Onibuje	playsFor	Preston_North_End_F.C.
Bogdan_Stelea	playsFor	FC_Dinamo_București
Masahiro_Ohashi	wasBornIn	Yokohama
Luiz_Felipe_Rodrigues_Marques	playsFor	Nacional_Futebol_Clube
Arie_Haan	playsFor	Netherlands_national_football_team
Túlio_de_Melo	playsFor	Le_Mans_FC
Andy_Mutch	playsFor	Wigan_Athletic_F.C.
Nicolas_Ceolin	playsFor	União_Agrícola_Barbarense_Futebol_Clube
Marcus_Berg	playsFor	Sweden_national_football_team
Sergio_Volpi	playsFor	Carrarese_Calcio
Don_McAllister	playsFor	Tottenham_Hotspur_F.C.
Fabio_Cannavaro	playsFor	Italy_national_under-21_football_team
Matthew_Collins	playsFor	Carmarthen_Town_A.F.C.
Mamia_Jikia	playsFor	FC_Dinamo_Zugdidi
Tommy_McConville	playsFor	Shamrock_Rovers_F.C.
Lee_Peltier	playsFor	Leicester_City_F.C.
Edin_Ademović	wasBornIn	Belgrade
Tsvetomir_Tsankov	playsFor	FC_Lyubimets_2007
Guy_Stephane_Essame	playsFor	Sportivo_Luqueño
Danilo_Alvim	wasBornIn	Rio_de_Janeiro
Rezart_Maho	playsFor	KS_Dinamo_Tirana
Gastón_Sessa	playsFor	Club_Atlético_River_Plate
Didargylyç_Urazow	playsFor	Sanfrecce_Hiroshima
Glynn_Snodin	playsFor	Doncaster_Rovers_F.C.
Peter_Debye	hasWonPrize	Max_Planck_Medal
Peter_Ofori-Quaye	playsFor	Hapoel_Ironi_Kiryat_Shmona_F.C.
Kenneth_Storvik	playsFor	Helsingborgs_IF
Ben_Hannigan	playsFor	Shamrock_Rovers_F.C.
David_Staff	playsFor	Boston_United_F.C.
Arkadiusz_Radomski	playsFor	SC_Heerenveen
Ronnie_Hildersley	playsFor	Chester_City_F.C.
Vanja_Iveša	playsFor	HNK_Rijeka
Slavko_Kodrnja	playsFor	BSC_Young_Boys
Kevin_Betsy	playsFor	Southend_United_F.C.
Rodgers_Kola	playsFor	Hapoel_Bnei_Lod_F.C.
Carlos_Marcora	playsFor	Deportivo_Maldonado
Sergey_Dmitriyev	playsFor	FC_Dynamo_Saint_Petersburg
Dani_Chigou	playsFor	FCM_Câmpina
Andy_Welsh	playsFor	Scunthorpe_United_F.C.
Joca	playsFor	S.C._Espinho
Mustafa_Özkan	playsFor	Malatyaspor
Philipp_Lahm	playsFor	Germany_national_youth_football_team
Aristotle	influences	Hans-Georg_Gadamer
Filip_Krstić	playsFor	Valencia_CF
Georg_Cantor	wasBornIn	Saint_Petersburg
Cristian_Raimondi	playsFor	U.S._Arezzo
Darren_Ward_(footballer_born_1978)	playsFor	Millwall_F.C.
Patrik_Mráz	playsFor	Slovakia_national_under-21_football_team
Bobby_Smith_(footballer_born_1944)	playsFor	Brighton_&_Hove_Albion_F.C.
Takuya_Yamada	playsFor	Sagan_Tosu
Gustavo_Lazzaretti	playsFor	Sport_Club_do_Recife
José_Velásquez_(footballer)	playsFor	Peru_national_football_team
Martin_Abraham	playsFor	SV_Wehen_Wiesbaden
Kevin_Kilbane	playsFor	Everton_F.C.
Vijay_(actor)	wasBornIn	Chennai
Christian_Bouckenooghe	playsFor	New_Zealand_national_football_team
Park_Jae-hong_(footballer_born_1978)	playsFor	South_Korea_national_under-23_football_team
Aleksandr_Malygin	wasBornIn	Luhansk
Jack_Alderson	playsFor	Crystal_Palace_F.C.
Liam_Robinson	playsFor	Northwich_Victoria_F.C.
Darko_Karapetrovič	playsFor	NK_Domžale
Terry_Cochrane	playsFor	Billingham_Synthonia_F.C.
Jimmy_Kébé	playsFor	LB_Châteauroux
Adrian_Woźniczka	playsFor	Zawisza_Bydgoszcz
Martín_Perezlindo	playsFor	Chacarita_Juniors
Yago_Fernández	playsFor	S.L._Benfica
Jusuf_Dajić	playsFor	Videoton_FC
Frédéric_Daquin	playsFor	Hibernian_F.C.
Aleksandar_Stojanović	playsFor	Diagoras_F.C.
Bonaventure_Kalou	playsFor	RC_Lens
Anderson_Ricardo_dos_Santos	playsFor	Botafogo_Futebol_Clube_(SP)
Eduardo_Roberto_dos_Santos	playsFor	PFC_Belasitsa_Petrich
Líder_Mármol	playsFor	Chicago_Fire_Soccer_Club
Giulliano_Gonçalves_Guedes	playsFor	Clube_Atlético_Mineiro
Shane_Rufer	playsFor	FC_Zürich
Willian_Xavier_Barbosa	playsFor	Associação_Portuguesa_de_Desportos
Garðar_Gunnlaugsson	playsFor	IFK_Norrköping
Oséas	playsFor	Santos_FC
Carlos_Michel_Lopes_Vargas	playsFor	Esporte_Clube_Juventude
Val_Teixeira	playsFor	Portugal_national_football_team
Mohamed_Armoumen	playsFor	K.S.C._Lokeren_Oost-Vlaanderen
Ragıp_Başdağ	playsFor	Bucaspor
Steven_Masterton	playsFor	Crawley_Town_F.C.
Adílio	playsFor	Barcelona_Sporting_Club
Ivory_Coast	exports	wordnet_fish_102512053
Andy_Morrison	playsFor	Sheffield_United_F.C.
Leandro_Cufré	playsFor	GNK_Dinamo_Zagreb
Daniel_Onyekachi	playsFor	Hetman_Zamość
Sócrates	playsFor	Garforth_Town_A.F.C.
Adnan_Barakat	playsFor	Muangthong_United_F.C.
Steeven_Langil	playsFor	En_Avant_de_Guingamp
Wes_Wade	playsFor	Detroit_Rockers
Faas_Wilkes	playsFor	Inter_Milan
Joseph_Stiglitz	graduatedFrom	University_of_Chicago
Genc_Iseni	playsFor	FK_Bregalnica_Štip
José_Ignacio_Castillo	playsFor	Trapani_Calcio
Givi_Didava	playsFor	Maccabi_Tel_Aviv_F.C.
Georges_Sorel	influences	Antonio_Gramsci
Alecsandro	playsFor	Cruzeiro_Esporte_Clube
Andrea_Parola	playsFor	U.S._Poggibonsi
Carlos_Morete	playsFor	Sevilla_FC
Ali_Aliyev_(footballer)	playsFor	Kartal_S.K.
Joey_Worthen	playsFor	Richmond_Kickers
Nicolás_Diez	playsFor	Deportivo_Táchira
Björn_Runström	playsFor	Luton_Town_F.C.
Vítězslav_Tuma	playsFor	FC_Vítkovice
Gianluca_Vivan	playsFor	S.S.D._Tivoli_Calcio_1919
Murat_Akyüz	playsFor	Karşıyaka_S.K.
Jiloan_Hamad	wasBornIn	Baku
Chris_Pozniak	playsFor	Örebro_SK
Nir_Berkovic	playsFor	Hapoel_Rishon_LeZion_F.C.
Bill_Paterson_(footballer_born_1898)	playsFor	Providence_F.C.
John_Neilson_(footballer)	playsFor	Bradford_City_A.F.C.
Liga_Española_de_Baloncesto	isLocatedIn	Spain
Ivan_Čvorović	playsFor	FK_Teleoptik
Mathias_Svensson	playsFor	Sweden_national_football_team
Gaël_Kakuta	playsFor	France_national_under-17_football_team
Norman_Panama	wasBornIn	Chicago
Ronnie_Bull_(footballer)	playsFor	Crawley_Town_F.C.
Frank_Swift	playsFor	Charlton_Athletic_F.C.
Bobby_Weale	playsFor	Cheltenham_Town_F.C.
Simon_Johnson_(footballer)	playsFor	Barnsley_F.C.
Colin_Powell	hasWonPrize	Legion_of_Merit
Víctor_Bonilla	playsFor	Deportivo_Cali
Mario_Rosas	playsFor	Real_Murcia
Guy_Feutchine	playsFor	KS_Cracovia_(football)
Alan_Kernaghan	playsFor	Falkirk_F.C.
Sebastián_Ariel_Romero	playsFor	Racing_Club_de_Avellaneda
Siyabonga_Nomvethe	wasBornIn	Durban
Paul_Obiefule	playsFor	Nigeria_national_football_team
Christian_Karembeu	playsFor	Middlesbrough_F.C.
Mohamed_Sakho	playsFor	Horoya_AC
Héctor_Rodríguez_Peña	playsFor	Defensor_Sporting
Friedrich_Nietzsche	influences	Boris_Groys
Kevin_Keelan	wasBornIn	Kolkata
David_Zdrilic	playsFor	Aberdeen_F.C.
John_Gielgud	hasWonPrize	Emmy_Award
Felipe_de_Souza_Campos	playsFor	Al-Wehda_Club_(Mecca)
Willie_Burton	wasBornIn	Detroit
Daniel_Tchuř	playsFor	1._SC_Znojmo
John_Oster	playsFor	Barnsley_F.C.
Darl_Douglas	wasBornIn	Paramaribo
Johan_Cavalli	playsFor	US_Créteil-Lusitanos
Jérôme_Palatsi	playsFor	Montpellier_HSC
Nereo_Rocco	playsFor	S.S.C._Napoli
Magdy_Tolba	playsFor	Ismaily_SC
Neil_Murphy	wasBornIn	Liverpool
Souleymane_Keïta	playsFor	AC_Ajaccio
Paul_Henderson_(footballer)	playsFor	Sutherland_Sharks_FC
Giampietro_Perrulli	playsFor	Ascoli_Calcio_1898
Michael_Kokocinski	playsFor	TSV_1860_München
James_Turley	playsFor	Harrogate_Town_F.C.
Florin_Prunea	playsFor	FCM_Bacău
David_Button	playsFor	Shrewsbury_Town_F.C.
Tomasz_Sajdak	playsFor	Alki_Larnaca_F.C.
Syrmia	isLocatedIn	Croatia
Dave_Cameron_(footballer)	playsFor	Rhyl_F.C.
Fredi_Bobic	playsFor	TSF_Ditzingen
Lucas_Favalli	playsFor	Talleres_de_Córdoba
Dave_Rogers_(footballer)	playsFor	Derry_City_F.C.
Karl-Heinz_Spikofski	playsFor	CO_Roubaix-Tourcoing
Emanuele_Del_Vecchio	playsFor	S.S.C._Napoli
Predrag_Lazić	playsFor	FK_BSK_Borča
Roberto_Acuña	playsFor	Club_Nacional
Carlos_Marinelli	playsFor	Club_Deportivo_Universidad_de_San_Martín_de_Porres
Jozef_Majoroš	playsFor	Debreceni_VSC
Dumitru_Popovici	playsFor	FC_Tighina
Sébastien_Siani	playsFor	RWDM_Brussels_FC
Louis_Brain	playsFor	Brisbane_Strikers_FC
José_Júnior	playsFor	Córdoba_CF
Silvano_Raggio_Garibaldi	playsFor	A.S._Gubbio_1910
Thomas_Kläsener	playsFor	FC_Augsburg
Aleksandre_Iashvili	playsFor	Inter_Baku_PIK
Moussa_Sow	playsFor	France_national_under-21_football_team
David_Ferreira	playsFor	Al_Shabab_Al_Arabi_Club
Khalil_Azmi	playsFor	Colorado_Rapids
Danny_Maye	playsFor	Yate_Town_F.C.
Noel_Hunt	playsFor	Reading_F.C.
T._S._Eliot	influences	Mircea_Cărtărescu
Wladimir_Baýramow	playsFor	FC_Yenisey_Krasnoyarsk
Megan_Rapinoe	playsFor	Olympique_Lyonnais_(Ladies)
Mozart_Santos_Batista_Júnior	playsFor	Clube_de_Regatas_do_Flamengo
Scott_Guyett	playsFor	Oxford_United_F.C.
Massimo_Zappino	playsFor	A.S.G._Nocerina
César_Azpilicueta	playsFor	Olympique_de_Marseille
Augustus_III_of_Poland	wasBornIn	Dresden
Jim_McLaughlin_(footballer)	playsFor	Peterborough_United_F.C.
Sergio_Batista	playsFor	All_Boys
Jardel_Pereira_de_Souza	playsFor	C.S._Marítimo
Ryan_Crowther	playsFor	Altrincham_F.C.
Željko_Gavrilović	playsFor	Békéscsaba_1912_Előre_SE
Claudio_Núñez	playsFor	Santiago_Wanderers
David_Andersen	wasBornIn	Melbourne
Ondřej_Herzán	playsFor	AC_Sparta_Prague
Srebrenko_Posavec	playsFor	Hannover_96
Francis_Kioyo	playsFor	1._FC_Köln
Lee_Grant_(footballer,_born_1983)	playsFor	Burnley_F.C.
Bobby_Thomson_(footballer_born_1943)	playsFor	Luton_Town_F.C.
Graeme_Jones	playsFor	Bridlington_Town_A.F.C.
Chung_Kyung-ho	playsFor	South_Korea_national_under-23_football_team
Lee_Warren	playsFor	Goole_A.F.C.
Elbekay_Bouchiba	playsFor	Willem_II_(football_club)
Hank_Liotart	playsFor	Blauw-Wit_Amsterdam
Dieter_Schatzschneider	playsFor	Hamburger_SV
Nikolajs_Poļakovs	playsFor	FK_Rīga
Paul_Krugman	hasWonPrize	Nobel_Prize_in_Economics
Diego_Trotta	playsFor	UD_Las_Palmas
Moscow_Oblast	isLocatedIn	Central_Federal_District
Hector_Sam	playsFor	San_Juan_Jabloteh_F.C.
Maor_Buzaglo	playsFor	Maccabi_Tel_Aviv_F.C.
Bolo_(footballer)	playsFor	Basque_Country_national_football_team
Trevor_Benjamin	playsFor	West_Bromwich_Albion_F.C.
Colin_Todd	playsFor	Vancouver_Whitecaps_(1974–84)
Fakhreddine_Galbi	playsFor	Arab_Contractors_SC
Jonny_Steele	playsFor	Wolverhampton_Wanderers_F.C.
Diego_Cagna	playsFor	Club_Atlético_Independiente
Hans_Küppers	playsFor	FC_Wacker_Innsbruck
Matt_Bobo	playsFor	Richmond_Kickers
Alexis_Ubillús	playsFor	Club_Deportivo_Universidad_César_Vallejo
Theodor_W._Adorno	influences	Edward_Said
Paolo_Castellini	playsFor	U.C._Sampdoria
Milton_Rodríguez	playsFor	Millonarios_Fútbol_Club
Paul_Oyuga	playsFor	Kenya_national_football_team
Illés_Zsolt_Sitku	playsFor	Videoton_FC
Evaristo_de_Macedo	playsFor	Brazil_national_football_team
Frederico_Burgel_Xavier	playsFor	Associação_Desportiva_São_Caetano
Gert_Claessens	playsFor	Club_Brugge_KV
Boško_Balaban	playsFor	HNK_Rijeka
Rodrigo_Ezequiel_Díaz	playsFor	Club_Atlético_Colón
Grégory_Sertic	playsFor	France_national_under-21_football_team
Júlio_César_Rocha_Costa	playsFor	Associação_Atlética_Portuguesa_(Santos)
Kévin_Bru	playsFor	Clairefontaine
Keigan_Parker	playsFor	Stockport_County_F.C.
Mark_Stewart_(footballer)	playsFor	Derry_City_F.C.
Danijel_Štefulj	playsFor	GNK_Dinamo_Zagreb
Arturo_Sanhueza	playsFor	Club_Deportivo_Arturo_Fernández_Vial
Akeem_Omolade	playsFor	Gela_Calcio
Rafael_Jacques	wasBornIn	Porto_Alegre
Luis_Saritama	playsFor	Alianza_Lima
Simon_Travis	playsFor	Forest_Green_Rovers_F.C.
Paul_Schrader	wasBornIn	Grand_Rapids,_Michigan
Peter_Kavanagh_(Irish_footballer)	wasBornIn	Dublin
Peter_Lorimer	playsFor	Leeds_United_A.F.C.
Allyson_Araújo_Santos	wasBornIn	Aracaju
Douglas_Hofstadter	hasWonPrize	National_Book_Award
António_Pedro_de_Brito_Lopes	wasBornIn	Setúbal
Terry_Cooper_(footballer_born_1944)	playsFor	Leeds_United_A.F.C.
Adílson_Batista	playsFor	Sport_Club_Internacional
Chigozie_Udoji	playsFor	Atromitos_F.C.
Andrew_Mumford	wasBornIn	Neath
Robert_Vágner	playsFor	FC_Energie_Cottbus
David_Bridges	playsFor	Cambridge_United_F.C.
Cenk_İşler	playsFor	Kasımpaşa_Spor_Kulübü
Leandro_Melino_Gomes	playsFor	Baku_FC
Kevin_Dillon_(footballer)	playsFor	Fareham_Town_F.C.
Raymond_Kaelbel	playsFor	RC_Strasbourg
Mark_Hughes_(Northern_Ireland_footballer)	playsFor	Northampton_Town_F.C.
Glenn_Whelan	playsFor	Bury_F.C.
Alfred_Osmani	playsFor	KS_Dinamo_Tirana
René_Schneider_(footballer)	playsFor	1._FC_Magdeburg
Tony_Whelan	playsFor	Rochdale_A.F.C.
Igor_Budan	playsFor	Croatia_national_under-20_football_team
Issa_Ba	playsFor	FC_Dinamo_București
Julio_Aguilar	playsFor	Tigres_UANL
Jean_Paulista	playsFor	Polonia_Bytom
Giovanni_Orfei	playsFor	Hellas_Verona_F.C.
Roy_Carroll	playsFor	Northern_Ireland_national_under-21_football_team
Jimmy_Bone	playsFor	Hong_Kong_Rangers_FC
Wilhelm_Reisinger	playsFor	Stuttgarter_Kickers
Rikki_Bains	playsFor	Sutton_Coldfield_Town_F.C.
António_Carlos_dos_Santos	playsFor	FC_Schaffhausen
Darko_Dražić	playsFor	Croatia_national_football_team
Danijel_Štefulj	wasBornIn	Čakovec
Borja_Fernández	playsFor	Spain_national_under-17_football_team
Fabiano_Ribeiro_de_Freitas	playsFor	Toledo_Colônia_Work
Oleksiy_Antonov	playsFor	Ukraine_national_under-21_football_team
Hamed_Namouchi	playsFor	Grenoble_Foot_38
Zurab_Ionanidze	playsFor	FC_Zhemchuzhina-Sochi
Billy_Taylor_(sportsman)	playsFor	Sheffield_Wednesday_F.C.
Edmílson_Matias	playsFor	Esporte_Clube_Juventude
Colin_Powell	graduatedFrom	George_Washington_University
Enrico_Chiesa	wasBornIn	Genoa
Matthias_Lust	playsFor	SpVgg_Ludwigsburg
Jan_Rajnoch	playsFor	FC_Slovan_Liberec
Yoann_Folly	playsFor	Aberdeen_F.C.
Selmir_dos_Santos_Bezerra	playsFor	Joinville_Esporte_Clube
Riccardo_Colombo	playsFor	Udinese_Calcio
Lai_Yiu_Cheong	wasBornIn	Hong_Kong
Bruno_Silva	playsFor	Uruguay_national_football_team
Fernando_Horácio_Ávalos	playsFor	FC_Basel
Adam_Ndlovu	playsFor	FC_Zürich
Anselmo_Eyegue	playsFor	UDA_Gramenet
Milan_Baroš	playsFor	Liverpool_F.C.
Frank_Upton	playsFor	Notts_County_F.C.
Erik_Sundin	playsFor	AIK_Fotboll
Steed_Malbranque	playsFor	AS_Saint-Étienne
Alo_Bärengrub	playsFor	Nõmme_Kalju_FC
Gilberto_Ribeiro_Gonçalves	playsFor	Gimnàstic_de_Tarragona
Paul_Lambert	playsFor	Borussia_Dortmund
Anatoli_Todorov	playsFor	PFC_Vidima-Rakovski_Sevlievo
Raymond_Kaelbel	playsFor	France_national_football_team
Jonhes_Elias_Pinto_Dos_Santos	playsFor	Fortaleza_Esporte_Clube
Marcelo_Labarthe	playsFor	Platanias_F.C.
Ivan_Kozoriz	wasBornIn	Kiev
Peterson_Peçanha	playsFor	America_Football_Club_(RJ)
Jorge_Dely_Valdés	playsFor	Panama_national_football_team
Pavel_Ryzhevski	playsFor	FC_Tobol
Oladapo_Olufemi	playsFor	Bayelsa_United_F.C.
Sam_Morrow	playsFor	Linfield_F.C.
Ben_Hannigan	playsFor	SC_Fortuna_Köln
Enrique_Romero	playsFor	Deportivo_de_La_Coruña
Joaquín_Larrivey	playsFor	Rayo_Vallecano
Kyle_Nix	playsFor	Buxton_F.C.
Pat_Scully	playsFor	Arsenal_F.C.
Dylan_Kerr	playsFor	Hamilton_Academical_F.C.
Iulian_Apostol	playsFor	Romania_national_football_team
Damien_Tixier	playsFor	U.D._Leiria
Thomas_Buffel	playsFor	S.B.V._Excelsior
Alan_Jay_Lerner	wasBornIn	New_York_City
Andy_Gray_(footballer,_born_1955)	playsFor	Everton_F.C.
Kevin_Watson	playsFor	Barnet_F.C.
David_Nicholls_(footballer)	playsFor	Coleraine_F.C.
Anne_Bancroft	hasWonPrize	Tony_Award
Swabia_(region)	isLocatedIn	Bavaria
Mark_Liveric	playsFor	Washington_Diplomats
Axel_Keller	playsFor	FC_Carl_Zeiss_Jena
Igor_Prins	playsFor	FC_Flora_Tallinn
Richard_Thompson_(footballer)	playsFor	Tiverton_Town_F.C.
Steven_Weinberg	worksAt	Massachusetts_Institute_of_Technology
Felipe_Caicedo	playsFor	FC_Lokomotiv_Moscow
Mark_Howard_(footballer,_born_September_1986)	playsFor	Arsenal_F.C.
Thomas_Myhre	playsFor	Everton_F.C.
Habib_Habibou	playsFor	K.A.A._Gent
Adrián_Martín_Cardona	playsFor	Real_Murcia
Felix_Gasselich	playsFor	FK_Austria_Wien
Jean-Michel_Tchouga	playsFor	FC_Luzern
Delroy_Facey	playsFor	Bolton_Wanderers_F.C.
Harold_Pinter	wasBornIn	London
Georges_Ambourouet	wasBornIn	Libreville
Osmar_Ferreyra	playsFor	Argentina_national_under-23_football_team
Fraser_Forster	playsFor	Newcastle_United_F.C.
Andrei_Streltsov	playsFor	FC_Spartak_Moscow
Synan_Braddish	playsFor	Dundalk_F.C.
Neil_Kilkenny	playsFor	England_national_under-20_football_team
Duvier_Riascos	playsFor	Monarcas_Morelia
Emily_Watson	actedIn	Cradle_Will_Rock
Patrik_Andersson	playsFor	Malmö_FF
Matthew_Bates	playsFor	England_national_under-19_football_team
Paul_Arnison	wasBornIn	Hartlepool
Ciarán_Hinds	actedIn	The_Tale_of_Despereaux_(film)
Emil_Noll	playsFor	FSV_Frankfurt
Barak_Yitzhaki	playsFor	K.R.C._Genk
Rade_Veljović	playsFor	FK_Jedinstvo_Ub
Sami_Allagui	playsFor	R.S.C._Anderlecht
Billy_Crystal	hasWonPrize	GLAAD_Media_Award
Stuart_Young	playsFor	South_Coast_Wolves_FC
Onyekachi_Okonkwo	wasBornIn	Aba,_Abia
Hasan_Ali_Kaldırım	playsFor	Turkey_national_under-21_football_team
Rui_Marques	playsFor	SSV_Ulm_1846
Leonardo_Rodríguez	playsFor	Club_Atlético_Lanús
Giorgio_Agamben	isInterestedIn	Political_philosophy
Owen_Madden_(footballer)	playsFor	Ireland_national_football_team_(1882–1950)
Joe_Jakub	playsFor	Colwyn_Bay_F.C.
William_H._Macy	wasBornIn	Miami
Joe_Norton	playsFor	Manchester_United_F.C.
Andy_Thorn_(footballer)	playsFor	Crystal_Palace_F.C.
Edgar_Loué	playsFor	Africa_Sports_d'Abidjan
Aleš_Urbánek	playsFor	AC_Sparta_Prague
Anderson_Roberto_da_Silva_Luiz	playsFor	Moreirense_F.C.
Jean-Philippe_Caillet	playsFor	Tianjin_Teda_F.C.
Salim_Arrache	playsFor	Asteras_Tripoli_F.C.
George_Mourad	playsFor	Willem_II_(football_club)
Liam_Coyle	wasBornIn	Derry
José_Manuel_Jiménez_Ortiz	playsFor	Ciudad_de_Murcia
Jacinto_Espinoza	playsFor	Club_Sport_Emelec
Issa_Ba	playsFor	Stade_Lavallois
Margrethe_II_of_Denmark	wasBornIn	Copenhagen
Eyal_Berkovic	playsFor	Maccabi_Tel_Aviv_F.C.
Dani_Osvaldo	playsFor	Club_Atlético_Banfield
Artem_Savin	wasBornIn	Luhansk
Massimo_Gotti	playsFor	Ascoli_Calcio_1898
Juan_Carlos_Mandiá	playsFor	Celta_de_Vigo
Lee_Williamson	playsFor	Northampton_Town_F.C.
Marco_Zamboni	playsFor	Juventus_F.C.
John_Kerr,_Sr.	wasBornIn	Glasgow
Owen_Madden_(footballer)	playsFor	Cork_United_F.C.
Jamie_Mackie	playsFor	Plymouth_Argyle_F.C.
Eben_Dugbatey	playsFor	Ghana_national_football_team
Gabriel_Obertan	playsFor	FC_Lorient
Bojan_Zajić	playsFor	FK_Obilić
Antti_Pohja	wasBornIn	Lahti
Austro-Prussian_War	isLocatedIn	Bohemia
Daniel_Nardiello	playsFor	Barnsley_F.C.
Ivan_Fatić	playsFor	FC_Chiasso
Billy_Whitehurst	playsFor	Mossley_A.F.C.
Malaury_Martin	wasBornIn	Nice
Stephen_Hughes_(footballer,_born_1976)	playsFor	Everton_F.C.
Krzysztof_Pawlak	playsFor	Lech_Poznań
Moravian-Silesian_Region	isLocatedIn	Moravia
Pan_Pierre_Koulibaly	playsFor	R.R.F.C._Montegnée
Jason_Vandelannoite	playsFor	Qormi_F.C.
José_Clebson_Augustinho	playsFor	Shenzhen_Ruby_F.C.
Howell_M._Estes_II	hasWonPrize	World_War_II_Victory_Medal_(United_States)
Kenny_Allen_(footballer)	playsFor	Bath_City_F.C.
André_Astorga	playsFor	Hannover_96
Hokuriku_region	isLocatedIn	Asia
Pablo_Forlán	playsFor	Defensor_Sporting
Schwenck	playsFor	Clube_Atlético_Juventus
Kerala	isLocatedIn	India
Mark_Taylor_(footballer_born_1966)	playsFor	Halesowen_Town_F.C.
Jean_Black_Ngody	playsFor	Okęcie_Warszawa
John_Burridge	playsFor	Queen_of_the_South_F.C.
Rodrigo_Prieto_(footballer)	playsFor	C.F._Mérida
Baltemar_Brito	playsFor	Sport_Club_do_Recife
Filipe_Teixeira	playsFor	Barnsley_F.C.
Lewis_Cook	playsFor	Lewes_F.C.
Dušan_Petković_(footballer_born_1974)	playsFor	Serbia_national_football_team
Roberto_Trashorras	playsFor	UD_Las_Palmas
Prince_Polley	playsFor	S.B.V._Excelsior
José_Luis_Villanueva	playsFor	Deportes_Antofagasta
Tore_Andreas_Gundersen	playsFor	HamKam
Abdullah_Quaye	playsFor	Zamalek_SC
Nenê_(footballer_born_1981)	playsFor	Celta_de_Vigo
Grigol_Chanturia	playsFor	FC_Hoverla_Uzhhorod
Élie_Metchnikoff	hasWonPrize	Nobel_Prize_in_Physiology_or_Medicine
Mohamed_Larbi_Arouri	playsFor	PFC_Oleksandriya
David_Loria	playsFor	PFC_Spartak_Nalchik
Miguel_Ángel_Carrilero	playsFor	Sporting_de_Gijón
Alexander_Vladimirovich_Panov	playsFor	FC_Dynamo_Moscow
Dawda_Bah	playsFor	Gambia_national_football_team
Brian_Dunseth	playsFor	FC_Dallas
Émile_Durkheim	influences	Talcott_Parsons
Igor_Grkajac	playsFor	FK_Mladost_Lučani
Wes_Thomas	playsFor	Portsmouth_F.C.
Andrius_Jokšas	playsFor	FK_Ekranas
Walther_Nernst	worksAt	Humboldt_University_of_Berlin
Marquis_de_Sade	playsFor	FC_Metalurgi_Rustavi
Ben_Hannigan	playsFor	Shelbourne_F.C.
Kevin_Nicholson_(footballer)	playsFor	Torquay_United_F.C.
Joe_Anyon	playsFor	Macclesfield_Town_F.C.
Andrew_Wiles	hasWonPrize	Shaw_Prize
Racing_Métro_92	isLocatedIn	Colombes
Zesh_Rehman	playsFor	Muangthong_United_F.C.
Mark_Noble	playsFor	Hull_City_A.F.C.
Abiodun_Baruwa	playsFor	Barry_Town_United_F.C.
Astrit_Ajdarević	playsFor	Leicester_City_F.C.
Steve_Bruce	playsFor	Norwich_City_F.C.
Edson_Luis_da_Silva	playsFor	Sport_Club_Corinthians_Paulista
Paolo_Hernán_Dellafiore	playsFor	A.C._Cesena
Mauricio_Pinilla	playsFor	Chile_national_football_team
John_Fraser_(footballer_born_1876)	playsFor	St._Mirren_F.C.
Đorđe_Rakić	playsFor	OFK_Beograd
Solomon_Okoronkwo	wasBornIn	Enugu
Howie_King	playsFor	Shamrock_Rovers_F.C.
George_Lawrence_(footballer)	playsFor	Millwall_F.C.
Oskar_Drobne	playsFor	NK_Celje
Salih_Sadir	playsFor	Najaf_FC
Asa_Charlton	playsFor	Leamington_F.C.
Iban_Zubiaurre	playsFor	Racing_de_Santander
Stephen_Quinn	wasBornIn	Dublin
Henok_Goitom	wasBornIn	Solna_Municipality
Harold_Hardman	playsFor	Bradford_City_A.F.C.
Richie_Ryan_(footballer)	playsFor	Dundee_United_F.C.
Ernie_Islip	playsFor	Kidderminster_Harriers_F.C.
Levir_Culpi	playsFor	Figueirense_Futebol_Clube
Paul_Oyuga	wasBornIn	Nairobi
Veselin_Đoković	playsFor	AS_Marsa
Najeh_Braham	playsFor	FC_Rot-Weiß_Erfurt
Zineddine_Mekkaoui	playsFor	Algeria_national_under-23_football_team
Sébastien_Hamel	playsFor	Olympique_de_Marseille
Anthony_Lozano	playsFor	Club_Deportivo_Olimpia
Eliézio_Santos_Santana	playsFor	Portimonense_S.C.
Tcham_N'Toya	playsFor	York_City_F.C.
Juliano_Laurentino_dos_Santos	wasBornIn	João_Pessoa
Andy_Roddie	playsFor	Yee_Hope_FC
Tony_Elliott_(footballer)	playsFor	Huddersfield_Town_F.C.
Jean-Jacques_Rousseau	influences	Ion_Dragoumis
Daniel_Heidman	playsFor	Maccabi_Tel_Aviv_F.C.
Lúcio_Carlos_Cajueiro_Souza	playsFor	Sociedade_Esportiva_do_Gama
Owain_Fôn_Williams	playsFor	Crewe_Alexandra_F.C.
Daniel_Marín	playsFor	UDA_Gramenet
André_Neles	playsFor	América_Futebol_Clube_(RN)
The_Mahabharata_(1989_film)	isLocatedIn	Iceland
Boston_Celtics	isLocatedIn	Boston
Patricio_Camps	playsFor	Argentina_national_football_team
Lloyd_Dyer	wasBornIn	Birmingham
Manfred_Bender	playsFor	Karlsruher_SC
Julio_dos_Santos	playsFor	VfL_Wolfsburg
Rene_Howe	playsFor	Peterborough_United_F.C.
Seïd_Khiter	wasBornIn	Roubaix
Paul_Linz	playsFor	VfL_Osnabrück
Sotiris_Leontiou	playsFor	Ilioupoli_F.C.
Ashlyn_Harris	playsFor	Washington_Spirit
Harold_Gough	playsFor	Bolton_Wanderers_F.C.
Haskell_Curry	graduatedFrom	Harvard_University
Nicky_Law_(footballer,_born_1961)	playsFor	Hereford_United_F.C.
Ramiz_Mamedov	playsFor	FC_Lokomotiv_Moscow
Lee_Makel	playsFor	Huddersfield_Town_F.C.
Jackson_Mendy	playsFor	Grenoble_Foot_38
Paul_Barnes_(footballer)	playsFor	Bury_F.C.
Carlos_María_Morales	playsFor	Uruguay_national_football_team
Pat_Noonan	playsFor	Colorado_Rapids
Paulo_Marcel_Pereira_Merabet	playsFor	Salgueiro_Atlético_Clube
Đorđije_Ćetković	playsFor	Buriram_United_F.C.
Marko_Muslin	playsFor	FK_Hajduk_Beograd
Sebastián_Cejas	playsFor	Ascoli_Calcio_1898
Terry_Gibson	playsFor	Coventry_City_F.C.
Dejan_Radosavljević	playsFor	FK_Sevojno
Andy_Milner	playsFor	Chester_City_F.C.
Peter_Zelem	playsFor	Wolverhampton_Wanderers_F.C.
Marcell_Takács	playsFor	Hungary_national_under-19_football_team
Sergio_Batista	playsFor	Club_Atlético_River_Plate
Ismael_Blanco	playsFor	AEK_Athens_F.C.
Beg_Ferati	playsFor	Switzerland_national_football_team
Matt_Okoh	playsFor	SSV_Reutlingen_05
Ben_Muirhead	wasBornIn	Doncaster
Franklin_Clovis_Anzité	playsFor	Weymouth_F.C.
Jason_van_Blerk	playsFor	Millwall_F.C.
Hennadiy_Lytovchenko	playsFor	Club_Universidad_de_Chile
Francisco_Alex	playsFor	Esporte_Clube_São_José
Yordan_Varbanov	playsFor	PFC_Chernomorets_Burgas_Sofia
Edmundo_Rodriguez	playsFor	Estudiantes_Tecos
Cosmin_Contra	playsFor	West_Bromwich_Albion_F.C.
Emile_M'Bouh	playsFor	Kuala_Lumpur_FA
Anton_Doboș	playsFor	FC_Steaua_București
Simone_Bonomi	playsFor	A.C._Chievo_Verona
Nils-Eric_Johansson	playsFor	Sweden_national_under-16_football_team
Allan_Moore	playsFor	Livingston_F.C.
Thiago_Martins	playsFor	D.C._United
Mitchell_Langerak	playsFor	Borussia_Dortmund_II
Burt_Young	actedIn	The_Adventures_of_Pluto_Nash
Kevin_McKinlay	playsFor	Greenock_Morton_F.C.
Miguel_Ángel_Tena	playsFor	Córdoba_CF
Tunay_Torun	playsFor	VfB_Stuttgart
Danny_Pena	playsFor	Wichita_Wings
Daniele_Ficagna	playsFor	S.S._Virtus_Lanciano_1924
Alex_Mathie	playsFor	Dundee_United_F.C.
Lil_Fuccillo	playsFor	Wivenhoe_Town_F.C.
Ahmad_Elrich	playsFor	Australia_national_under-23_association_football_team
Alexander_Kutschera	playsFor	FC_Bayern_Munich_II
Robert_Michael_White	hasWonPrize	Legion_of_Merit
Dino_Delevski	playsFor	Milwaukee_Wave
Marios_Christodoulou	playsFor	APEP_F.C.
Grzegorz_Rasiak	playsFor	Southampton_F.C.
Tony_Currie_(footballer)	playsFor	Queens_Park_Rangers_F.C.
Andreas_Dahl	playsFor	Landskrona_BoIS
Steve_Olfers	playsFor	Feyenoord
Jari_Europaeus	playsFor	Helsingin_Jalkapalloklubi
Ingo_Hertzsch	playsFor	1._FC_Kaiserslautern
Kim_Røntved	wasBornIn	Copenhagen
Rob_Edwards_(footballer_born_1982)	playsFor	Wales_national_football_team
Santamaria_(footballer)	playsFor	C.F._Estrela_da_Amadora
Keith_Lowe_(footballer)	playsFor	Brighton_&_Hove_Albion_F.C.
Harison_da_Silva_Nery	playsFor	Grêmio_Barueri_Futebol
Eamonn_Gregg	playsFor	League_of_Ireland_XI
Bojan_Brnović	playsFor	FK_Obilić
Felipe_Félix	playsFor	Baku_FC
Abdullah_Fusseini	playsFor	Torino_F.C.
Sandro_Manoel_dos_Santos	playsFor	Cruzeiro_Esporte_Clube
Alan_Wright	playsFor	Cardiff_City_F.C.
Alberta	isLocatedIn	Canada
Alex_Sandro_da_Silva	playsFor	Boa_Esporte_Clube
Samuel_Baños	playsFor	Xerez_CD
Henry_David_Thoreau	influences	Janet_Frame
Farès_Bousdira	playsFor	OGC_Nice
Ángel_Bernuncio	playsFor	Juventud_Antoniana
Nikola_Grubješić	playsFor	FC_KAMAZ_Naberezhnye_Chelny
Freetown	isLocatedIn	Africa
Miklós_Horthy	hasWonPrize	Order_of_the_Three_Stars
Mstislav_Rostropovich	wasBornIn	Baku
Rainer_Bieli	playsFor	FC_Baden
Ross_Wallace	playsFor	Celtic_F.C.
Steve_Talboys	playsFor	Kingstonian_F.C.
Abdoulaye_Camara	playsFor	FC_Koper
Anthony_Modeste_(footballer_born_1988)	wasBornIn	Cannes
René_Ponk	playsFor	FC_Utrecht
Keith_Sanderson_(footballer)	playsFor	Plymouth_Argyle_F.C.
Edgar_Aguilera	playsFor	Club_Cerro_Corá
Roy_John	playsFor	Sheffield_United_F.C.
Bojan_Isailović	wasBornIn	Belgrade
Linus_Hallenius	playsFor	Calcio_Padova
Mugur_Bolohan	playsFor	Nea_Salamis_Famagusta_FC
Herbert_Gager	wasBornIn	Vienna
Radomir_Đalović	playsFor	Red_Star_Belgrade
Aivar_Anniste	playsFor	FC_Flora_Tallinn
Kyle_Moran	playsFor	Institute_F.C.
Revaz_Arveladze	playsFor	Georgia_national_football_team
Dirceu	playsFor	Atlético_Madrid
Johnnier_Montaño	playsFor	Independiente_Santa_Fe
Marlon_King	playsFor	Jamaica_national_football_team
Aliaksei_Kuchuk	playsFor	FK_Ventspils
Aitor_Karanka	playsFor	Spain_national_football_team
Steve_Thompson_(footballer,_born_1963)	playsFor	Bristol_City_F.C.
Lionard_Pajoy	playsFor	Millonarios_Fútbol_Club
Jock_Wallace,_Jr.	playsFor	Bedford_Town_F.C.
Eyal_Berkovic	playsFor	Manchester_City_F.C.
Stéphane_Mbia	playsFor	Stade_Rennais_F.C.
Willem-Alexander_of_the_Netherlands	playsFor	FC_Samtredia
Bruno_Agnello	wasBornIn	Santos,_São_Paulo
Martin_Jiránek	wasBornIn	Prague
Brian_Howard_(footballer)	playsFor	Millwall_F.C.
Brent_Goulet	playsFor	Bonner_SC
Ricky_Hill	playsFor	Le_Havre_AC
Herfried_Sabitzer	playsFor	Austria_national_football_team
Łukasz_Szukała	playsFor	TSV_1860_München_II
Pedro_Alves_da_Silva	playsFor	Sporting_Clube_de_Portugal
Mark_DeBolla	playsFor	Aston_Villa_F.C.
Marco_Gómez	playsFor	Club_Necaxa
Román_Torres	playsFor	Millonarios_Fútbol_Club
Rubén_Blades	hasWonPrize	Grammy_Award
Vyacheslav_Sukristov	playsFor	Soviet_Union_national_football_team
José_Andrés_Bilibio	playsFor	Manta_Fútbol_Club
Jena	isLocatedIn	Germany
Chris_Doig	playsFor	Queen_of_the_South_F.C.
Roy_Hunter	playsFor	Harrogate_Town_F.C.
Richie_Foran	playsFor	Motherwell_F.C.
Karel_Poborský	playsFor	Manchester_United_F.C.
Sallieu_Bundu	playsFor	Ravan_Baku_FK
Takuya_Yamada	wasBornIn	Tokyo
Baffour_Gyan	playsFor	Al-Nasr_SC_(Benghazi)
Cluj-Napoca	isLocatedIn	Transylvania
Fumagalli	playsFor	Al_Rayyan_SC
Leandro_Alvarez	playsFor	Olympiacos_Volou_1937_F.C.
Nathan_Paulse	playsFor	Hammarby_IF
Samuel_Di_Carmine	playsFor	A.S.D._Gallipoli_Football_1909
Franco_Miranda	playsFor	Racing_Club_de_Avellaneda
Zach_Thornton	playsFor	New_York_Red_Bulls
Danijel_Subotić	playsFor	FC_Volyn_Lutsk
Samy_Houri	playsFor	K.V._Oostende
John_Turturro	hasWonPrize	David_di_Donatello
Louis_Page	playsFor	Yeovil_Town_F.C.
Matt_Carmichael_(footballer)	playsFor	Stamford_A.F.C.
Hermann_von_Helmholtz	influences	Ludwig_Wittgenstein
Iulian_Filipescu	playsFor	Real_Betis
John_Spicer_(footballer)	playsFor	Doncaster_Rovers_F.C.
Grégory_Vignal	playsFor	Southampton_F.C.
Alexander_Klitzpera	playsFor	FSV_Frankfurt
Marcelinho_Paraíba	playsFor	Grêmio_Foot-Ball_Porto_Alegrense
Pavel_Fořt	playsFor	SK_Slavia_Prague
Fangio_Buyse	playsFor	AEP_Paphos_F.C.
Nikolay_Petrov_(footballer)	playsFor	FC_Etar_1924_Veliko_Tarnovo
Kenny_Miller	playsFor	Wolverhampton_Wanderers_F.C.
Tommy_Mooney	playsFor	Oxford_United_F.C.
Jean_Paulista	playsFor	S.C._Farense
Dave_Hickson	playsFor	Bury_F.C.
Răzvan_Cociș	playsFor	FC_Karpaty_Lviv
Jordão_(footballer_born_1971)	playsFor	Leça_F.C.
Francesco_Moriero	playsFor	Inter_Milan
Edu_Marangon	wasBornIn	São_Paulo
Peter_Pace	hasWonPrize	Distinguished_Service_Medal
Cícero_Semedo	playsFor	Moreirense_F.C.
Nicklas_Bendtner	wasBornIn	Copenhagen
David_Bermudo	playsFor	CF_Badalona
Papua_New_Guinea	exports	wordnet_coffee_bean_107929351
Charlie_MacDonald	playsFor	Colchester_United_F.C.
Ashley_Nicholls	playsFor	Grays_Athletic_F.C.
Vladimirs_Babičevs	playsFor	FK_Liepājas_Metalurgs
Matt_Knowles_(soccer)	playsFor	Cleveland_Crunch
Jean-François_Rivière	playsFor	Clermont_Foot
Adam_Petrouš	playsFor	Bohemians_1905
Terry_Fleming	playsFor	Coventry_City_F.C.
Ross_Nicholson	playsFor	Sembawang_Rangers_FC
Danny_Westwood	playsFor	Queens_Park_Rangers_F.C.
Romain_Rocchi	playsFor	SC_Bastia
Anselmo_(footballer_born_1980)	playsFor	Al-Sailiya_SC
David_Button	playsFor	Grays_Athletic_F.C.
Márcio_Luiz_Adurens	playsFor	Sociedade_Esportiva_do_Gama
Jari_Vanhala	playsFor	Helsingin_Jalkapalloklubi
Rashad_Abdullayev	playsFor	Baku_FC
Don_O'Riordan	playsFor	Gloucester_City_A.F.C.
Thomas_Reis	playsFor	VfL_Bochum
Derek_Mountfield	playsFor	Everton_F.C.
Marco_Biagianti	playsFor	ACF_Fiorentina
Disney_Channel_(Latin_America)	isLocatedIn	Mexico_City
Thomas_Richter_(footballer_born_1980)	playsFor	Sportfreunde_Siegen
Daniel_McBreen	playsFor	Shanghai_Dongya_F.C.
Dharmendra	hasWonPrize	Filmfare_Awards
Stéphane_Biakolo	playsFor	Chamois_Niortais_F.C.
Rod_Wallace	playsFor	Rangers_F.C.
Clark_Gable	hasWonPrize	Academy_Award_for_Best_Actor
Javier_Zeoli	wasBornIn	Montevideo
Erison_da_Silva_Santos	playsFor	FC_Bihor_Oradea
Dubravko_Tešević	playsFor	Livingston_F.C.
Abdelmalek_Cherrad	playsFor	K.A.A._Gent
Johnnier_Montaño	playsFor	S.S.D._Piacenza_Calcio_1919
Henry_Eyring	hasWonPrize	Wolf_Prize_in_Chemistry
Talal_Khalfan	playsFor	Al-Oruba_SC
Toni_Golem	playsFor	NK_Mosor
David_Ridler	playsFor	Shrewsbury_Town_F.C.
Ivan_Tsachev	wasBornIn	Varna
Antoni_Łukasiewicz	playsFor	ŁKS_Łódź
Isaac_Boakye	playsFor	1._FSV_Mainz_05
Elbe	isLocatedIn	Czech_Republic
Paul_Dobson_(footballer)	playsFor	Scarborough_F.C.
Ilia_Kandelaki	playsFor	Inter_Baku_PIK
Luciano_Ratinho	playsFor	S.C._Beira-Mar
Antonio_Tomás	playsFor	Racing_de_Santander_B
Peter_Barnes_(footballer)	playsFor	Drogheda_United_F.C.
Massimiliano_Giacobbo	playsFor	A.S.D._Virtus_Casarano
Sebastián_Vázquez	playsFor	Peñarol
Gary_Megson	playsFor	Plymouth_Argyle_F.C.
Jajá_(Brazilian_footballer)	playsFor	Vila_Nova_Futebol_Clube
Ismael_Urzaiz	playsFor	Celta_de_Vigo
Fábio_do_Nascimento_Silva	playsFor	Clube_Atlético_do_Porto
Norbert_Sipos	playsFor	Lombard-Pápa_TFC
Jaime_Sánchez_Fernández	playsFor	Real_Madrid_Castilla
Mauricio_Ferradas	playsFor	Club_Atlético_Platense
Richard_Hastings	playsFor	Inverness_Caledonian_Thistle_F.C.
Neil_Heaney	playsFor	Arsenal_F.C.
Michael_Bradley_(soccer)	playsFor	New_York_Red_Bulls
Richard_Knopper	playsFor	SC_Heerenveen
Stefano_Borgonovo	playsFor	U.S._Sambenedettese_1923
Oleh_Krasnopyorov	playsFor	FC_Metalist_Kharkiv
Alexandre_Kojève	influences	Michel_Foucault
Robert_Taylor_(footballer)	playsFor	Gorleston_F.C.
Ray_Hankin	playsFor	Wolverhampton_Wanderers_F.C.
Aaron_Pitchkolan	playsFor	San_Jose_Earthquakes
Savvas_Poursaitidis	playsFor	Anorthosis_Famagusta_FC
Thomas_Murray_(soccer)	playsFor	Newark_Skeeters
Kerry_Dixon	playsFor	Luton_Town_F.C.
José_Carlos_Santos_da_Silva	playsFor	Club_Bolívar
Manfred_Burgsmüller	playsFor	Germany_national_football_B_team
Jimmy_Harrower_(footballer,_born_1935)	playsFor	Albion_Rovers_F.C.
Evaristo_de_Macedo	wasBornIn	Rio_de_Janeiro
Englewood,_New_Jersey	isLocatedIn	New_Jersey
Abdessalam_Benjelloun	playsFor	FAR_Rabat
Ismael_Santiago_López	playsFor	Hércules_CF
Giovanni_Morabito	playsFor	Vicenza_Calcio
Derek_Allan	wasBornIn	Irvine,_North_Ayrshire
Ciro_Polito	playsFor	Delfino_Pescara_1936
Attilio_Tesser	playsFor	A.C.D._Treviso_2013
Richard_Pryor	influences	Jon_Stewart
Moudourou_Moise	playsFor	Chainat_Hornbill_F.C.
Mamadou_Samassa_(footballer_born_1986)	playsFor	A.C._Chievo_Verona
Erwin_Koen	playsFor	Rot-Weiss_Essen
Dan_Petersen	playsFor	Denmark_national_under-21_football_team
Francisco_Javier_Peral	playsFor	Orduspor
Keith_Devlin	worksAt	University_of_Toronto
Philippe_Douste-Blazy	hasChild	Xavier_Bertrand
Andreas_Mayer	playsFor	Rosenborg_BK
Blake_Edwards	wasBornIn	Tulsa,_Oklahoma
Luciano_Andrade_Rissutt	playsFor	Sport_Club_do_Recife
Clayton_Ferreira_Cruz	playsFor	Clube_Atlético_Mineiro
Scouting_in_California	isLocatedIn	Sacramento,_California
Nicolas_Anelka	playsFor	Fenerbahçe_S.K._(football)
Darren_Ambrose	playsFor	Birmingham_City_F.C.
Calvin_Andrew	playsFor	Crystal_Palace_F.C.
Aaron_Brown_(footballer_born_1980)	playsFor	Darlington_F.C.
Yoann_Folly	playsFor	Southampton_F.C.
Anthony_Flood	playsFor	Galway_United_F.C.
Mel_Charles	playsFor	Wales_national_under-21_football_team
Jukka_Raitala	playsFor	SC_Paderborn_07
Carlos_María_Morales	playsFor	Everton_de_Viña_del_Mar
John_Markovski	playsFor	Marconi_Stallions_FC
Miroslav_Barčík	playsFor	Slovakia_national_football_team
Luigi_Di_Biagio	playsFor	Inter_Milan
Daniel_Šarić	playsFor	HNK_Rijeka
Emerson_Ferreira_da_Rosa	playsFor	Adelaide_United_FC
Sérgio_Mota	playsFor	Clube_Atlético_Penapolense
Gerardo_García_León	playsFor	Real_Sociedad
Murat_Şahin	playsFor	Gaziantepspor
Pedro_Largo_Carazo	playsFor	Xerez_CD
Darel_Russell	playsFor	Stoke_City_F.C.
Dominic_Green_(footballer)	playsFor	St_Neots_Town_F.C.
Marco_Streller	playsFor	VfB_Stuttgart
Hovhannes_Goharyan	playsFor	Armenia_national_under-21_football_team
Runar_Normann	playsFor	Tromsø_IL
Salvatore_Nobile	playsFor	Inter_Milan
Hamza_Bencherif	playsFor	Plymouth_Argyle_F.C.
Fernando_Alves_Santa_Clara	playsFor	Paraná_Clube
Marco_Ballotta	playsFor	Inter_Milan
Dejan_Damjanović	playsFor	Jiangsu_Guoxin-Sainty_F.C.
Juan_Manuel_Salgueiro	playsFor	San_Lorenzo_de_Almagro
Jonathan_Soriano	playsFor	Spain_national_under-20_football_team
Rafael_Santos_Bergamasco	playsFor	Londrina_Esporte_Clube
Chadli_Amri	playsFor	MC_Oran
Péter_Kincses	playsFor	Lombard-Pápa_TFC
Terry_Boyle	playsFor	Ebbw_Vale_F.C.
Hernán_Rodrigo_López	playsFor	Colo-Colo
Henri_Sillanpää	playsFor	Vaasan_Palloseura
Fabiano_Vieira_Soares	playsFor	FC_Thun
John_G._Thompson	graduatedFrom	University_of_Chicago
Shaka_Hislop	playsFor	Newcastle_United_F.C.
Wilson_Surubim	playsFor	Associação_Desportiva_Confiança
Esmail_Halali	playsFor	Paykan_F.C.
Hakan_Yakin	wasBornIn	Basel
Lee_Dong-won	playsFor	Incheon_United_FC
Guillermo_Israilevich	playsFor	Israel_national_under-21_football_team
Óscar_López_Hernández	playsFor	S.S._Lazio
Ibrahim_Kargbo	playsFor	Willem_II_(football_club)
Anselmo_Ramon	playsFor	CFR_Cluj
Benjamin_Kibebe	playsFor	FC_Nordsjælland
Tel_Aviv	isLocatedIn	Israel
Adrian_Viveash	playsFor	Walsall_F.C.
Marcus_Vinícius_da_Cruz_Alves_Nóbrega	wasBornIn	Rio_de_Janeiro
Felipe_Tigrão	playsFor	Tupi_Football_Club
Anıl_Karaer	playsFor	MKE_Ankaragücü
Christian_Erwig	playsFor	SC_Preußen_Münster
Norberto_Araujo	playsFor	Aldosivi
Boris_Rotenberg	playsFor	FC_Alania_Vladikavkaz
Greg_Strong	playsFor	Stoke_City_F.C.
Russell_Bradley	playsFor	Hereford_United_F.C.
Jürgen_Macho	playsFor	FC_Admira_Wacker_Mödling
Mitja_Mörec	playsFor	Maccabi_Herzliya_F.C.
Markus_Schupp	playsFor	Eintracht_Frankfurt
Emmanuel_Krontiris	playsFor	Tennis_Borussia_Berlin
Miklós_Horthy	playsFor	Sweden_national_football_team
Maciej_Scherfchen	playsFor	Widzew_Łódź
Lee_Ridley	playsFor	Scunthorpe_United_F.C.
Xhevdet_Llumnica	playsFor	Kalmar_FF
Ashley_Vickers	playsFor	Weymouth_F.C.
Víctor_Núñez	playsFor	C.S._Herediano
Frode_Olsen	playsFor	Stabæk_Fotball
Gustavo_Quinteros	playsFor	Club_Deportivo_San_José
Alain_Masudi	playsFor	SC_Bastia
Gianluca_Signorini	playsFor	A.S._Livorno_Calcio
Kevin_Dearden	playsFor	Barnet_F.C.
Delain_Sasa	playsFor	KF_Bylis_Ballsh
Miguel_Zepeda	playsFor	Club_Atlas
Stewart_Imlach	playsFor	Scotland_national_football_team
Michael_Duberry	playsFor	Hendon_F.C.
Joe_North	playsFor	Gillingham_F.C.
Dumisa_Ngobe	playsFor	Bidvest_Wits_F.C.
Robert_Duvall	hasWonPrize	Academy_Award_for_Best_Actor
Gianni_Munari	playsFor	ACF_Fiorentina
Sidney_Moraes	playsFor	C.D._Trofense
Mauro_Camoranesi	playsFor	Juventus_F.C.
Roger_Rodrigues_da_Silva	playsFor	Sport_Club_do_Recife
Marco_Caneira	playsFor	Reggina_Calcio
Wayne_Burnett	playsFor	Bolton_Wanderers_F.C.
Volkan_Ünlü	playsFor	MVV_Maastricht
Mahmud_Qurbanov	playsFor	Kapaz_PFK
Jorge_Domínguez	playsFor	Argentina_national_football_team
Alex_Bruce_(footballer,_born_1984)	playsFor	Republic_of_Ireland_national_under-21_football_team
Alberto_Fontana_(footballer_born_1967)	playsFor	S.S.C._Napoli
Željko_Gavrilović	playsFor	C.D._Nacional
Jeffrey_de_Visscher	playsFor	FC_Twente
Marcus_Pürk	playsFor	Real_Sociedad
Donald_Cock	playsFor	Leyton_Orient_F.C.
Wayne_Biggins	playsFor	Stoke_City_F.C.
Luis_Miguel_Gracia	playsFor	Deportivo_Alavés
Carmelo_Valencia	playsFor	Colombia_national_football_team
Antonio_Floro_Flores	playsFor	U.S._Sassuolo_Calcio
Caio_Júnior	playsFor	C.F._Os_Belenenses
Jordão_(footballer_born_1971)	playsFor	S.L._Benfica
Alexander_Thamm	playsFor	FC_Schalke_04
Anderson_Luiz_Domingos	playsFor	Luverdense_Esporte_Clube
Koko'o	playsFor	ASEC_Mimosas
Pedro_Vera	playsFor	Club_Olimpia
Stephen_O'Flynn	playsFor	Galway_United_F.C.
Roy_Carroll	playsFor	Manchester_United_F.C.
Edgardo_Simovic	playsFor	Club_Olimpia
Paul_Baker	playsFor	Hartlepool_United_F.C.
Valentīns_Lobaņovs	playsFor	FC_Metalurh_Zaporizhya
Mirko_Taccola	playsFor	F.C._Maia
Ronnie_Bird_(footballer)	playsFor	Birmingham_City_F.C.
Micah_Hyde_(footballer)	playsFor	Woking_F.C.
Gilberto_Yearwood	playsFor	Real_C.D._España
Fitz_Hall	playsFor	Wigan_Athletic_F.C.
Uli_Hoeneß	playsFor	Germany_national_youth_football_team
Scouting_in_California	isLocatedIn	Santa_Clara_County,_California
Bruno_Germain	playsFor	Paris_Saint-Germain_F.C.
Luciano_Becchio	playsFor	Norwich_City_F.C.
Glenn_Roeder	playsFor	Arsenal_F.C.
Serigne_Diop	playsFor	UJA_Maccabi_Paris_Métropole
Ismo_Lius	playsFor	FC_Kuusysi
Yozhef_Betsa	playsFor	Soviet_Union_national_football_team
Rajko_Lekić	playsFor	Lyngby_Boldklub
Dimitrios_Eleftheropoulos	playsFor	Proodeftiki_F.C.
Nick_Blackman	playsFor	Blackburn_Rovers_F.C.
Cícero_Semedo	playsFor	Guinea-Bissau_national_football_team
Andreas_Hinkel	playsFor	Germany_national_football_B_team
Cayetano_Ré	hasWonPrize	Pichichi_Trophy
Karl_Marx	influences	Jean-François_Lyotard
Andy_Ansah	playsFor	Dulwich_Hamlet_F.C.
Ruy_Bueno_Neto	playsFor	Grêmio_Foot-Ball_Porto_Alegrense
Evans_Wise	playsFor	SV_Waldhof_Mannheim
Andy_Lynch_(footballer)	playsFor	Heart_of_Midlothian_F.C.
Allan_Wanga	playsFor	A.F.C._Leopards
Saliou_Lassissi	playsFor	AS_Nancy
Julio_Landauri	playsFor	Total_Chalaco
David_Silva_(Cape_Verdean_footballer)	playsFor	G.D._Tourizense
Ibrahima_Bakayoko	playsFor	AEL_1964_FC
İlyas_Kahraman	playsFor	Bursaspor
Dean_Windass	wasBornIn	Kingston_upon_Hull
William_Shakespeare	influences	Henry_Fielding
Ferenc_Horváth	playsFor	G.D._Estoril_Praia
Marko_Perović_(footballer_born_1984)	playsFor	Chainat_Hornbill_F.C.
Matej_Delač	playsFor	Vitória_S.C.
Fábio_Felício	playsFor	Rio_Ave_F.C.
Tibor_Moldovan	playsFor	FC_Dinamo_București
Jon_Macken	playsFor	England_national_under-20_football_team
Fred_Pentland	wasBornIn	Wolverhampton
Walter_Whittaker	playsFor	Blackburn_Rovers_F.C.
Carlo_Nervo	playsFor	A.S._Cittadella
Dean_Bennett	playsFor	West_Bromwich_Albion_F.C.
Lennart_Meri	hasWonPrize	Order_of_the_Redeemer
Daniel_Majstorović	playsFor	Celtic_F.C.
André_Felippe_Seixas_Dias	playsFor	Villa_Nova_Atlético_Clube
Jean_Fernandez	playsFor	AS_Cannes
Victor_Kodelja	playsFor	Toronto_Blizzard_(1971–84)
Nikola_Trajković	wasBornIn	Belgrade
Chris_Leadbitter	playsFor	A.F.C._Bournemouth
Pedro_Geromel	playsFor	G.D._Chaves
Mark_Bentley	playsFor	Dagenham_&_Redbridge_F.C.
Kléber_de_Souza_Freitas	playsFor	FC_Dynamo_Kyiv
Henri_Antchouet	playsFor	Deportivo_Alavés
Chad_Marshall	playsFor	United_States_men's_national_under-17_soccer_team
Rudi_Vata	playsFor	St._Johnstone_F.C.
Gustavo_Balvorín	playsFor	Barcelona_Sporting_Club
Dejan_Ognjanović	playsFor	G.D._Estoril_Praia
Valmiro_Lopes_Rocha	playsFor	Málaga_CF
Hans_Vonk_(footballer)	playsFor	FC_Wageningen
Paul_Rachubka	playsFor	Milton_Keynes_Dons_F.C.
Emmanuel_Cerda	playsFor	Club_Tijuana
Juan_Pablo_Alfaro	playsFor	C.F._La_Piedad
Ruslan_Solyanyk	playsFor	FC_Kryvbas_Kryvyi_Rih
Strom_Thurmond	hasWonPrize	Order_of_the_Crown_(Belgium)
John_Beresford_(footballer)	playsFor	Barnsley_F.C.
Denis_Caniza	playsFor	Club_Rubio_Ñu
Jimmy_Gauld	playsFor	Everton_F.C.
Fabio_Virgili	playsFor	POFC_Botev_Vratsa
Miltiadis_Sapanis	playsFor	Ionikos_F.C.
Mick_Harford	playsFor	Derby_County_F.C.
Juan_Pablo_Galavis	playsFor	Deportivo_Lara
Francesco_Cozza_(footballer)	playsFor	Reggina_Calcio
Daniel_Gomez_(footballer)	playsFor	R.E._Virton
Alan_Kimble	playsFor	Dagenham_&_Redbridge_F.C.
Evgeny_Yarovenko	playsFor	FC_Rotor_Volgograd
Christian_Lara_(footballer)	playsFor	Deportivo_Quito
Ljubiša_Tumbaković	playsFor	FK_Partizan
Wellington_Nogueira_Lopes	playsFor	Clube_Atlético_Mineiro
Daniel_Candeias	playsFor	C.D._Nacional
Younous_Oumouri	playsFor	Egaleo_F.C.
Forest_Whitaker	actedIn	The_Hire
Danny_Fuchs	playsFor	SV_Wehen_Wiesbaden
Ivan_Korponai	playsFor	FC_Spartak_Ivano-Frankivsk
Michel_Pensée	wasBornIn	Yaoundé
David_Hibbert	playsFor	Port_Vale_F.C.
Federico_Almerares	playsFor	Argentina_national_under-20_football_team
Jeff_Duback	playsFor	Charlotte_Eagles
Ivan_Klasnić	playsFor	FC_Nantes
Jack_Macleod	playsFor	Hereford_United_F.C.
Valeriya_Korotenko	playsFor	Fenerbahçe_S.K.
Colin_Walker_(footballer,_born_1958)	playsFor	Matlock_Town_F.C.
Alexandre_Alves_da_Silva	playsFor	Pontevedra_CF
Mohd_Suffian_Abdul_Rahman	playsFor	Selangor_FA
Manfred_Kaltz	playsFor	Hamburger_SV
Robbie_Keane	playsFor	Leeds_United_A.F.C.
Norberto_Huezo	playsFor	C.D._Jalapa
John_Eriksen	playsFor	Odense_Boldklub
Alessandro_Pellicori	playsFor	Torino_F.C.
Ian_McDonald_(footballer)	playsFor	Aldershot_F.C.
Pavel_Kováč	playsFor	ŠK_Slovan_Bratislava
Vejle	isLocatedIn	Region_of_Southern_Denmark
Leandro_dos_Santos_Branco	playsFor	Clube_Atlético_Metropolitano
Tomasz_Frankowski	playsFor	FC_Martigues
Rupert_Everett	actedIn	Prêt-à-Porter_(film)
Dudu_Cearense	playsFor	Ceará_Sporting_Club
Joetex_Asamoah_Frimpong	wasBornIn	Accra
Mel_Brooks	isMarriedTo	Anne_Bancroft
Daniel_Cousin	wasBornIn	Libreville
Herbert_A._Simon	isCitizenOf	United_States
Carlos_Nicola	playsFor	San_Lorenzo_de_Almagro
Mirnes_Šišić	playsFor	NK_Rudar_Velenje
Lucknow	isLocatedIn	India
Ceará_(footballer)	playsFor	Sociedade_Esportiva_do_Gama
Ian_Stevens_(footballer)	playsFor	Gretna_F.C.
Vanderlei_José_Alves	playsFor	Clube_Atlético_Mineiro
Draško_Božović	playsFor	NK_Domžale
Mustapha_Hadji	playsFor	Deportivo_de_La_Coruña
Rory_Loy	playsFor	Kilmarnock_F.C.
Chris_Casement	playsFor	Hamilton_Academical_F.C.
Gunter_Thiebaut	playsFor	MVV_Maastricht
Rafael_dos_Santos_de_Oliveira	playsFor	Clube_Atlético_Juventus
Luis_Suárez_Miramontes	hasWonPrize	Ballon_d'Or_(1956–2009)
Serhiy_Bezhenar	playsFor	Ukraine_national_football_team
Thorsten_Wittek	playsFor	CS_Grevenmacher
Paulo_Figueiredo	playsFor	FC_Ceahlăul_Piatra_Neamț
Pablo_Granoche	playsFor	Novara_Calcio
Claude_Shannon	worksAt	Massachusetts_Institute_of_Technology
Milan_Perić	playsFor	FK_Mladost_Lučani
Santos_Amador	playsFor	Club_Deportivo_San_José
Horace_Harmon_Lurton	playsFor	Al-Hilal_FC
Yasuyuki_Moriyama	playsFor	ND_Gorica
Nuno_Manuel_Soares_Gomes	wasBornIn	Lisbon
Ian_Storey-Moore	playsFor	Chicago_Sting
Youssef_Haraoui	playsFor	ŠK_Slovan_Bratislava
James_Watson	hasWonPrize	Albert_Lasker_Award_for_Basic_Medical_Research
Dominique_Kivuvu	playsFor	N.E.C._(football_club)
Chris_Bennion	wasBornIn	Edinburgh
Steve_Shak	playsFor	Charlotte_Eagles
Gary_Etherington	playsFor	San_Diego_Sockers_(1978–96)
Ivan_Vukomanović	wasBornIn	Belgrade
Alessandro_Agostini	playsFor	A.C._Siena
Tony_Adcock	playsFor	Peterborough_United_F.C.
Mark_Kennedy_(footballer)	playsFor	Crystal_Palace_F.C.
Scott_Tynan	wasBornIn	Liverpool
Rui_Fonte	playsFor	RCD_Espanyol_B
Michael_Krohn-Dehli	playsFor	Denmark_national_under-21_football_team
Yıldıray_Baştürk	playsFor	Bayer_04_Leverkusen
Joe_Hanrahan	playsFor	Limerick_F.C.
Juha_Hakola	playsFor	Willem_II_(football_club)
Paulo_Sousa	playsFor	Panathinaikos_F.C.
Prince_Leopold_of_Bavaria	hasWonPrize	Military_Order_of_St._Henry
Henry_James	hasWonPrize	Order_of_Merit
Raymond_Chandler	wasBornIn	Chicago
Andrew_Hannah	playsFor	Everton_F.C.
Les_Devonshire	playsFor	Wealdstone_F.C.
Greg_Lincoln	playsFor	Stevenage_F.C.
Hughie_Gallacher	playsFor	Gateshead_F.C.
Derek_Swan	playsFor	FC_Wageningen
Steffen_Karl	playsFor	FC_St._Pauli
Daouda_Kanté	playsFor	St._Louis_Steamers_(1998–2006)
José_Sátiro_do_Nascimento	playsFor	Esporte_Clube_Vitória
Colombo	isLocatedIn	Asia
António_Folha	playsFor	Standard_Liège
Humberto_Maschio	playsFor	Quilmes_Atlético_Club
Daniel_Van_Buyten	playsFor	FC_Bayern_Munich_II
Gordon_Schildenfeld	playsFor	FC_Dynamo_Moscow
Mario_Grgurović	wasBornIn	Zadar
Fredrik_Stoor	playsFor	Hammarby_IF
Szymon_Matuszek	playsFor	Dolcan_Ząbki
Miloš_Živković_(footballer_born_1985)	playsFor	FK_Jagodina
Hernán_Losada	playsFor	R._Charleroi_S.C.
F._Murray_Abraham	actedIn	Marco_Polo_(TV_miniseries)
Bruno_Patacas	playsFor	Sporting_Clube_Lourinhanense
Pat_Scully	playsFor	Northampton_Town_F.C.
David_Sauget	playsFor	AS_Nancy
Adam_Cristman	playsFor	D.C._United
Grigol_Chanturia	playsFor	FC_Shevardeni-1906_Tbilisi
Alin_Artimon	playsFor	FCM_Dinamo_Onești
Mike_Trusson	playsFor	Plymouth_Argyle_F.C.
Giovanni_Invernizzi_(footballer_born_1931)	playsFor	Unione_Triestina_2012_S.S.D.
Sachin_Bhowmick	hasWonPrize	Filmfare_Awards
Andy_Tod	playsFor	Stockport_County_F.C.
Ertuğrul_Sağlam	playsFor	Turkey_national_football_team
João_Fajardo	playsFor	Atlético_Clube_de_Portugal
João_Gabriel_da_Silva	playsFor	NK_Drava_Ptuj
Gabriel_Torres_(footballer)	playsFor	Atlético_Huila
Daniel_Orac	playsFor	FC_Oțelul_Galați
Christoph_Saurer	playsFor	SK_Rapid_Wien
Darío_Figueroa	playsFor	Yokohama_F._Marinos
Brent_Sancho	playsFor	Portland_Timbers_(2001–10)
Guillermo_Suárez	playsFor	Deportivo_Armenio
Marco_Walker	playsFor	FC_Grenchen
Bernard_Pardo	playsFor	Olympique_de_Marseille
Matthew_Nelson_(soccer)	playsFor	Kilkenny_City_A.F.C.
Martin_Fenin	playsFor	Czech_Republic_national_under-17_football_team
Yusuke_Nakatani	playsFor	Kashiwa_Reysol
Hans_Henrik_Andreasen	playsFor	Denmark_national_under-21_football_team
Glynn_Snodin	playsFor	Gainsborough_Trinity_F.C.
Antoine_Bonifaci	playsFor	Vicenza_Calcio
Jay_Shields	playsFor	Dundee_F.C.
Pedro_DeBrito	wasBornIn	Praia
Aloísio_da_Silva_Filho	playsFor	Associação_Desportiva_Recreativa_e_Cultural_Icasa
Stephen_Carson	playsFor	Hartlepool_United_F.C.
Bruno_Rodriguez	playsFor	AS_Monaco_FC
Stevenage	isLocatedIn	East_of_England
Tosh_McKinlay	playsFor	Celtic_F.C.
Jean_Bouli	playsFor	FC_Terek_Grozny
Boston,_Lincolnshire	isLocatedIn	East_Midlands
Armen_Ambartsumyan	wasBornIn	Plovdiv
George_Miranda_dos_Santos	playsFor	Sport_Club_Corinthians_Alagoano
Jennison_Myrie-Williams	playsFor	Stevenage_F.C.
Simon_Stainrod	playsFor	RC_Strasbourg
Nico_Claesen	playsFor	Royal_Antwerp_F.C.
Bryan_Hughes	playsFor	Scarborough_Athletic_F.C.
Chris_Carruthers	playsFor	England_national_under-20_football_team
Gary_Heale	playsFor	Los_Angeles_Lazers
George_Papandreou	playsFor	Jomo_Cosmos_F.C.
Franco_Cángele	playsFor	Club_Atlético_Colón
Vadis_Odjidja-Ofoe	wasBornIn	Ghent
Élvis_Alves_Pereira	playsFor	Leixões_S.C.
Kevin_Miller_(footballer)	playsFor	Bristol_Rovers_F.C.
Peter_Nieketien	wasBornIn	Port_Harcourt
Zhivko_Zhelev	playsFor	PFC_Litex_Lovech
Ronnie_Bird_(footballer)	playsFor	Gloucester_City_A.F.C.
Ottó_Vincze	playsFor	FC_Energie_Cottbus
Balázs_Rabóczki	playsFor	Hungary_national_under-19_football_team
Mark_Noble	playsFor	Ipswich_Town_F.C.
Matt_Murphy_(English_footballer)	playsFor	Banbury_United_F.C.
Paul_Rideout	playsFor	Swindon_Town_F.C.
Gordon_Banks	playsFor	Cleveland_Stokers
Andreas_Lukse	wasBornIn	Vienna
Sammy_Clingan	playsFor	Kilmarnock_F.C.
Andy_Williams_(footballer_born_1962)	playsFor	Rotherham_United_F.C.
Terry_Howard	playsFor	Aldershot_Town_F.C.
Barry_Powell_(footballer)	playsFor	Wolverhampton_Wanderers_F.C.
Roberto_Brum	playsFor	Figueirense_Futebol_Clube
Walter_Henrique_da_Silva	playsFor	F.C._Porto
Shai_Biruk	playsFor	Hapoel_Ashkelon_F.C.
Craig_Dove	playsFor	Buxton_F.C.
Ivan_Zammit	wasBornIn	Valletta
Júnior_Morales	playsFor	Platense_F.C.
Rainer_Bonhof	playsFor	Valencia_CF
Régis_Amarante_Lima_de_Quadros	playsFor	Fluminense_FC
Philippe_Senderos	playsFor	Arsenal_F.C._Academy
Jovan_Kirovski	playsFor	SC_Fortuna_Köln
Hamed_Namouchi	playsFor	Étoile_du_Sahel
Laurent_Koscielny	playsFor	France_national_football_team
Park_Jae-hong_(footballer_born_1978)	playsFor	Insee_Police_United_F.C.
Flanders	hasOfficialLanguage	Dutch_language
Tim_Jerat	playsFor	Bayer_04_Leverkusen_II
Ivan_Čvorović	playsFor	PFC_Ludogorets_Razgrad
Anthony_Charles	playsFor	Farnborough_F.C.
Keenan_Wynn	wasBornIn	New_York_City
Clayton_Blackmore	playsFor	Wales_national_football_team
Paul_Ritchie_(footballer_born_1975)	playsFor	Walsall_F.C.
George_Berry_(footballer)	playsFor	Stafford_Rangers_F.C.
Adrián_Berbia	playsFor	Peñarol
Gabriel_Torje	playsFor	FC_Dinamo_București
Sebastian_Svärd	playsFor	Brøndby_IF
Ilija_Katić	wasBornIn	Belgrade
Eduardo_da_Silva_Nascimento_Neto	playsFor	Villa_Rio_Esporte_Clube
Neville_Roach	playsFor	Gippsland_Falcons
Darren_Barnard	playsFor	Wales_national_football_team
John_Williams	wroteMusicFor	Home_Alone_(franchise)
Orazio_Russo	playsFor	A.C._Perugia_Calcio
Rene_Gilmartin	playsFor	Yeovil_Town_F.C.
Michel_Ngonge	playsFor	K.A.A._Gent
Rajko_Brežančić	playsFor	FK_Bežanija
David_Sauget	playsFor	AS_Saint-Étienne
Veljko_Paunović	playsFor	Hannover_96
Ersin_Güreler	playsFor	Akçaabat_Sebatspor
Fereydoon_Fazli	playsFor	Nassaji_Mazandaran_F.C.
Desmon_Farmer	wasBornIn	Flint,_Michigan
Zoran_Mamić	playsFor	SV_Eintracht_Trier_05
Eitan_Tibi	playsFor	Maccabi_Tel_Aviv_F.C.
Pavel_Byahanski	playsFor	FC_Illichivets_Mariupol
Nicola_Pavarini	playsFor	A.C._Siena
Leandro_Lourenço_Franco	playsFor	C.D._Luis_Ángel_Firpo
Juan_Carlos_Quintero	playsFor	Atlético_Huila
Ali_Aliyev_(footballer)	playsFor	Akçaabat_Sebatspor
Tony_Sylva	playsFor	Trabzonspor
Nico_Jalink	playsFor	RKC_Waalwijk
Manolo_(footballer)	playsFor	Real_Murcia
Fabián_Espíndola	playsFor	Sociedad_Deportiva_Aucas
Roy_Barry	playsFor	Hibernian_F.C.
Geert_De_Vlieger	playsFor	Manchester_City_F.C.
George_Wall	playsFor	Hamilton_Academical_F.C.
Horst_Blankenburg	playsFor	K.S.C._Hasselt
Richarlyson	playsFor	FC_Red_Bull_Salzburg
Habib_Bellaïd	playsFor	MC_Alger
Pablo_Amo	wasBornIn	Madrid
Chibuzor_Chilaka	playsFor	Notts_County_F.C.
Jurica_Puljiz	playsFor	FK_Liepājas_Metalurgs
Wayne_Clarke_(footballer)	playsFor	Manchester_City_F.C.
Davide_Lanzafame	playsFor	Juventus_F.C.
Alojz_Rebula	isCitizenOf	Italy
Agent_Sawu	playsFor	APOP_Kinyras_FC
Albert_Jorquera	playsFor	FC_Barcelona_C
Thomas_Kyparissis	playsFor	Panelefsiniakos_F.C.
Isli_Hidi	playsFor	KF_Tirana
Edgar_Aldrighi_Júnior	playsFor	Tai_Po_FC
William_Prunier	playsFor	K.V._Kortrijk
Neill_Roberts	playsFor	Edmonton_Drillers_(1979–82)
Héctor_Bracamonte	playsFor	FC_Rostov
Ricardo_Esteves	playsFor	S.L._Benfica_B
Dominik_Beršnjak	playsFor	NK_Maribor
Šabac	isLocatedIn	Serbia
Karol_Gregorek	playsFor	Lech_Poznań
Jean-Pierre_La_Placa	wasBornIn	Geneva
Panagiotis_Tachtsidis	playsFor	Greece_national_football_team
Paulo_Assunção	playsFor	F.C._Porto_B
David_Thompson_(footballer_born_1968)	playsFor	Brentford_F.C.
Johnny_Jordan	playsFor	West_Ham_United_F.C.
Genoa_Cristoforo_Colombo_Airport	isLocatedIn	Genoa
David_Bell_(footballer_born_1985)	playsFor	Republic_of_Ireland_national_under-19_football_team
Jean_Tragodara	playsFor	Club_Deportivo_Universidad_César_Vallejo
Bill_Smith_(footballer_born_1926)	playsFor	Birmingham_City_F.C.
Simon_Walton	playsFor	Hartlepool_United_F.C.
Martin_Jirouš	playsFor	FK_Baník_Sokolov
Carl_Muggleton	playsFor	Bradford_City_A.F.C.
Afshin_Chavoshi	playsFor	S.C._Damash
Patrick_Colleter	wasBornIn	Brest,_France
Luís_Carlos_Fernandes	playsFor	Santos_FC
Tibor_Szabó	playsFor	FC_Volgar_Astrakhan
James_Beattie_(footballer)	playsFor	Rangers_F.C.
Jesse_Ventura	playsFor	Wrexham_F.C.
Harun_Isa	playsFor	FC_Prishtina
Willian_Xavier_Barbosa	wasBornIn	Campo_Grande
Don_Rickles	isCitizenOf	United_States
Lucas_Barrios	playsFor	Cobreloa
Gabriel_Héctor_Fernández	playsFor	Junior_F.C.
Adam_Moffat	playsFor	Cleveland_City_Stars
Yohann_Lacroix	playsFor	Ballymena_United_F.C.
Nerijus_Astrauskas	playsFor	Veria_F.C.
2waytraffic	isLocatedIn	Stockholm
Roger_Hansbury	playsFor	Birmingham_City_F.C.
Marian_Constantinescu	playsFor	FC_Ceahlăul_Piatra_Neamț
Iulian_Filipescu	playsFor	FC_Zürich
Walter_Samuel	playsFor	Deportivo_Petare
Florian_Myrtaj	playsFor	Sorrento_Calcio
Yannick_Djaló	playsFor	San_Jose_Earthquakes
Erasmus_University_Rotterdam	isLocatedIn	Rotterdam
Jon_Whitney_(footballer)	playsFor	Wigan_Athletic_F.C.
Uroš_Milosavljević	playsFor	FC_Zvezda_Irkutsk
Miami	isLocatedIn	Florida
Ghenadie_Ochincă	playsFor	FC_Rapid_Ghidighici
Dzmitry_Chaley	playsFor	FC_Granit_Mikashevichi
Paul_McGrillen	playsFor	East_Fife_F.C.
Pier_Luigi_Cherubino	playsFor	Spain_national_under-19_football_team
David_Targamadze	playsFor	Georgia_national_football_team
Stefan_Kuntz	playsFor	Germany_national_football_team
Andreas_Lipa	wasBornIn	Vienna
Zoran_Milinković_(footballer)	playsFor	K.S.V._Waregem
José_Torrealba	playsFor	Unión_Atlético_Maracaibo
Rossi_Jarvis	playsFor	Norwich_City_F.C.
Ray_Ferris	wasBornIn	Newry
Moussa_Saïb	playsFor	Tottenham_Hotspur_F.C.
David_França_Oliveira_e_Silva	playsFor	Pogoń_Szczecin
Slobodan_Krčmarević	wasBornIn	Belgrade
Herbert_A._Simon	hasWonPrize	Turing_Award
Hawar_Mulla_Mohammed	playsFor	Persepolis_F.C.
Barrie_Jones	playsFor	Plymouth_Argyle_F.C.
Mickaël_Pagis	playsFor	RC_Strasbourg
César_La_Paglia	playsFor	Wuhan_Optics_Valley_F.C.
Francisco_Ferreira_(Paraguayan_footballer)	playsFor	Club_Deportivo_Universidad_César_Vallejo
Dimitri_Tiomkin	wroteMusicFor	55_Days_at_Peking
Jermaine_Darlington	playsFor	Dover_Athletic_F.C.
Robert_Enke	playsFor	Fenerbahçe_S.K._(football)
Michal_Horňák	playsFor	FC_Fastav_Zlín
Dorothy_Parker	influences	Prince_(musician)
Beijing_Guoan_F.C.	isLocatedIn	China
Cleveland_Taylor	playsFor	Scarborough_F.C.
John_Grant_(English_footballer)	playsFor	Telford_United_F.C.
Moudachirou_Amadou	playsFor	FC_Erzgebirge_Aue
Serhiy_Zhuravlyov	playsFor	FC_Zimbru_Chișinău
Uche_Okafor	playsFor	U.D._Leiria
Hans_Bethe	playsFor	Greenock_Morton_F.C.
Enkeleid_Alikaj	wasBornIn	Tirana
Ymer_Xhaferi	playsFor	Tampereen_Peli-Pojat-70
Mousa_Dembélé	playsFor	Belgium_national_under-18_football_team
Hamza_Yacef	playsFor	CS_Constantine
Thomas_Beck_(footballer)	playsFor	Grasshopper_Club_Zürich
Bobby_Campbell_(footballer_born_1956)	playsFor	Huddersfield_Town_F.C.
Matteo_Momentè	playsFor	Italy_national_under-18_football_team
Mehdi_Nafti	playsFor	Racing_de_Santander_B
Vitória_F.C.	isLocatedIn	Pau,_France
Neil_Emblen	playsFor	Wolverhampton_Wanderers_F.C.
Ihor_Skoba	playsFor	FC_Sevastopol
Tomislav_Ivić	playsFor	RNK_Split
Alan_Mulcahy	playsFor	Kilkenny_City_A.F.C.
Zeffiro_Furiassi	playsFor	ACF_Fiorentina
Billy_Woods_(Irish_footballer)	playsFor	Portadown_F.C.
José_Reinaldo_de_Lima	playsFor	Clube_Atlético_Mineiro
Reinaldo_José_da_Silva	playsFor	CR_Vasco_da_Gama
Andrea_Gaveglia	playsFor	A.S._Avellino_1912
Northwestern_University	isLocatedIn	Illinois
Paul_Marshall_(footballer)	playsFor	Droylsden_F.C.
Martin_Landau	actedIn	EDtv
Colin_Hawkins	playsFor	Sporting_Fingal_F.C.
Pape_Habib_Sow	wasBornIn	Dakar
Sebastián_Flores	playsFor	C.A._Bella_Vista
Darren_Dunning	playsFor	York_City_F.C.
Graeme_Le_Saux	playsFor	England_national_football_B_team
Miguel_Herrera	playsFor	Santos_Laguna
Joey_Worthen	playsFor	United_States_men's_national_under-20_soccer_team
Helen_Mirren	wasBornIn	London
Michael_Essien	playsFor	A.C._Milan
Francisco_Aguirre	playsFor	FC_Chiasso
Aleksandar_Živković_(footballer_born_1977)	playsFor	Shenzhen_Ruby_F.C.
Mateo_Figoli	playsFor	Cúcuta_Deportivo
Ernest_Rutherford	hasWonPrize	Rumford_Medal
M._S._Swaminathan	hasWonPrize	Indira_Gandhi_Prize
Henrik_Larsen	playsFor	A.C._Pisa_1909
Nigel_Gleghorn	playsFor	Witton_Albion_F.C.
Oscar_Wirth	playsFor	Independiente_Medellín
Joël_Epalle	playsFor	Baku_FC
Howie_King	playsFor	Bray_Wanderers_A.F.C.
Christian_Träsch	playsFor	Manly_United_FC
Adi_Rocha	playsFor	SK_Austria_Kärnten
Steve_Klein_(soccer)	playsFor	New_England_Revolution
Claudio_Dadómo	playsFor	C.A._Cerro
László_Sepsi	playsFor	Romania_national_under-21_football_team
Martin_Horsell	playsFor	Weymouth_F.C.
Moreno_Ferrario	playsFor	A.S._Varese_1910
Juan_Gonzalo_Lorca	playsFor	Vitesse
Jeff_Blockley	playsFor	Notts_County_F.C.
Goran_Ljubojević	playsFor	FC_St._Gallen
Roberto_Vieri	playsFor	Marconi_Stallions_FC
Brian_Cash	playsFor	Sligo_Rovers_F.C.
José_Manuel_Ochotorena	playsFor	CD_Tenerife
Andrés_Scotti	playsFor	Puebla_F.C.
Mohamed_Chalali	playsFor	JSM_Béjaïa
Ihor_Shukhovtsev	playsFor	FC_Podillya_Khmelnytskyi
Eduardo_Antunes_Coimbra	playsFor	Esporte_Clube_Bahia
Diego_Cocca	playsFor	Querétaro_F.C.
Ruslan_Pimenov	playsFor	FC_Lokomotiv_Moscow
Harrison_Otálvaro	playsFor	Club_Atlético_Huracán
Tom_Murphy_(footballer)	playsFor	Lewes_F.C.
Adoniran_Vinícius_de_Campos	playsFor	União_Agrícola_Barbarense_Futebol_Clube
Guðmundur_Torfason	playsFor	K.R.C._Genk
George_Handley_(footballer)	playsFor	Southampton_F.C.
John_Williams	wroteMusicFor	Superman_II
David_Williams_(Australian_association_footballer)	playsFor	Melbourne_City_FC
Brian_Kerr_(footballer)	playsFor	Arbroath_F.C.
Eiður_Guðjohnsen	playsFor	Cercle_Brugge_K.S.V.
Willemstad	isLocatedIn	Central_America
Sinan_Bolat	playsFor	K.R.C._Genk
Alfredo_Moreno	playsFor	Racing_Club_de_Avellaneda
Tom_Soehn	playsFor	Colorado_Foxes
Yevhen_Zarichnyuk	playsFor	MFC_Mykolaiv
Kader_Mangane	wasBornIn	Dakar
Igor_Kralevski	playsFor	FC_Luch-Energiya_Vladivostok
Jimmy_Douglas_(American_soccer)	playsFor	Brooklyn_Wanderers
Patrick_Bick	playsFor	SV_Elversberg
Mateiu_Caragiale	influences	Mircea_Cărtărescu
Tamás_Takács	playsFor	Diósgyőri_VTK
Matěj_Vydra	playsFor	FC_Vysočina_Jihlava
Mario_Tičinović	playsFor	HNK_Hajduk_Split
Amarildo_Souza_do_Amaral	playsFor	Associação_Atlética_Internacional_(Limeira)
Jovan_Damjanović	playsFor	Red_Star_Belgrade
Ralph_Eberhart	hasWonPrize	Defense_Meritorious_Service_Medal
Paulo_Afonso_Santos_Júnior	playsFor	América_Futebol_Clube_(MG)
Warren_Aspinall	playsFor	Wigan_Athletic_F.C.
Declan_Edge	playsFor	Adelaide_City_FC
Horacio_Peralta	playsFor	Patriotas_F.C.
Marco_Cellini	playsFor	Montevarchi_Calcio_Aquila_1902
Pedro_Rocha	playsFor	Deportivo_Neza
Robin_Trott	playsFor	Hastings_United_F.C.
James_Jennings	playsFor	Mansfield_Town_F.C.
Egidio_Arévalo	playsFor	C.F._Monterrey
Johnny_Gorman	playsFor	Macclesfield_Town_F.C.
Mutiu_Adepoju	playsFor	Nigeria_national_football_team
Ahmad_Momenzadeh	playsFor	Foolad_F.C.
Anthony_Elding	playsFor	Stevenage_F.C.
Sebastian_Boenisch	playsFor	FC_Schalke_04_II
Serhiy_Litovchenko_(footballer_born_1979)	playsFor	Torpedo_Rīga
Ramin_Guliyev	playsFor	Baku_FC
Oleg_Veretennikov	playsFor	FC_Sokol_Saratov
Karim_Fachtali	playsFor	FC_Kaisar
Alfred_Schütz	graduatedFrom	University_of_Vienna
Jorge_Orosmán_da_Silva	playsFor	Danubio_F.C.
Avi_Tikva	playsFor	Israel_national_football_team
Georg_Wilhelm_Friedrich_Hegel	influences	Frantz_Fanon
Eric_Davis_(footballer)	playsFor	Sheffield_United_F.C.
Joël_Tchami	playsFor	Al-Salmiya_SC
Bashiru_Gambo	playsFor	King_Faisal_Babes_FC
Rob_Matthews_(footballer)	playsFor	Mossley_A.F.C.
Mohamed_Messoudi	playsFor	Beerschot_AC
Stephan_Keller	playsFor	FC_Aarau
Peter_Clarke_(footballer)	playsFor	Coventry_City_F.C.
Albert_Camus	influences	Jean-Paul_Sartre
Gustavo_Chena	playsFor	Deltras_F.C.
Jamie_Moralee	playsFor	Colchester_United_F.C.
Miodrag_Belodedici	playsFor	Villarreal_CF
Ousmane_Dabo	playsFor	S.S._Lazio
Patrick_Bengondo	playsFor	Olympic_Mvolyé
Carlos_Alberto_Alves_Garcia	wasBornIn	Lisbon
Southampton	isLocatedIn	South_East_England
Daniel_Majstorović	playsFor	Malmö_FF
William_Arthur_Conceição_dos_Santos	playsFor	Vitória_F.C.
Warren_Cummings	playsFor	Scotland_national_football_team
Radosław_Cierzniak	playsFor	Stomil_Olsztyn_(football)
Albert_Camus	influences	Philip_Roth
Razak_Omotoyossi	playsFor	Helsingborgs_IF
Krzysztof_Ratajczyk	playsFor	FK_Austria_Wien
Ralf_Keidel	playsFor	Germany_national_under-21_football_team
Rosa_Luxemburg	graduatedFrom	University_of_Zurich
UB_Conquense	isLocatedIn	Castile-La_Mancha
Michael_Turnbull_(footballer)	playsFor	South_Coast_Wolves_FC
Syarhey_Shtanyuk	playsFor	FC_Dynamo_Moscow
Dirk_Jan_Derksen	playsFor	Fortuna_Sittard
David_Kinnear	playsFor	Queen_of_the_South_F.C.
Ivan_Stevanović	playsFor	FC_Sochaux-Montbéliard
Richard_Dryden	playsFor	Scarborough_F.C.
Luke_Guttridge	playsFor	Cambridge_United_F.C.
Uche_Okafor	playsFor	Maccabi_Ironi_Ashdod_F.C.
Djamel_Belmadi	playsFor	Celta_de_Vigo
Dady	playsFor	G.D._Estoril_Praia
Dmytro_Brovkin	playsFor	AC_Oulu
Armando_Pantanelli	playsFor	A.S.D._Fidelis_Andria_1928
Prince_(musician)	hasWonPrize	Brit_Awards
Rubén_Paz	playsFor	Rampla_Juniors
Newport_Gwent_Dragons	isLocatedIn	South_Wales
Aleksandar_Sarić	playsFor	FK_Obilić
Mick_Harford	playsFor	Coventry_City_F.C.
Tony_da_Costa_Pinho	wasBornIn	Cuiabá
David_Cross_(footballer,_born_1950)	playsFor	Bury_F.C.
Urmuz	influences	Eugène_Ionesco
Louis-Ferdinand_Céline	influences	Charles_Bukowski
Rob_Elvins	playsFor	Solihull_Moors_F.C.
Matthias_Lepiller	playsFor	Novara_Calcio
Marcone_Amaral_Costa	playsFor	El_Jaish_SC
Sam_Allardyce	playsFor	Esteghlal_Ahvaz_F.C.
David_Holdsworth	playsFor	Bolton_Wanderers_F.C.
John_Sheridan_(footballer)	playsFor	Doncaster_Rovers_F.C.
Felix_Klein	hasWonPrize	Copley_Medal
Rene_Gilmartin	wasBornIn	Dublin
Mike_Stowell	playsFor	Preston_North_End_F.C.
Nigel_Winterburn	playsFor	West_Ham_United_F.C.
Bartosz_Tarachulski	playsFor	Górnik_Zabrze
Taipei	isLocatedIn	Asia
Martin_Laursen	playsFor	Denmark_national_under-19_football_team
Alec_Chamberlain	playsFor	Tranmere_Rovers_F.C.
Danny_Hockton	playsFor	Bromley_F.C.
Léo_Lima	playsFor	Santos_FC
David_Adekola	playsFor	Bridge_Boys_F.C.
Scott_Houghton	playsFor	Gillingham_F.C.
Hamdan_Al-Bishi	playsFor	S.S.D._Massese
Craig_Sives	playsFor	Heart_of_Midlothian_F.C.
James_Constable	playsFor	Walsall_F.C.
Matheus_Coradini_Vivian	playsFor	Grenoble_Foot_38
Gabriel_Boștină	playsFor	FC_Dinamo_București
Francesco_Guidolin	playsFor	F.B.C._Unione_Venezia
Kamil_Majkowski	playsFor	Pogoń_Szczecin
Eiji_Kawashima	playsFor	Japan_national_football_team
Blaž_Slišković	playsFor	HNK_Hajduk_Split
Antar_Yahia	wasBornIn	Mulhouse
Nana_Attakora	playsFor	Canada_men's_national_under-20_soccer_team
Laura_Linney	hasWonPrize	Golden_Globe_Award
William_Martínez	playsFor	Central_Español
Edin_Šaranović	playsFor	NK_Kamen_Ingrad
Jiloan_Hamad	playsFor	TSG_1899_Hoffenheim
Ben_Roberts_(footballer)	playsFor	Hartlepool_United_F.C.
Richard_Dutruel	playsFor	Stade_Malherbe_Caen
George_H._W._Bush	hasChild	Bill_Clinton
Sven_Müller	playsFor	FC_Augsburg
Gennaro_Troianiello	playsFor	U.S.D._Nuorese_Calcio
Skyliners_Frankfurt	isLocatedIn	Germany
Domingo_Tarasconi	playsFor	San_Martín_de_Tucumán
Ivan_Paskov	playsFor	Kastoria_F.C.
Bruno_Henrique_Fortunato_Aguiar	playsFor	Grêmio_Barueri_Futebol
Jefferson_Nascimento	playsFor	Guaratinguetá_Futebol
Marco_Cassetti	playsFor	A.C._Lumezzane
Steve_Morrow	playsFor	Peterborough_United_F.C.
Wassim_El_Banna	playsFor	Ajman_Club
Michael_Connelly	wasBornIn	Philadelphia
Cristiano_Moraes_de_Oliveira	playsFor	Criciúma_Esporte_Clube
Wilf_Toman	playsFor	Burnley_F.C.
Sam_Aiston	playsFor	Northampton_Town_F.C.
Per_Frandsen	playsFor	Denmark_national_football_team
Erving_Goffman	worksAt	University_of_Pennsylvania
Oliver_Ryan	playsFor	Frickley_Athletic_F.C.
Tiago_Rannow	playsFor	Betim_Esporte_Clube
Bjørn_Tore_Kvarme	playsFor	Real_Sociedad
Marko_Livaja	playsFor	A.C._Cesena
Diego_Capel	playsFor	Sevilla_FC
Entebbe_International_Airport	isLocatedIn	Uganda
Emanuele_Pesaresi	playsFor	A.C._Chievo_Verona
Neil_Lennon	playsFor	Glenavon_F.C.
Oskar_Drobne	playsFor	FC_Koper
Vančo_Trajanov	playsFor	PFC_Minyor_Pernik
Moussa_Saïb	playsFor	Al_Nassr_FC
Rovérsio	playsFor	New_York_Cosmos_(2010)
Olivier_Dacourt	playsFor	Inter_Milan
Scott_McGleish	playsFor	Colchester_United_F.C.
Gerry_Hitchens	playsFor	Worcester_City_F.C.
Baldur_Sigurðsson	playsFor	Iceland_national_football_team
Gaël_Kakuta	wasBornIn	Lille
Tomica_Kocijan	playsFor	SK_Vorwärts_Steyr
Jamie_Wood	playsFor	Swansea_City_A.F.C.
Omar_Jarun	playsFor	Chicago_Fire_Premier
Jason_Kennedy_(footballer)	playsFor	Darlington_F.C.
Boško_Janković	playsFor	U.S._Città_di_Palermo
Leslie_Caron	hasWonPrize	Golden_Globe_Award
Bryan_Deasley_(footballer)	playsFor	Dundee_F.C.
André_Neles	playsFor	Esporte_Clube_Vitória
Radoslav_Batak	wasBornIn	Novi_Sad
Andy_Jones_(footballer)	playsFor	Charlton_Athletic_F.C.
Andrija_Kaluđerović	playsFor	FK_Spartak_Zlatibor_Voda
Miroslav_Bičanić	playsFor	Hapoel_Be'er_Sheva_F.C.
Luis_Tonelotto	playsFor	Real_Murcia
Lee_Richardson_(footballer)	playsFor	Livingston_F.C.
Tuto	playsFor	Grêmio_Esportivo_Glória
Ramón_Sánchez	playsFor	Alianza_F.C.
Springfield,_Illinois	isLocatedIn	Illinois
Bobby_Robinson_(footballer)	playsFor	Scotland_national_under-21_football_team
Michal_Hanek	playsFor	Polonia_Bytom
Paul_Murray_(footballer)	playsFor	England_national_football_B_team
Grigori_Perelman	playsFor	S.C._Damash
Hannes_Reinmayr	playsFor	FC_Linz
Vladimir_Shishelov	playsFor	FC_Bunyodkor
Carlos_Menjívar	playsFor	A.D._Isidro_Metapán
Philippe_Clement	playsFor	K._Beerschot_V.A.C.
Luís_Miguel_Fontes_Martins	playsFor	Rio_Ave_F.C.
Volodymyr_Kilikevych	playsFor	FK_Dinamo_Samarqand
Federico_Moretti	playsFor	A.S._Varese_1910
Siniša_Ubiparipović	playsFor	FK_Modriča
Ivan_Jurić	playsFor	Genoa_C.F.C.
Søren_Kierkegaard	influences	Karl_Jaspers
Libor_Kozák	playsFor	Aston_Villa_F.C.
Giuseppe_Colucci_(footballer)	playsFor	Calcio_Catania
Giambattista_Vico	influences	Joseph_de_Maistre
Bernard_Lambourde	playsFor	SC_Bastia
Quique_Setién	playsFor	CD_Logroñés
Carl_Alford	playsFor	Stockport_County_F.C.
Hermes_Rodrigues_Júnior	playsFor	Gil_Vicente_F.C.
Sebastián_Hernández	playsFor	Colombia_national_under-17_football_team
Francesco_Baiano	playsFor	A.S.D._SanGiovanniValdarno
Oriol_Lozano	playsFor	CE_L'Hospitalet
Nikica_Jelavić	playsFor	Croatia_national_football_team
Johnny_Woodly_Lambert	playsFor	Alianza_F.C.
Nedumudi_Venu	hasWonPrize	National_Film_Awards_(India)
Luuk_de_Jong	playsFor	Netherlands_national_under-21_football_team
Peter_Beardsley	playsFor	Fulham_F.C.
Marc_Laird	playsFor	Manchester_City_F.C.
Marco_Gómez	playsFor	C.F._Mérida
Michael_Malcolm_(footballer)	playsFor	Bromley_F.C.
Vijayakumar_(actor)	actedIn	Baba_(2002_film)
Jorge_Higuaín	playsFor	San_Lorenzo_de_Almagro
Zoltán_Kovács_(footballer_born_1973)	playsFor	MTK_Budapest_FC
Robbie_Doyle	playsFor	Blackburn_Rovers_F.C.
Emiliano_Viviano	wasBornIn	Florence
Guido_Hoffmann	playsFor	Borussia_Mönchengladbach
Erich_Probst	playsFor	Wuppertaler_SV
Joël_Epalle	playsFor	Panachaiki_F.C.
David_Jackson_(footballer)	playsFor	Altrincham_F.C.
Adrian_Dulcea	playsFor	CS_Jiul_Petroșani
Stefan_Leitl	playsFor	SpVgg_Unterhaching
Eric_Cantona	playsFor	AJ_Auxerre
Andy_McLaren	playsFor	Ayr_United_F.C.
Jarrod_Smith	playsFor	Colorado_Rapids_U-23
Hayden_Mullins	playsFor	Reading_F.C.
Abdoulaye_Baldé_(footballer)	playsFor	LB_Châteauroux
Peter_Hawkins_(footballer)	playsFor	Wimbledon_F.C.
Ecuador	exports	wordnet_petroleum_114980579
Sebastián_Losada	wasBornIn	Madrid
Ionel_Augustin	playsFor	FC_Dinamo_București
Agustín_Viana	playsFor	Columbus_Crew
Aaron_Conway	wasBornIn	Dundee
Les_plus_belles_escroqueries_du_monde	isLocatedIn	France
Manny_Panther	wasBornIn	Glasgow
Paulo_Santos_(Portuguese_footballer)	playsFor	Rio_Ave_F.C.
Hunter_Freeman	playsFor	IK_Start
Manuel_Vidrio	playsFor	Tiburones_Rojos_de_Veracruz
Pan_Pierre_Koulibaly	playsFor	Wydad_Casablanca
János_Kovács	playsFor	Lincoln_City_F.C.
Curtis_Osano	playsFor	Aldershot_Town_F.C.
Hyun_Young-min	playsFor	FC_Seoul
Mickaël_Poté	playsFor	AS_Cannes
Oliver_Stone	hasWonPrize	Bronze_Star_Medal
South_West_England	isLocatedIn	Bristol
Artur_Kotenko	playsFor	AEP_Paphos_F.C.
Filipe_Morais	playsFor	Stevenage_F.C.
Jaime_Miguel_Linares	playsFor	Angola_national_football_team
Aaron_Brown_(footballer_born_1980)	playsFor	Gillingham_F.C.
Karl_Decker_(footballer)	playsFor	First_Vienna_FC
Crawley_Town_F.C.	isLocatedIn	Crawley
Alen_Bokšić	playsFor	AS_Cannes
Dino_Đulbić	playsFor	South_Melbourne_FC
Pavel_Kováč	playsFor	Apollon_Kalamarias
John_Edensor_Littlewood	graduatedFrom	University_of_Cambridge
Kwame_Ampadu	playsFor	Tiverton_Town_F.C.
Con_Martin	playsFor	League_of_Ireland_XI
Prince_Polley	playsFor	FC_Aarau
Leyrielton_Moura_de_Morais	playsFor	Trindade_Atlético_Clube
Pasquale_Bruno	playsFor	Wigan_Athletic_F.C.
Markus_Münch_(footballer)	playsFor	Germany_national_youth_football_team
Gifton_Noel-Williams	playsFor	Elche_CF
Marco_Quotschalla	playsFor	Wuppertaler_SV
Alexandro_Álvarez	playsFor	Santos_Laguna
Wagner_Diniz	playsFor	CR_Vasco_da_Gama
Paul_Bracewell	playsFor	Stoke_City_F.C.
Juan_Carlos_Reyes_(footballer)	playsFor	Centro_Atlético_Fénix
Jean_Calvé	playsFor	Le_Mans_FC
Julian_Brahja	playsFor	KS_Dinamo_Tirana
Andrew_McNeil	playsFor	Hibernian_F.C.
Bernabé_Ballester	playsFor	Ontinyent_CF
South_Holland	isLocatedIn	The_Hague
Martins_Ekwueme	playsFor	SK_Sigma_Olomouc
James_Constable	playsFor	Chippenham_Town_F.C.
Johnny_McGuire	playsFor	Brooklyn_Robins_Dry_Dock
Aleandro_Rosi	playsFor	A.S._Livorno_Calcio
Jens_Paeslack	wasBornIn	Hamburg
José_Luis_Borbolla	playsFor	Real_Club_España
Evan_Berger	wasBornIn	Sydney
Santa_Cruz_de_Tenerife	isLocatedIn	Canary_Islands
Giampaolo_Pazzini	playsFor	ACF_Fiorentina
Fabien_Bossy	playsFor	Montpellier_HSC
João_Paulo_da_Silva	playsFor	Iraty_Sport_Club
Martin_Gritton	wasBornIn	Glasgow
Jordy_Brouwer	playsFor	ADO_Den_Haag
Elivélton	playsFor	Sport_Club_Internacional
Deon_Burton	playsFor	Brentford_F.C.
Danny_Sleath	playsFor	Ilkeston_F.C.
Matt_Taylor_(footballer)	playsFor	Matlock_Town_F.C.
Addy-Waku_Menga	playsFor	F.C._Hansa_Rostock
Txomin_Nagore	playsFor	CD_Mirandés
Claudio_Dadómo	playsFor	Ergotelis_F.C.
Alec_Chamberlain	playsFor	Chelsea_F.C.
René_van_Eck	playsFor	S.B.V._Excelsior
Indra_Putra_Mahayuddin	playsFor	Turkey_national_football_B_team
Christian_Tiffert	playsFor	1._FC_Kaiserslautern
Miguel_Peirano_(footballer)	playsFor	C.A._Progreso
Joseph_Ujlaki	playsFor	France_national_football_team
Juan_Guillermo_Domínguez	playsFor	Newell's_Old_Boys
Andy_Hessenthaler	playsFor	Gillingham_F.C.
Ibezito_Ogbonna	playsFor	Apolonia_Fier
Jon_Sheffield	playsFor	Hereford_United_F.C.
Filippo_Carobbio	playsFor	U.C._AlbinoLeffe
Sergio_Santín	playsFor	Uruguay_national_football_team
Slobodan_Rajković	playsFor	Vitesse
Neil_Ross_(footballer)	playsFor	Ilkeston_F.C.
Stéphane_Noro	playsFor	Apollon_Limassol
Roman_Ogaza	playsFor	GKS_Tychy
Oscar_Más	playsFor	América_de_Cali
Luís_Fernando_Martinez	playsFor	Cruzeiro_Esporte_Clube
Delfim_Teixeira	playsFor	Associação_Naval_1º_de_Maio
Abderrahim_Ouakili	playsFor	1._FSV_Mainz_05
Toni_Kolehmainen	playsFor	Hønefoss_BK
Emin_Agaev	playsFor	Baku_FC
Tunis	isLocatedIn	Tunisia
Danny_Murphy_(footballer,_born_1982)	playsFor	Shamrock_Rovers_F.C.
Mohamed_Fofana_(Guinean_footballer)	playsFor	Porin_Palloilijat
Vítor_Moreno	playsFor	Portimonense_S.C.
Mako_Iwamatsu	actedIn	Teenage_Mutant_Ninja_Turtles_(film_series)
Lee_Elam	playsFor	Southport_F.C.
Fumagalli	playsFor	Associação_Ferroviária_de_Esportes
Lucas_Piasentin	playsFor	Fortaleza_Esporte_Clube
Brian_Dutton	playsFor	Eastleigh_F.C.
Billy_Dixon_(footballer)	playsFor	Boston_Rovers
Volkmar_Groß	playsFor	Hertha_BSC
Steve_Talboys	playsFor	Sutton_United_F.C.
Roger_Rodrigues_da_Silva	wasBornIn	Campinas
Josip_Skoko	playsFor	Gençlerbirliği_S.K.
Pasi_Rautiainen	playsFor	Helsingin_Jalkapalloklubi
Sam_Morrow	playsFor	Hibernian_F.C.
Sebastian_Schoof	playsFor	TSV_Germania_Windeck
Carlos_Enrique	playsFor	Gimnasia_y_Tiro
Randy_Samuel	playsFor	FC_Volendam
Lee_Williamson	playsFor	Preston_North_End_F.C.
Kenny_Cooper	playsFor	TSV_1860_München
Joca	playsFor	C.D._Santa_Clara
Jack_Elkes	playsFor	Tottenham_Hotspur_F.C.
Edu_Sales	playsFor	Akratitos_F.C.
Philip_K._Dick	influences	The_Wachowskis
Search_for_Common_Ground	isLocatedIn	Indonesia
Martin_Dimov_(footballer_born_1986)	playsFor	FC_Sportist_Svoge
Herbert_York	hasWonPrize	Vannevar_Bush_Award
Nader_al-Tarhouni	playsFor	Ismaily_SC
Ahmed_Mubarak_Al-Mahaijri	playsFor	Al-Oruba_SC
Oeki_Hoekema	wasBornIn	Leeuwarden
Danny_Grainger	playsFor	Heart_of_Midlothian_F.C.
Jim_Arnold_(footballer)	playsFor	Stafford_Rangers_F.C.
Harald_V_of_Norway	hasWonPrize	Order_of_the_Three_Stars
José_Júnior	playsFor	Ceará_Sporting_Club
Kenneth_Møller_Pedersen	wasBornIn	Odense
Leandro_Lázzaro	playsFor	Instituto_Atlético_Central_Córdoba
Duisburg	isLocatedIn	Germany
Darren_Sawatzky	playsFor	New_England_Revolution
Sebastián_Ereros	playsFor	Cerro_Porteño
David_Smith_(footballer_born_1968)	playsFor	England_national_under-21_football_team
Ysrael_Zúñiga	playsFor	Sporting_Cristal
Bruno_Fogaça	playsFor	Associação_Naval_1º_de_Maio
Gláuber	playsFor	Associação_Desportiva_São_Caetano
United_States_Naval_Academy	isLocatedIn	United_States
Jody_Banim	playsFor	Ebbsfleet_United_F.C.
Jean_Paulo_Batista_de_França	playsFor	Nacional_Futebol_Clube
Chris_Makiese	playsFor	Troyes_AC
Liran_Cohen	playsFor	Israel_national_under-21_football_team
Vicente_Sánchez	playsFor	FC_Schalke_04
Łódź	isLocatedIn	Łódź_Voivodeship
Guillem_Bauzà	playsFor	Northampton_Town_F.C.
Lorenz_Kindtner	playsFor	Australia_national_under-23_association_football_team
Rio_Ferdinand	playsFor	England_national_football_team
Gábor_Bukrán	playsFor	Hungary_national_football_team
Ramón_Calderé	playsFor	Real_Valladolid
Dean_Howell	playsFor	Halifax_Town_A.F.C.
Mark_Byrnes	playsFor	Sydney_Olympic_FC
Bryan_Prunty	playsFor	Dumbarton_F.C.
Doc_Lawson	playsFor	New_York_Cosmos
Edvin_Murati	playsFor	Paris_Saint-Germain_F.C.
Luigi_Delneri	playsFor	U.C._Sampdoria
Nicolás_Raimondi	playsFor	Club_Jorge_Wilstermann
Leon_Constantine	playsFor	Peterborough_United_F.C.
Giuseppe_Colucci_(footballer)	playsFor	A.S._Roma
Schwenck	playsFor	Centro_de_Futebol_Zico_Sociedade_Esportiva
Leo_Strauss	isInterestedIn	Islamic_philosophy
Paul_Evans_(footballer_born_1973)	playsFor	Mamelodi_Sundowns_F.C.
Richard_Eckersley_(footballer)	playsFor	New_York_Red_Bulls
Georg_Wilhelm_Friedrich_Hegel	influences	Ion_Heliade_Rădulescu
Mario_Cáceres	playsFor	FC_St._Gallen
William_Mokoena	wasBornIn	Johannesburg
Germán_Pietrobon	playsFor	PFC_CSKA_Sofia
Donizete_Oliveira	playsFor	Fluminense_FC
Sergey_Burdin	playsFor	FC_SOYUZ-Gazprom_Izhevsk
Münster	isLocatedIn	North_Rhine-Westphalia
Zoltan_Crișan	playsFor	FC_Bihor_Oradea
Stanislav_Griga	playsFor	SK_Rapid_Wien
Francis_Laurent	wasBornIn	Paris
Carlo_Azeglio_Ciampi	hasChild	Silvio_Berlusconi
Dean_Sinclair	playsFor	Cheltenham_Town_F.C.
Mike_Pinner	playsFor	Corinthian-Casuals_F.C.
David_Niven	hasWonPrize	Legion_of_Merit
Marcos_Aurélio_de_Oliveira_Lima	playsFor	Ituano_Futebol_Clube
James_Thompson_(footballer)	playsFor	FC_Luzern
Scott_Y._Thomson	playsFor	Brechin_City_F.C.
Elia_Kazan	hasWonPrize	Golden_Globe_Award
Slobodan_Komljenović	playsFor	SV_Wacker_Burghausen
Gustaf_V_of_Sweden	hasWonPrize	Order_of_St._Anna
George_MacDonald	influences	Mark_Twain
George_Travers	playsFor	Gillingham_F.C.
René_van_de_Kerkhof	playsFor	Netherlands_national_football_team
Daniel_Florea	playsFor	FC_Metalurh_Zaporizhya
Denílson_Gabionetta	playsFor	A.S._Varese_1910
Brendon_Šantalab	playsFor	Parramatta_Power_SC
Goran_Stevanović	playsFor	Veria_F.C.
Neil_Shipperley	playsFor	Brentford_F.C.
Miloš_Bursać	playsFor	Kansas_City_Attack
Steve_Olfers	playsFor	S.B.V._Excelsior
Marc_Van_Der_Linden	playsFor	K.A.A._Gent
Luciano_Agnolín	playsFor	All_Boys
Sam_Gargan	playsFor	Bognor_Regis_Town_F.C.
Dewan_Bader	playsFor	Richmond_Kickers
Georges_Bataille	influences	Jean_Baudrillard
Stefano_Sorrentino	playsFor	A.S._Varese_1910
Gérard_Depardieu	actedIn	Hamlet_(1996_film)
Jimmy_Sharp	playsFor	Arsenal_F.C.
Osei_Sankofa	playsFor	Boreham_Wood_F.C.
Ali_Karimi	playsFor	FC_Schalke_04
Emin_Agaev	playsFor	FC_Nosta_Novotroitsk
Yemi_Odubade	playsFor	Gateshead_F.C.
Mark_Lillis	playsFor	Stockport_County_F.C.
Terry_Owen	wasBornIn	Liverpool
Renny_Vega	playsFor	Deportivo_La_Guaira
Andrey_Astrowski	playsFor	FC_Chornomorets_Odesa
Yevgeni_Varlamov	playsFor	FC_Metalist_Kharkiv
Ian_McDonald_(footballer)	wasBornIn	Barrow-in-Furness
Todi_Jónsson	playsFor	F.C._Copenhagen
Christian_Eduardo_Giménez	playsFor	Hertha_BSC
István_Gajda	playsFor	Hungary_national_under-17_football_team
Pier_Ruggero_Piccio	playsFor	Bradford_City_A.F.C.
Dida_(footballer_born_1973)	playsFor	Sport_Club_Internacional
Albert_Craig_(footballer)	playsFor	Dumbarton_F.C.
John_O'Neill_(Scottish_footballer)	playsFor	Stirling_Albion_F.C.
Robbie_Threlfall	playsFor	Northampton_Town_F.C.
Nick_Deacy	playsFor	Vitesse
Nikolajs_Poļakovs	playsFor	FK_Venta
Robbie_Russell_(soccer)	playsFor	Viborg_FF
Paul_Compton	playsFor	Aldershot_F.C.
Roberto_Trashorras	playsFor	FC_Barcelona
Nenad_Stojanović	playsFor	FK_Železnik
Henryk_Jabłoński	hasWonPrize	Order_of_Georgi_Dimitrov
Isidoro_San_José	playsFor	Real_Madrid_C.F.
Trevor_Senior	playsFor	Dorchester_Town_F.C.
Jesús_Ramírez	wasBornIn	Mexico_City
Burak_Karaduman	playsFor	Torku_Konyaspor
Oleh_Venhlynskyi	playsFor	FC_Dnipro_Dnipropetrovsk
Igor_Bogdanović	wasBornIn	Novi_Sad
Steve_Williams_(footballer_born_1983)	playsFor	Farnborough_F.C.
Bilal_Çubukçu	playsFor	Berliner_AK_07
Neil_Martin	playsFor	Hibernian_F.C.
Shahrulnizam_Mustapa	playsFor	Kedah_FA
Kenneth_Brylle_Larsen	playsFor	CE_Sabadell_FC
Henk_Vos	playsFor	Beerschot_AC
Alec_Chamberlain	playsFor	Luton_Town_F.C.
Omar_Jarun	playsFor	Atlanta_Silverbacks
Joan_Crawford	wasBornIn	San_Antonio
Pedro_Paulo_da_Silva	playsFor	Clube_de_Regatas_Brasil
Jürgen_Colin	playsFor	NAC_Breda
Leandro_Caruso	playsFor	Club_El_Porvenir
Gary_McSwegan	playsFor	Barnsley_F.C.
Lee_Todd_(footballer)	playsFor	Bradford_City_A.F.C.
Amadou_Sanokho	playsFor	FC_Nantes
Les_Ferdinand	playsFor	Watford_F.C.
Kevin_O'Flanagan	wasBornIn	Dublin
Vlad_Munteanu	playsFor	FC_Energie_Cottbus
Renaldo_Kalari	wasBornIn	Tirana
Sean_Douglas	playsFor	Football_Kingz_FC
Arthur_Stepanyan	playsFor	FC_Gornyak_Uchaly
Saúl_Ñíguez	playsFor	Rayo_Vallecano
David_Byrne_(footballer,_born_1960)	playsFor	Toronto_Blizzard_(1971–84)
Steven_Cann	playsFor	Derby_County_F.C.
Benjamin_Martha	wasBornIn	Willemstad
Rubens_Cardoso	playsFor	Sociedade_Esportiva_Palmeiras
Philippe_Anziani	playsFor	AS_Monaco_FC
Thomas_Hunt_Morgan	isCitizenOf	United_States
William_Shatner	created	Star_Trek_(film_franchise)
Trond_Egil_Soltvedt	playsFor	Sheffield_Wednesday_F.C.
Miloš_Marić	playsFor	FK_Remont_Čačak
Gareth_Davies_(footballer_born_1973)	playsFor	Cardiff_City_F.C.
Vladimir_Jugović	playsFor	Rot_Weiss_Ahlen
Tony_Cousins	playsFor	Republic_of_Ireland_national_under-19_football_team
Agustín_De_La_Canal	playsFor	Olympiakos_Nicosia
Chris_Woods	playsFor	Nottingham_Forest_F.C.
Henri_Bedimo	wasBornIn	Douala
Angelo_Di_Livio	playsFor	A.C._Perugia_Calcio
Nicolás_Diez	playsFor	Racing_Club_de_Avellaneda
John_Oster	playsFor	Leeds_United_A.F.C.
Derek_O'Connor	playsFor	Republic_of_Ireland_national_under-21_football_team
Shay_Given	playsFor	Manchester_City_F.C.
Roy_Essandoh	playsFor	East_Fife_F.C.
Paolo_Vanoli	wasBornIn	Varese
Reagan_Noble	playsFor	South_Africa_national_football_team
Filippo_Antonelli	playsFor	Cosenza_Calcio
Stuart_Lewis	playsFor	Gillingham_F.C.
George_Uhlenbeck	hasWonPrize	Wolf_Prize_in_Physics
Sergey_Dmitriyev	playsFor	FC_Spartak_Moscow
Gyula_Lóránt	playsFor	FC_UTA_Arad
Hiroyuki_Ishida	playsFor	Balestier_Khalsa_FC
Luis_Cristaldo	playsFor	Textil_Mandiyú
Diego_Latorre	playsFor	Racing_Club_de_Avellaneda
John_Galvin_(general)	hasWonPrize	Legion_of_Merit
Olav_V_of_Norway	hasWonPrize	Order_of_the_White_Rose_of_Finland
Grand_Duke_Constantine_Pavlovich_of_Russia	playsFor	FK_Smederevo
Orestas_Buitkus	playsFor	FC_Rubin_Kazan
Hossein_Kazemi	playsFor	Fajr_Sepasi_F.C.
Aytekin_Viduşlu	playsFor	Balıkesirspor
Edson_dos_Santos_Reis	playsFor	Comercial_Futebol_Clube_(Ribeirão_Preto)
Jalen_Pokorn	playsFor	NK_Olimpija_Ljubljana_(defunct)
Nicolás_Pareja	playsFor	Argentina_national_under-23_football_team
CB_Sevilla	isLocatedIn	Seville
Papakouli_Diop	playsFor	K.A.S._Eupen
Marko_Vejinović	playsFor	Heracles_Almelo
Andy_Toman	playsFor	Bishop_Auckland_F.C.
Mattias_Bjärsmyr	playsFor	Panathinaikos_F.C.
Henryk_Miłoszewicz	wasBornIn	Vilnius
Bernd_Schuster	playsFor	Germany_national_football_team
Kakhaber_Tskhadadze	playsFor	FC_Metalurgi_Rustavi
Marquis_de_Sade	influences	Michel_Foucault
Kleyr_Vieira_dos_Santos	playsFor	Varzim_S.C.
Eric_Avila	playsFor	FC_Dallas
Leonard_Bisaku	playsFor	Pohang_Steelers
Hebert_Revetria	playsFor	Club_Nacional_de_Football
Bob_McAuley	playsFor	Cardiff_City_F.C.
Republic_of_Ireland	exports	wordnet_pharmaceutical_103920989
Sammy_Igoe	playsFor	Portsmouth_F.C.
Volkan_Kahraman	playsFor	Austria_national_football_team
Juan_Ramón_Carrasco	playsFor	Rocha_F.C.
Mike_Metcalf	playsFor	Wrexham_F.C.
Nenad_Lazarevski	wasBornIn	Novi_Sad
Kieran_McAnespie	playsFor	A.F.C._Bournemouth
Edmundo_Zura	playsFor	San_Jose_Earthquakes
Dean_Beckwith	playsFor	Gillingham_F.C.
Edgar_Aguilera	playsFor	Cerro_Porteño
Lucas_Omar_Rodríguez_Pagano	playsFor	Club_Atlético_Temperley
Marius_Kižys	playsFor	ŁKS_Łódź
Neil_McBain	playsFor	Liverpool_F.C.
Waldir_Lucas_Pereira	playsFor	Ethnikos_Piraeus_F.C.
Lee_Tschantret	playsFor	Harrisburg_Heat
Ally_MacLeod	wasBornIn	Glasgow
Tommy_Eglington	playsFor	Cork_Hibernians_F.C.
Franck_Manga_Guela	playsFor	Arminia_Bielefeld
François_Omam-Biyik	playsFor	Canon_Yaoundé
Tony_Scully	playsFor	Dagenham_&_Redbridge_F.C.
Cutthroat_Island	isLocatedIn	Italy
Peñarol_de_Mar_del_Plata	isLocatedIn	Buenos_Aires_Province
Albeiro_Usuriaga	playsFor	Carabobo_FC
Ray_Harford	playsFor	Colchester_United_F.C.
Alan_Fettis	playsFor	Blackburn_Rovers_F.C.
Demba_Ba	playsFor	Newcastle_United_F.C.
Mario_Leguizamón	playsFor	Club_Deportivo_Universidad_César_Vallejo
Gianfranco_Labarthe	playsFor	Derby_County_F.C.
Alexander_Hleb	playsFor	Arsenal_F.C.
Ioannis_Masmanidis	wasBornIn	Leverkusen
Shirley_MacLaine	hasWonPrize	GLAAD_Media_Award
Alessandro_Gazzi	playsFor	A.C._Siena
Ali_Mathlouthi	playsFor	LB_Châteauroux
Steve_Pinau	playsFor	Vendée_Poiré-sur-Vie_Football
Solomon_Lefschetz	hasWonPrize	National_Medal_of_Science
Rudy_Doliscat	playsFor	Buffalo_Blizzard
Domenico_Di_Carlo	playsFor	Vicenza_Calcio
Mark_Strudal	playsFor	Boldklubben_Frem
Andy_Brownrigg	playsFor	Hednesford_Town_F.C.
Avi_Peretz_(footballer)	playsFor	Hapoel_Bnei_Lod_F.C.
Darran_Rowbotham	playsFor	Weymouth_F.C.
Kevin_Sakuda	playsFor	Montreal_Impact
Wellington_Luís_de_Sousa	playsFor	FC_Twente
Ray_Veall	playsFor	Everton_F.C.
Neal_Bartlett	playsFor	Hastings_United_F.C.
Stuart_Green	playsFor	Newcastle_United_F.C.
Marcos_de_Paula	playsFor	Foligno_Calcio
Kleyr_Vieira_dos_Santos	playsFor	Sociedade_Esportiva_do_Gama
Rašo_Babić	playsFor	FK_Mladost_Lučani
Ernie_Campbell	playsFor	St_George_FC
Michel_Rodriguez	playsFor	Amiens_SC
Scott_Howie	playsFor	Coventry_City_F.C.
Mustapha_Hadji	playsFor	Coventry_City_F.C.
Oliver_Stöckli	playsFor	FC_Aarau
Mohammed_Ali_Karim	playsFor	Al-Zawra'a_SC
Doug_Warren	playsFor	Northern_Virginia_Royals
Adrian_Olegov	playsFor	PFC_CSKA_Sofia
Alyaksey_Suchkow	playsFor	Belarus_national_under-21_football_team
Gustaf_V_of_Sweden	hasWonPrize	Order_of_St._Vladimir
Badile_Lubamba	playsFor	FC_Luzern
Jack_Brand	playsFor	Tampa_Bay_Rowdies_(1975–93)
Mark_Williams_(South_African_footballer)	playsFor	Guizhou_Renhe_F.C.
Julio_César_Manzur	playsFor	Santos_FC
Vincent_Sasso	playsFor	FC_Nantes
Andy_Linighan	playsFor	Oldham_Athletic_A.F.C.
Fernando_Amorebieta	playsFor	Athletic_Bilbao_B
Patrick_Zoundi	playsFor	MSV_Duisburg
Con_Boutsianis	playsFor	Moreland_Zebras_FC
Mehmet_Akgün	playsFor	Borussia_Dortmund_II
Michael_Turnbull_(footballer)	playsFor	Marconi_Stallions_FC
Roy_Essandoh	playsFor	Kettering_Town_F.C.
Alex_von_Schwedler	playsFor	Colo-Colo
Pedro_Benítez	playsFor	Sportivo_Luqueño
Steve_Nicol	playsFor	Liverpool_F.C.
Davis_Curiale	playsFor	U.S._Sambenedettese_1923
Andriy_Poroshyn	playsFor	FC_Salyut_Belgorod
Vladan_Pavlović	playsFor	FK_Mladi_Obilić
Françoise_Bonnot	edited	Top_Secret!
Fernando_Gómez_Colomer	playsFor	Spain_national_under-19_football_team
Mbulelo_Mabizela	playsFor	Mamelodi_Sundowns_F.C.
Luis_Capurro	playsFor	LDU_Quito
Shwan_Jalal	playsFor	Gillingham_F.C.
Stu_Riddle	playsFor	Kalamazoo_Kingdom
Juvhel_Tsoumou	playsFor	TSV_Hartberg
Silviu_Izvoranu	playsFor	CS_Universitatea_Craiova_(football)
Yussif_Chibsah	playsFor	Djurgårdens_IF_Fotboll
Túlio_Gustavo_Cunha_Souza	playsFor	Esporte_Clube_Santo_André
Aleksander_Knavs	playsFor	Slovenia_national_football_team
Nobuhiro_Takeda	playsFor	Júbilo_Iwata
Roberto_Lopes_Nascimento	playsFor	Ceará_Sporting_Club
Claudio_Enría	playsFor	Club_Atlético_Lanús
George_Raynor	playsFor	Sheffield_United_F.C.
Germán_Arangio	playsFor	Argentina_national_under-20_football_team
Dimitris_Koutromanos	playsFor	AEK_Athens_F.C.
Vardan_Mazalov	playsFor	FC_Khimki
Mick_Heathcote	playsFor	Spennymoor_United_F.C.
Rhys_Murphy	playsFor	England_national_under-16_football_team
Vadim_Demidov	playsFor	Rosenborg_BK
Aitor_Ocio	playsFor	Athletic_Bilbao
Phil_Kite	playsFor	Sheffield_United_F.C.
John_Woodward_(footballer_born_1947)	playsFor	Stoke_City_F.C.
Neil_McBain	playsFor	New_Brighton_A.F.C.
Sergio_Busquets	playsFor	Spain_national_under-21_football_team
Richard_Harris	hasWonPrize	European_Film_Awards
Ronnie_Dix	playsFor	Derby_County_F.C.
Miguel_Rebosio	playsFor	Sport_Boys
Pat_Flynn_(footballer)	playsFor	Kidderminster_Harriers_F.C.
Zoltán_Stieber	playsFor	SpVgg_Greuther_Fürth
Mohammed_Mbye	playsFor	Stade_Rennais_F.C.
Dorival_Júnior	playsFor	Avaí_Futebol_Clube
Georgi_Georgiev_(footballer_born_1970)	playsFor	Apollon_Smyrni_F.C.
Alysson_Marendaz_Marins	playsFor	CR_Vasco_da_Gama
Mauro_Navas	wasBornIn	Buenos_Aires
Luis_Vallenilla	playsFor	Unión_Atlético_Maracaibo
Fernando_Meneses	playsFor	Colo-Colo
Alan_Gow	playsFor	Plymouth_Argyle_F.C.
Kalusha_Bwalya	playsFor	PSV_Eindhoven
Robert_Kovač	playsFor	1._FC_Nürnberg
Marek_Kulič	playsFor	1._FK_Příbram
James_McEveley	playsFor	Charlton_Athletic_F.C.
Rafael_Olarra	playsFor	Club_Deportivo_Universidad_Católica
Paolo_Hernán_Dellafiore	playsFor	Calcio_Padova
Bartosz_Ślusarski	playsFor	Lech_Poznań
Leyti_N'Diaye	playsFor	AC_Ajaccio
Mark_Jonas	wasBornIn	Washington,_D.C.
Marc_Kienle	playsFor	Germany_national_under-21_football_team
Patrick_Cubaynes	playsFor	Nîmes_Olympique
Rob_Witschge	playsFor	AFC_Ajax
Lemuel_C._Shepherd,_Jr.	hasWonPrize	Order_of_the_Aztec_Eagle
John_Bonnar	playsFor	Celtic_F.C.
Mathias_Jørgensen	playsFor	Denmark_national_under-17_football_team
Fernando_Correa	playsFor	Club_Atlético_River_Plate_(Montevideo)
Ayres_Cerqueira_Simao	playsFor	Paraná_Clube
Tomo_Šokota	playsFor	K.S.C._Lokeren_Oost-Vlaanderen
Luigi_Allemandi	playsFor	A.S.D._Legnano_Calcio_1913
Dejan_Osmanović	playsFor	FK_Bežanija
Dudu_Cearense	playsFor	Goiás_Esporte_Clube
Itimi_Dickson	playsFor	Woodlands_Wellington_FC
Izu_Azuka	playsFor	Nigeria_national_under-23_football_team
Billy_Paynter	playsFor	Swindon_Town_F.C.
Martins_Ekwueme	playsFor	Wisła_Kraków
Christian_Samir_Martínez	playsFor	Rio_Ave_F.C.
Cédric_Liabeuf	playsFor	Le_Mans_FC
Exodus_Geohaghon	wasBornIn	Birmingham
Stanton_Fredericks	playsFor	Pierikos_F.C.
Paul_Robson	playsFor	Long_Island_Rough_Riders
Gelson_Fernandes	playsFor	FC_Sion
Josef_Bican	playsFor	SK_Rapid_Wien
Takashi_Hirano	playsFor	Yokohama_F._Marinos
Billy_Hodgson	playsFor	St._Johnstone_F.C.
José_Moreira	playsFor	Portugal_national_football_team
Mark_Williams_(Northern_Ireland_footballer)	playsFor	Milton_Keynes_Dons_F.C.
Lothar_Emmerich	playsFor	Würzburger_Kickers
Hao_Junmin	playsFor	FC_Schalke_04
Aniello_Cutolo	playsFor	A.C._Perugia_Calcio
Javier_Moro_León	playsFor	Hércules_CF
Fabiano_Cezar_Viegas	playsFor	Kashima_Antlers
Raouf_Bouzaiene	playsFor	LB_Châteauroux
Jimmy_Case	playsFor	Darlington_F.C.
Brandenburg	isLocatedIn	Germany
Ante_Jurić	playsFor	Australia_national_under-23_association_football_team
Thomas_Herbst_(footballer)	playsFor	SV_Darmstadt_98
Fabricio_Agosto_Ramírez	wasBornIn	Las_Palmas
Shaun_Batt	wasBornIn	Harlow
Florin_Bratu	playsFor	Romania_national_football_team
Ludovic_Giuly	playsFor	A.S._Roma
Giovanni_Cervone	playsFor	Brescia_Calcio
Matt_Tubbs	playsFor	Salisbury_City_F.C.
Ivan_Kotenko	playsFor	PFC_Oleksandriya
David_Cross	hasWonPrize	Primetime_Emmy_Award
Marcelo_Leopaldi	playsFor	Ionikos_F.C.
Ramazan_Özcan	playsFor	SC_Austria_Lustenau
Josip_Škorić	playsFor	HNK_Šibenik
Tenywa_Bonseu	playsFor	Chicago_Fire_Soccer_Club
TSV_1860_München	isLocatedIn	Bavaria
Ramazan_Kurşunlu	playsFor	Ankaraspor_A.Ş.
Boyko_Velichkov	playsFor	PFC_Levski_Sofia
Carlos_Saleiro	playsFor	Sporting_Clube_de_Portugal
Dean_McDonald	playsFor	Whitehawk_F.C.
Almamy_Schuman_Bah	playsFor	Clermont_Foot
Nuno_Laranjeiro	playsFor	C.D._Fátima
Jimmy_Mulisa	wasBornIn	Kigali
Michele_Canini	playsFor	Italy_national_under-21_football_team
Brian_Murphy_(association_footballer)	playsFor	Ipswich_Town_F.C.
Alassane_N'Dour	playsFor	Senegal_national_football_team
Donald-Olivier_Sié	playsFor	Nagoya_Grampus
Ger_Robinson	playsFor	Kildare_County_F.C.
John_Spicer_(footballer)	playsFor	Notts_County_F.C.
Motohiro_Yamaguchi	playsFor	Nagoya_Grampus
Eliseo_Quintanilla	playsFor	C.D._FAS
Felice_Piccolo	playsFor	Reggina_Calcio
Colin_Stein	playsFor	Kilmarnock_F.C.
János_Hrutka	wasBornIn	Budapest
João_Carlos_Pires_de_Deus	playsFor	F.C._Barreirense
Miodrag_Krivokapić	playsFor	FK_Sutjeska_Nikšić
Sam_Ricketts	playsFor	Hull_City_A.F.C.
Alexei_Eremenko	playsFor	Tromsø_IL
Werner_Heisenberg	influences	Carl_Friedrich_von_Weizsäcker
Leandro_Machado	playsFor	Avaí_Futebol_Clube
Vladimir_Eshtrekov	playsFor	FC_Dynamo_Vologda
Vlado_Šmit	playsFor	Cagliari_Calcio
Pedro_Guerreiro_de_Jesus_Correia	playsFor	Racing_de_Ferrol
James_Thompson_(footballer)	playsFor	Leyton_Orient_F.C.
Kelly_(footballer)	playsFor	Clube_Atlético_Paranaense
Sergio_Herrera	playsFor	Colombia_national_football_team
Rachid_Rokki	playsFor	Fath_Union_Sport
Nîmes	isLocatedIn	Languedoc-Roussillon
Curd_Jürgens	isCitizenOf	Austria
Little_Vietnam	isLocatedIn	Japan
Nikola_Jozić	playsFor	FK_Radnik_Bijeljina
Mandla_Zwane	playsFor	F.C._Porto
Francisco_José_Olivas	playsFor	Villarreal_CF
Diego_De_Ascentis	wasBornIn	Como
Milija_Aleksic	playsFor	Barnet_F.C.
Andreas_Dahlén	playsFor	F.C._Hansa_Rostock
Colin_Brazier_(footballer)	playsFor	Leamington_F.C.
Ibrahima_Sidibe	playsFor	ASKÖ_Pasching
Paul_Simpson_(footballer)	playsFor	Carlisle_United_F.C.
Claude_Gnakpa	playsFor	Luton_Town_F.C.
Ayoze_Díaz_Díaz	playsFor	Racing_de_Santander
Kai_Haaskivi	playsFor	Houston_Hurricane
Baltazar_Maria_de_Morais_Júnior	playsFor	Stade_Rennais_F.C.
Terry_Yorath	playsFor	Coventry_City_F.C.
Amir_Karić	playsFor	NK_Rudar_Velenje
Igor_Mostarlić	playsFor	NK_Jedinstvo_Bihać
Aristide_Bancé	playsFor	Fortuna_Düsseldorf
Jorge_Luis_Borges	wasBornIn	Buenos_Aires
Michael_Lumb_(footballer)	playsFor	Feyenoord
Mehdi_Benatia	playsFor	Clairefontaine
Emmanuel_Kenmogne	playsFor	Ethnikos_Achna_FC
Edgar_Davids	playsFor	Inter_Milan
Jason_Price	playsFor	Oldham_Athletic_A.F.C.
Renato_Rafael_Bondi	playsFor	S.S._Teramo_Calcio
Brendan_O'Connell_(football)	playsFor	Burnley_F.C.
Karel_Jarolím	playsFor	SK_Slavia_Prague
Celje	isLocatedIn	Savinjska_Statistical_Region
Everson_Pereira_da_Silva	playsFor	RWDM_Brussels_FC
Jorge_Orlando_Aravena_Plaza	playsFor	Club_Deportivo_Universidad_Católica
Jehad_Muntasser	playsFor	Calcio_Catania
Ricardo_Serna	playsFor	Spain_national_under-23_football_team
Fábio_Júnior_Pereira	playsFor	Brazil_national_under-23_football_team
Álvaro_Santos	playsFor	F.C._Copenhagen
Kálmán_Kovács	playsFor	Valenciennes_FC
Daniel_Baldi	playsFor	Danubio_F.C.
Aaron_King	playsFor	Fort_Lauderdale_Strikers
Law_Chun_Bong	playsFor	Hong_Kong_Rangers_FC
Kwame_Ayew	wasBornIn	Accra
Gilberto_da_Silva_Melo	playsFor	America_Football_Club_(RJ)
Leonardo_DiCaprio	actedIn	Celebrity_(film)
Papa_Bouba_Diop	wasBornIn	Dakar
Jimmy_Carter_(footballer)	playsFor	Crystal_Palace_F.C.
Sejad_Halilović	playsFor	GNK_Dinamo_Zagreb
Christian_Prosenik	playsFor	First_Vienna_FC
Costel_Mozacu	playsFor	FC_Oțelul_Galați
Richard_Roelofsen	playsFor	Vitesse
Wellington_Sánchez	playsFor	New_York_Red_Bulls
Dawid_Banaczek	playsFor	IFK_Norrköping
Silvio_Pagano	wasBornIn	Wuppertal
Tomáš_Galásek	playsFor	Willem_II_(football_club)
Georgios_Kyriazis	playsFor	Iraklis_Thessaloniki_F.C.
Romano_Perticone	playsFor	U.S._Cremonese
Roger_Ljung	playsFor	Sweden_national_football_team
Daniel_Fernandes_(footballer)	playsFor	VfL_Bochum
Janusz_Kupcewicz	playsFor	Arka_Gdynia
Dave_Tuttle	playsFor	Wycombe_Wanderers_F.C.
José_Leandro_Andrade	playsFor	C.A._Bella_Vista
Rodolfo_Arruabarrena	playsFor	Club_Deportivo_Universidad_Católica
Andrea_Guerra_(footballer)	playsFor	F.C._Südtirol
Albert_Luque	playsFor	FC_Barcelona
Francismar_Carioca_de_Oliveira	playsFor	Grêmio_Barueri_Futebol
Alexandru_Tudose	playsFor	FC_Oțelul_Galați
Vitaliy_Berezovskyi	playsFor	FC_Odesa
Oleg_Strakhanovich	playsFor	FC_Partizan_Minsk
Lee_Sharpe	playsFor	Garforth_Town_A.F.C.
Dragan_Čadikovski	playsFor	FC_Zenit_Saint_Petersburg
Rodrigo_Arroz	playsFor	FC_Vihren_Sandanski
Oz_Ifrah	playsFor	FC_Torpedo_Moscow
Chakhir_Belghazouani	playsFor	RC_Strasbourg
Derek_Lyle	playsFor	Partick_Thistle_F.C.
Peter_Sweeney	playsFor	Leeds_United_A.F.C.
Roman_Kienast	playsFor	HamKam
Alberto_Valentim	playsFor	Guarani_Futebol_Clube
Fábio_Bilica	playsFor	Sivasspor
Iván_Zarandona	playsFor	RCD_Mallorca_B
Miguel_Bravo	playsFor	Deportivo_Cuenca
Rudi_Völler	playsFor	Germany_national_football_team
Hugo_Machado	playsFor	Sanat_Naft_Abadan_F.C.
Claudio_Marangoni	playsFor	Sunderland_A.F.C.
Juan_Pablo_Ángel	playsFor	Atlético_Nacional
Joan_Verdú	playsFor	Spain_national_under-20_football_team
Willie_Hamilton_(footballer)	playsFor	Hamilton_Academical_F.C.
Tiago_Luís	playsFor	Clube_Atlético_Bragantino
Stuart_Holden	playsFor	Houston_Dynamo
Tomasz_Moskała	playsFor	Dyskobolia_Grodzisk_Wielkopolski
Danny_Blair	playsFor	Scotland_national_football_team
Ettore_Mendicino	wasBornIn	Milan
Los_Angeles	isLocatedIn	California
Natale_Gonnella	playsFor	A.S._Gualdo_Casacastalda
Juan_Carlos_Lorenzo	playsFor	Chacarita_Juniors
Marcelo_Guerrero	wasBornIn	Montevideo
Adolfino_Cañete	playsFor	Club_River_Plate_(Asunción)
Jordan_Henderson	playsFor	England_national_under-20_football_team
Paul_Kitson_(American_soccer)	playsFor	Cleveland_Force_(1978–88)
Vladimir_Vujović_(footballer)	playsFor	Al-Wehda_Club_(Mecca)
Wenderson_Arruda_Said	playsFor	Esporte_Clube_Democrata
Óscar_Díaz_González	playsFor	Real_Madrid_Castilla
Bobby_Thomson_(footballer_born_1943)	playsFor	Worcester_City_F.C.
Wojciech_Łobodziński	playsFor	Stomil_Olsztyn_(football)
Will_Hay	influences	John_Cleese
Oribe_Peralta	playsFor	Santos_Laguna
Darren_Bradshaw	playsFor	Blackpool_F.C.
Gordon_Marshall_(footballer_born_1964)	playsFor	Celtic_F.C.
Warren_Patmore	playsFor	Cambridge_United_F.C.
Alejandro_Meloño	playsFor	Rentistas
University_of_Calcutta	isLocatedIn	West_Bengal
Michel_Lafranceschina	playsFor	Bourges_18
Charles_Darwin	hasWonPrize	Royal_Medal
Gary_Barnett_(footballer)	playsFor	Coventry_City_F.C.
Mark_Nicholls	playsFor	Northwood_F.C.
Chuks_Aneke	playsFor	Stevenage_F.C.
Michael_Flynn_(footballer)	playsFor	Gillingham_F.C.
Trond_Fredrik_Ludvigsen	playsFor	Strømsgodset_IF
Alan_Irvine_(footballer,_born_1962)	playsFor	St._Mirren_F.C.
San_Francisco_Bay_Area	isLocatedIn	California
Blessing_Kaku	playsFor	Nigeria_national_football_team
Mathieu_Bodmer	playsFor	AS_Saint-Étienne
Souleymane_Oulare	playsFor	K._Beringen-Heusden-Zolder
Nazar_Baýramow	playsFor	FC_Vorskla_Poltava
Karl_Marx	influences	Michel_Aflaq
Sébastien_Siani	playsFor	S.V._Zulte_Waregem
Blaise_Pascal	influences	Alexis_de_Tocqueville
Dmitri_Ekimov	wasBornIn	Moscow
Immanuel_Kant	influences	John_Dewey
Obafemi_Martins	playsFor	VfL_Wolfsburg
Rahim_Ouédraogo	playsFor	Heracles_Almelo
Steve_Mokone	playsFor	Sunshine_George_Cross_FC
Jon-Paul_Pittman	playsFor	Bury_F.C.
Paul_Allen_(footballer)	playsFor	West_Ham_United_F.C.
Bill_Lacey_(footballer)	playsFor	Shelbourne_F.C.
Bruno_Akrapović	playsFor	FC_Rot-Weiß_Erfurt
Daniel_Usvat	wasBornIn	Oradea
Ovidiu_Petre	playsFor	FC_Progresul_București
Ólafur_Ingi_Skúlason	wasBornIn	Reykjavík
Orestes_Júnior_Alves	playsFor	C.F._Os_Belenenses
Evanivaldo_Castro	playsFor	Associação_Portuguesa_de_Desportos
Jamie_McQuilken	playsFor	Queen_of_the_South_F.C.
Dirk_Caspers	playsFor	Borussia_Mönchengladbach_II
Yakov_Ehrlich	playsFor	FC_Rostov
Peter_Kjær_(footballer)	playsFor	Beşiktaş_J.K.
Ederson_Honorato_Campos	playsFor	S.S._Lazio
Levan_Kenia	playsFor	Georgia_national_under-21_football_team
Mattias_Asper	playsFor	AIK_Fotboll
Jesús_Galván_Carrillo	playsFor	Deportivo_Alavés
Michelle_Pfeiffer	actedIn	A_Midsummer_Night's_Dream_(1999_film)
César_Charún	playsFor	Peru_national_football_team
Belgrade	isLocatedIn	Serbia
Darren_Ryan	playsFor	Shrewsbury_Town_F.C.
Emiliano_Dudar	playsFor	AC_Bellinzona
Emerson_Orlando_de_Melo	playsFor	Guarani_Futebol_Clube
Rúben_Micael	playsFor	C.F._União
Stefan_Ishizaki	wasBornIn	Stockholm
Stefano_Okaka	playsFor	U.C._Sampdoria
Paul_Aimson	playsFor	York_City_F.C.
Ibrahima_Ba_(footballer)	playsFor	CS_Sfaxien
Julian_de_Guzman	playsFor	FC_Dallas
Fernando_Clavijo	playsFor	San_Jose_Earthquakes_(1974–88)
Boubacar_Dembélé	playsFor	Étoile_Fréjus_Saint-Raphaël
Ned_Beatty	actedIn	Toy_Story_3
Raf_de_Gregorio	playsFor	Helsingin_Jalkapalloklubi
Aristotle	influences	Murray_Rothbard
Marko_Marin	playsFor	Germany_national_youth_football_team
Jonathan_Bornstein	wasBornIn	Torrance,_California
Fernando_Morientes	playsFor	AS_Monaco_FC
Tommy_Fitzgerald	playsFor	Shelbourne_F.C.
Nicolás_Vigneri	playsFor	Racing_Club_de_Avellaneda
Lasha_Salukvadze	playsFor	FC_SKA-Energiya_Khabarovsk
Marc_Williams	playsFor	Wales_national_under-17_football_team
Georgi_Markov_(footballer)	playsFor	PFC_Levski_Sofia
Nii_Lamptey	playsFor	R.S.C._Anderlecht
Ricardo_Alves_Pereira	playsFor	Clube_Atlético_Paranaense
Björn_Bergmann_Sigurðarson	playsFor	Iceland_national_under-19_football_team
Zoltán_Fehér	playsFor	Rákospalotai_EAC
Maximilian_Heidenreich	playsFor	SG_Wattenscheid_09
Douglas_Rodrigues_(footballer)	playsFor	Goiás_Esporte_Clube
Mamadou_Samassa_(footballer_born_1986)	playsFor	Olympique_de_Marseille
Grégory_Béranger	wasBornIn	Nice
João_Paulo_da_Silva_Gouveia_Morais	playsFor	Imortal_DC
Tarcisio_Burgnich	playsFor	Juventus_F.C.
Paul_Hartley	playsFor	Millwall_F.C.
Faneva_Imà_Andriatsima	playsFor	US_Créteil-Lusitanos
Mark_Yeates	playsFor	Sheffield_United_F.C.
Paul_Codrea	playsFor	FC_Dinamo_București
Raúl_(footballer)	playsFor	Real_Madrid_C.F.
Michel_Legrand	wroteMusicFor	Les_plus_belles_escroqueries_du_monde
Ivan_Konev	hasWonPrize	Order_of_Lenin
VfL_Wolfsburg	isLocatedIn	Lower_Saxony
Jordan	hasOfficialLanguage	Arabic_language
Boy-Boy_Mosia	playsFor	Oud-Heverlee_Leuven
Douglas_Fairbanks,_Jr.	wasBornIn	New_York_City
Vadym_Panas	playsFor	FC_Karpaty_Lviv
Devon_White_(footballer)	playsFor	Boston_United_F.C.
Miguel_Peirano_(footballer)	playsFor	Peñarol
Craig_Easton	playsFor	Dunfermline_Athletic_F.C.
James_Comrie	playsFor	Reading_F.C.
Héctor_Veira	playsFor	Club_Atlético_Banfield
Mantas_Savėnas	playsFor	FC_Gazovik_Orenburg
Iván_Alonso	playsFor	Club_Atlético_River_Plate_(Montevideo)
Barry_Robson	playsFor	Dundee_United_F.C.
Juanlu_(footballer_born_1980)	playsFor	CD_Numancia
Lajos_Kovács	wasBornIn	Budapest
Frank_McPherson	playsFor	Chesterfield_F.C.
Raymond_Victoria	playsFor	Feyenoord
Jimmy_Nicholson	playsFor	Huddersfield_Town_F.C.
Henry_Gutierrez	playsFor	Miami_Fusion
Andy_McLaren	playsFor	Partick_Thistle_F.C.
Aleksandar_Luković	playsFor	FK_Jedinstvo_Ub
Donald_Knuth	graduatedFrom	California_Institute_of_Technology
Michael_Lejan	playsFor	Alemannia_Aachen
Julio_Salinas	playsFor	Athletic_Bilbao
Michael_Kamen	hasWonPrize	Ivor_Novello_Awards
Gareth_Hopkins_(footballer)	playsFor	Cheltenham_Town_F.C.
David_McCreery	playsFor	Hartlepool_United_F.C.
Flavio_Lazzari	playsFor	Udinese_Calcio
Clint_Bolton	playsFor	Australia_national_under-20_association_football_team
Simon_Francis_(footballer)	playsFor	Charlton_Athletic_F.C.
Jackie_Brown_(footballer)	playsFor	Barry_Town_United_F.C.
Fernando_Leal	playsFor	Ríver_Atlético_Clube
Aziz_Bouderbala	playsFor	Olympique_Lyonnais
Przemysław_Norko	playsFor	Ruch_Chorzów
Boubacar_Diarra	playsFor	Mali_national_football_team
Ian_Woan	playsFor	Barnsley_F.C.
Jorge_Alcalde	playsFor	Peru_national_football_team
Bernhard_Trares	playsFor	Karlsruher_SC
Gary_Smith_(footballer_born_1971)	playsFor	Cowdenbeath_F.C.
Mirko_Oremuš	playsFor	Hapoel_Tel_Aviv_F.C.
Daniel_Webb_(footballer)	playsFor	Dover_Athletic_F.C.
Hossam_Hassan	playsFor	Al-Masry_SC
Hadj_Bouguèche	playsFor	USM_Blida
Saudi_detainees_at_Guantanamo_Bay	playsFor	SC_Freiburg
Karim_Bellarabi	wasBornIn	Berlin
Bojan_Šaranov	playsFor	FK_Bežanija
Andy_Williams_(footballer_born_1962)	playsFor	Port_Vale_F.C.
Yusuf_Soysal	playsFor	Gençlerbirliği_S.K.
Fevzi_Tuncay	playsFor	Beşiktaş_J.K.
Trond_Sollied	playsFor	Vålerenga_Fotball
Juergen_Sommer	playsFor	Luton_Town_F.C.
Robert_Warzycha	playsFor	Columbus_Crew
Marcos_Corrêa_dos_Santos	playsFor	América_Futebol_Clube_(RN)
Lenny_Fernandes_Coelho	playsFor	Fluminense_FC
John_Grant_(English_footballer)	playsFor	Northwich_Victoria_F.C.
Moritz_Leitner	playsFor	TSV_1860_München
Henning_Berg	playsFor	Vålerenga_Fotball
Yang_Chen	playsFor	China_national_football_team
Lukáš_Janič	playsFor	FC_ViOn_Zlaté_Moravce
Miguel_Marcos_Madera	playsFor	Sporting_de_Gijón
Chris_Gunter	playsFor	Wales_national_under-19_football_team
Ilya_Fomitchev	playsFor	TP-47
Brahim_Thiam	playsFor	Red_Star_F.C.
Roel_van_Hemert	playsFor	Waasland-Beveren
Giorgio_Chiellini	playsFor	ACF_Fiorentina
André_Almeida	playsFor	S.L._Benfica
Lorenzo_Rossetti	playsFor	Ravenna_F.C.
Ádám_Simon	playsFor	Szombathelyi_Haladás
Ray_Fränkel	playsFor	Feyenoord
Marc_Pfertzel	playsFor	VfL_Bochum
Willie_Ormond	playsFor	Scotland_national_football_B_team
Leonel_Ríos	playsFor	Asteras_Tripoli_F.C.
John_DeBrito	playsFor	St._Louis_Ambush_(NPSL)
Albert_Einstein	graduatedFrom	University_of_Zurich
David_Steele_(footballer)	playsFor	Bristol_Rovers_F.C.
Aaron_Cook_(footballer)	playsFor	Gosport_Borough_F.C.
André_Simonyi	playsFor	S.C._Covilhã
Anton_Makarenko_(footballer)	playsFor	FC_Energie_Cottbus
Stuart_Lee	playsFor	St._Louis_Steamers_(1979–88)
Branco_(footballer)	playsFor	Clube_de_Regatas_do_Flamengo
Mike_Small_(footballer)	playsFor	West_Ham_United_F.C.
Lewis_Grabban	playsFor	A.F.C._Bournemouth
Michael_Nelson_(footballer)	playsFor	Scunthorpe_United_F.C.
Matías_Cresseri	wasBornIn	Montevideo
Arthur_C._Clarke	hasWonPrize	Nebula_Award
Bogdan_Pătrașcu	playsFor	FC_Dinamo_București
Filipe_Azevedo	playsFor	AEL_Limassol
Guntars_Silagailis	playsFor	SK_Blāzma
Kasper_Schmeichel	playsFor	Cardiff_City_F.C.
André_Ferreira_da_Silva	playsFor	Clube_Atlético_Sorocaba
Ihor_Chuchman	playsFor	FC_Karpaty_Lviv
Peter_Fieber	playsFor	Czechoslovakia_national_football_team
Mons_Ivar_Mjelde	playsFor	SK_Brann
Adilson_Soares_Cassamá	playsFor	C.D._Fátima
Chris_Casement	wasBornIn	Belfast
Alexandru_Bălțoi	playsFor	CF_Brăila
Marcos_Aurélio_Galeano	playsFor	Sertãozinho_Futebol_Clube
Charles_Laughton	actedIn	O._Henry's_Full_House
Alberto_Orlando	wasBornIn	Rome
Zoran_Mijanović	playsFor	FK_Bežanija
Michael_Johnson_(footballer_born_1988)	playsFor	England_national_under-19_football_team
Cheick_Oumar_Dabo	playsFor	Tours_FC
Ned_Beatty	wasBornIn	Louisville,_Kentucky
Dale_Belford	playsFor	Nuneaton_Town_F.C.
Alberto_Méndez_(footballer)	wasBornIn	Nuremberg
Goran_Gavrančić	playsFor	Red_Star_Belgrade
Stefan_Emmerling	playsFor	Hannover_96
Sergei_Hohlov-Simson	playsFor	FC_Flora_Tallinn
Dennis_Wit	playsFor	New_England_Tea_Men
José_Aílton_da_Silva	playsFor	Clube_Atlético_Bragantino
Max_Porter	playsFor	Newport_County_A.F.C.
Careca	playsFor	S.S.C._Napoli
Bart_McGhee	wasBornIn	Edinburgh
Sidney_Moraes	playsFor	São_Paulo_FC
Tanju_Kayhan	playsFor	Beşiktaş_J.K.
Tom_Hanks	actedIn	The_Green_Mile_(film)
Kyung_Hee_University	isLocatedIn	South_Korea
Andrea_Ivan	playsFor	A.C._Siena
Eduardo_Costa	playsFor	Avaí_Futebol_Clube
Matt_Heath	wasBornIn	Leicester
Willy_Aubameyang	wasBornIn	Paris
Andrei_Agius	playsFor	Malta_national_football_team
Izmir	isLocatedIn	Turkey
Mislav_Karoglan	playsFor	HNK_Rijeka
Billy_Whitehurst	playsFor	St_George_FC
Dean_Gordon	playsFor	Torquay_United_F.C.
Kristin_Bengtsson	wasBornIn	Stockholm
Luís_Boa_Morte	playsFor	Chesterfield_F.C.
Roger_Ljung	playsFor	Sweden_national_under-21_football_team
Otto_Szabó	playsFor	Vasas_SC
Nadine_Angerer	playsFor	Djurgårdens_IF_Dam
Frank_Seifert	playsFor	Chemnitzer_FC
Matej_Krajčík	playsFor	MFK_Frýdek-Místek
Douglas_MacArthur	hasWonPrize	Distinguished_Flying_Cross_(United_States)
José_Padrón	playsFor	FC_Barcelona
Alan_A'Court	playsFor	Liverpool_F.C.
Dirk_Lehmann	playsFor	R._White_Daring_Molenbeek
Yao_Junior_Sènaya	playsFor	FC_Basel
James_McEveley	playsFor	England_national_under-21_football_team
Dawid_Kucharski	playsFor	Lech_Poznań
Yoon_Jung-hwan	playsFor	Sagan_Tosu
Marco_Haber	playsFor	UD_Las_Palmas
Walid_Atta	playsFor	GNK_Dinamo_Zagreb
Danijel_Cesarec	playsFor	Asteras_Tripoli_F.C.
Jimmy_Greenhoff	playsFor	Port_Vale_F.C.
Valeriy_Kutsenko	playsFor	Ukraine_national_under-17_football_team
Elliott_Godfrey	playsFor	Boreham_Wood_F.C.
Ihar_Hurynovich	playsFor	Soviet_Union_national_football_team
Marco_Schällibaum	playsFor	Grasshopper_Club_Zürich
Daniel_Orac	playsFor	FC_Steaua_București
Ernst_Mach	isCitizenOf	Austria
Ismael_Sosa	playsFor	Argentinos_Juniors
Terry_Boyle	playsFor	Cardiff_City_F.C.
Frank_Rost	playsFor	Hamburger_SV
Fiachra_McArdle	playsFor	Shamrock_Rovers_F.C.
Morten_Olsen	playsFor	Cercle_Brugge_K.S.V.
Tomer_Hemed	playsFor	Israel_national_under-18_football_team
Paul_Robinson_(footballer,_born_November_1978)	playsFor	Horden_Colliery_Welfare_A.F.C.
Montesquieu	influences	Edmund_Burke
Pleun_Strik	playsFor	Feyenoord
José_Moreno_Mora	playsFor	Club_Atlético_Independiente
Paul_Kessany	playsFor	USM_Libreville
Denilson_Costa	playsFor	C.D._Motagua
Marijan_Kovačević	playsFor	MSV_Duisburg
Sunny_Ekeh_Kingsley	playsFor	Caldas_Sport_Clube
Felipe_Flores	playsFor	Unión_Española
Alejandro_Correa	playsFor	Peñarol
Tim_Jerat	playsFor	Bayer_04_Leverkusen
Lasse_Schöne	playsFor	Denmark_national_under-17_football_team
Marcus_Diniz	playsFor	Esporte_Clube_Vitória
Dan_Counce	playsFor	Toronto_Blizzard_(1971–84)
Oleksandr_Sytnik	playsFor	FC_Hoverla_Uzhhorod
David_Preece_(footballer_born_1976)	playsFor	Sunderland_A.F.C.
Massimo_Mutarelli	playsFor	Genoa_C.F.C.
Marc_Valiente	playsFor	FC_Barcelona_B
Paolo_Foglio	playsFor	U.S._Fiorenzuola_1922
Attila_Katona	playsFor	BFC_Siófok
Michael_Jakobsen	playsFor	Boldklubben_af_1893
Paolo_Bianco	playsFor	U.S._Sassuolo_Calcio
Damian_Spencer	playsFor	Aldershot_Town_F.C.
West_Midlands_(region)	isLocatedIn	Coventry
Jafar_Irismetov	playsFor	FC_Kairat
Karim_Matmour	playsFor	Borussia_Mönchengladbach
Mladen_Krstajić	playsFor	FC_Schalke_04
Fabián_Cancelarich	playsFor	Millonarios_Fútbol_Club
Mate_Dugandžić	playsFor	GNK_Dinamo_Zagreb
Habib_Mohamed	playsFor	Great_Olympics
Andy_Welsh	playsFor	Yeovil_Town_F.C.
Jonathan_Walters	playsFor	Barnsley_F.C.
Neale_Cooper	playsFor	Scotland_national_under-21_football_team
Derek_Decamps	playsFor	Aris_F.C._(Thessaloniki)
University_of_Nebraska–Lincoln	isLocatedIn	United_States
Matt_Kmosko	playsFor	United_States_men's_national_soccer_team
Brian_Close_(footballer)	playsFor	Darlington_F.C.
Christian_Stuani	playsFor	Danubio_F.C.
Eliseu_Pereira_dos_Santos	playsFor	S.S._Lazio
Matt_Moussilou	playsFor	France_national_under-21_football_team
Alessandro_Alessandrì	playsFor	Atletico_Roma_F.C.
Jamie_Waite	playsFor	Woking_F.C.
Simon_Henzler	playsFor	SV_Meppen
Danny_Allsopp	playsFor	Wrexham_F.C.
Mehmed_Baždarević	playsFor	FK_Željezničar_Sarajevo
Bryan_Orritt	playsFor	Wales_national_football_team
Achille_Coser	playsFor	U.C._AlbinoLeffe
Khalid_Sinouh	playsFor	HFC_Haarlem
Kyle_Brown_(soccer)	playsFor	New_England_Revolution
Chris_Hope_(footballer)	playsFor	Rushden_&_Diamonds_F.C.
Lennart_Skoglund	playsFor	AIK_Fotboll
Nicky_Adler	playsFor	1._FC_Nürnberg
Bernie_Slaven	playsFor	Albion_Rovers_F.C.
Moussa_N'Diaye	playsFor	FC_Istres
Paul_Scharner	playsFor	Wigan_Athletic_F.C.
Richard_Brodie_(footballer)	playsFor	Crawley_Town_F.C.
Carlos_Domínguez	playsFor	Spain_national_under-19_football_team
Marco_Pascolo	playsFor	FC_Sion
Cândido_Costa	playsFor	S.C._Braga
Robert_Pintenat	playsFor	Toulouse_FC
Alessandro_Budel	playsFor	Genoa_C.F.C.
Antonio_Giosa	playsFor	Vicenza_Calcio
Rashid_Yussuff	playsFor	Charlton_Athletic_F.C.
Synan_Braddish	playsFor	Longford_Town_F.C.
Abdelhafid_Tasfaout	playsFor	MC_Oran
Ousmane_Sanou	playsFor	Willem_II_(football_club)
Ervin_Bulku	playsFor	AZAL_PFK
Kurt_Gödel	isCitizenOf	Austria-Hungary
Aleksandar_Čanović	playsFor	FK_BASK
Steve_Horvat	playsFor	Carlton_S.C.
Aytaç_Ak	playsFor	Turkey_national_youth_football_team
Sandro_Manoel_dos_Santos	playsFor	Betim_Esporte_Clube
Joseph_Ujlaki	playsFor	AS_Aix
Mick_Galloway	playsFor	Worksop_Town_F.C.
Gábor_Torma	playsFor	Zalaegerszegi_TE
Luis_Monti	playsFor	Italy_national_football_team
Ríkharður_Daðason	playsFor	Viking_FK
Federico_Lussenhoff	playsFor	Club_Atlético_Colón
Gustavo_Fuentes	playsFor	Talleres_de_Córdoba
David_Steele_(footballer)	playsFor	St._Mirren_F.C.
Alexandro_Alves_Ferreira	playsFor	Denizlispor
Talal_Khalfan	playsFor	Muscat_Club
Geoff_Horsfield	playsFor	Halifax_Town_A.F.C.
Ashley_Ward	playsFor	Sheffield_United_F.C.
Karim_Zaza	playsFor	Rot-Weiss_Essen
Cristiano_Pereira_de_Souza	playsFor	Ulsan_Hyundai_FC
Luc_Nilis	playsFor	K.R.C._Genk
Rodrigo_Fernandes_Alflen	playsFor	Clube_Atlético_Paranaense
Lee_Hodges_(footballer,_born_1978)	playsFor	Thurrock_F.C.
Nathan_Doyle	playsFor	England_national_under-16_football_team
Denis_Kiselyov	playsFor	FC_Zenit_Penza
Simon_Osborn	playsFor	Queens_Park_Rangers_F.C.
Frank_Broome	playsFor	Brentford_F.C.
Rafael_Vágner_Dias_Silva	playsFor	Clube_Atlético_Mineiro
Eoin_Hand	wasBornIn	Dublin
Dirk_Lehmann	wasBornIn	Aachen
Erik_Paartalu	playsFor	Parramatta_FC
Gianni_Guigou	playsFor	A.C.D._Treviso_2013
Everton_Giovanella	playsFor	UD_Salamanca
Curtis_Woodhouse	playsFor	Eastwood_Town_F.C.
Iago_Iglesias	playsFor	Valencia_CF_Mestalla
Serhiy_Danylovskyi	playsFor	Ukraine_national_under-21_football_team
Phil_Kite	playsFor	Cardiff_City_F.C.
Serdar_Kesimal	playsFor	Turkey_national_under-20_football_team
Ryan_Semple_(footballer_born_1985)	playsFor	Boston_United_F.C.
Craig_Ireland	playsFor	Dundee_F.C.
Adrian_Forbes	playsFor	Grimsby_Town_F.C.
Thomas_Gill_(footballer)	playsFor	F.C._Copenhagen
Jader_Volnei_Spindler	playsFor	Grêmio_Foot-Ball_Porto_Alegrense
Peter_Madsen	playsFor	Southampton_F.C.
Mark_Švets	playsFor	FC_Levadia_Tallinn
