Ramón_da_Silva_Ramos	playsFor	Sport_Club_Internacional
Srđan_Mrkušić	playsFor	HNK_Hajduk_Split
Blaise_Pascal	influences	G._K._Chesterton
Saktiawan_Sinaga	playsFor	Indonesia_national_football_team
José_Antonio_Reyes	playsFor	Sevilla_FC
Guy_Bates	playsFor	Darlington_F.C.
Bannered_routes_of_U.S._Route_66	isLocatedIn	St._Louis
Gordon_Cowans	playsFor	Bradford_City_A.F.C.
David_Barnes_(footballer)	playsFor	Watford_F.C.
Edgar_Aguilera	playsFor	Cerro_Porteño
Aleksandre_Kobakhidze	playsFor	Belarus_national_football_team
Francisco_Valdés	hasGender	male
Nick_Dasovic	playsFor	Stade_Briochin
Jorge_Francisco_Vargas	playsFor	Empoli_F.C.
Natalio_Lorenzo_Poquet	hasGender	male
Roy_Wegerle	playsFor	Arcadia_Shepherds_F.C.
Rubén_Epitié_Dyowe	playsFor	CD_Logroñés
Ghandi_Kassenu	playsFor	Ghana_national_under-17_football_team
Jean-Alain_Fanchone	hasGender	male
Igor_Simutenkov	playsFor	Sporting_Kansas_City
Yassir_Raad	playsFor	Erbil_SC
Thompson_Usiyan	playsFor	Tulsa_Roughnecks_(1978–84)
Server_Djeparov	playsFor	Pakhtakor_Tashkent_FK
Jamie_McMaster	playsFor	Peterborough_United_F.C.
Henry_León	playsFor	Barcelona_Sporting_Club
José_Javier_Barkero	playsFor	Spain_national_under-20_football_team
VfB_Lübeck	isLocatedIn	Lübeck
Tibor_Pomper	playsFor	BVSC_Budapest
Miguel_Zepeda	playsFor	Deportivo_Toluca_F.C.
Isnan_Ali	playsFor	Persib_Bandung
Aluísio_da_Silva_Neves_Júnior	playsFor	Paysandu_Sport_Club
William_Thomson,_1st_Baron_Kelvin	influences	Henry_Adams
Massimo_Carrera	playsFor	Juventus_F.C.
Bernie_Wright	playsFor	Gloucester_City_A.F.C.
Roberto_Ayala	playsFor	Real_Zaragoza
Darryl_Powell	playsFor	Portsmouth_F.C.
Artūras_Rimkevičius	playsFor	Asteras_Tripoli_F.C.
Andy_Jones_(footballer)	playsFor	Port_Vale_F.C.
Schumacher_(footballer)	playsFor	SK_Austria_Kärnten
Anderson_Marcelo_da_Silva	playsFor	Asteras_Tripoli_F.C.
Ian_Harte	playsFor	Sunderland_A.F.C.
Fabrizio_Ferron	playsFor	Inter_Milan
Scott_McGleish	playsFor	Charlton_Athletic_F.C.
Andreas_Biermann	playsFor	Hertha_BSC_II
Daniel_Ginczek	playsFor	Germany_national_youth_football_team
Eiji_Kawashima	playsFor	Japan_national_under-20_football_team
Roberto_Martínez	playsFor	Walsall_F.C.
Kader_Mangane	playsFor	Stade_Rennais_F.C.
Norbert_Wiener	isCitizenOf	United_States
Giorgi_Oniani	hasGender	male
Mario_Gómez	playsFor	Germany_national_youth_football_team
Moses_Ashikodi	playsFor	England_national_under-18_football_team
Jamie_McCluskey	playsFor	Forfar_Athletic_F.C.
Horst_Heldt	playsFor	Germany_national_football_team
Benjamin_Gavanon	playsFor	Nottingham_Forest_F.C.
Amadou_Touré	playsFor	ASFA_Yennenga
Stéphane_Pichot	playsFor	Paris_Saint-Germain_F.C.
Zoltán_Nagy_(footballer_born_1974)	playsFor	Alki_Larnaca_F.C.
Zlatko_Yankov	playsFor	Bulgaria_national_football_team
Burundi	dealsWith	India
Modesto,_California	isLocatedIn	United_States
Peter_Sarantopoulos	playsFor	Toronto_Rockets
Gerry_Kelly_(footballer)	diedIn	Luton
Tomasz_Hajto	playsFor	Hutnik_Nowa_Huta
Samir_Bertin_d'Avesnes	playsFor	AS_Beauvais_Oise
Mileta_Radulović	playsFor	FK_Budućnost_Podgorica
Kees_Krijgh	playsFor	Willem_II_(football_club)
Hadi_Asghari	playsFor	F.C._Aboomoslem
Cape_Verde	imports	wordnet_foodstuff_107566340
Daniyel_Cimen	playsFor	FC_Erzgebirge_Aue
Elia_Legati	playsFor	A.S.D._Legnano_Calcio_1913
Martin_Vunk	playsFor	FC_Warrior_Valga
Asa_Charlton	playsFor	Halesowen_Town_F.C.
Gary_McSwegan	playsFor	Inverness_Caledonian_Thistle_F.C.
Istanbul	isLocatedIn	Asia
Josico	playsFor	UD_Las_Palmas
Ștefan_Apostol	playsFor	FCM_Bacău
Eugen_Neagoe	playsFor	Veria_F.C.
Reinaldo_José_da_Silva	playsFor	Paysandu_Sport_Club
Charles_Sanders_Peirce	influences	Ferdinand_de_Saussure
Madson_Formagini_Caridade	playsFor	Al-Khor_Sports_Club
Mohamed_Chalali	playsFor	Aberdeen_F.C.
Rógvi_Jacobsen	playsFor	Havnar_Bóltfelag
Phil_Alexander	playsFor	Kingstonian_F.C.
Paul_Millar	playsFor	Cardiff_City_F.C.
Mülayim_Erdem	hasGender	male
Elbekay_Bouchiba	playsFor	Al-Wakrah_Sport_Club
Luis_Monti	playsFor	Italy_national_football_team
Paul_Smith_(footballer_born_22_January_1976)	playsFor	Hartlepool_United_F.C.
Oleh_Ostapenko	playsFor	FC_Banants
Nonato	playsFor	Tuna_Luso_Brasileira
Christian_Pouga	playsFor	C.S._Marítimo
Michael_Mutzel	playsFor	VfB_Stuttgart_II
Dennis_Schmidt_(footballer)	playsFor	VfL_Osnabrück
Leopold_Infeld	livesIn	United_States
Kevin_Hector	playsFor	Burton_Albion_F.C.
Herbert_Waas	playsFor	Dynamo_Dresden
Jaime_Miguel_Linares	playsFor	SC_Vila_Real
Ramón_Víctor_Castro	playsFor	Textil_Mandiyú
Daniele_Amerini	playsFor	Vicenza_Calcio
José_Filho_Duarte	playsFor	Hapoel_Be'er_Sheva_F.C.
NATO_bombing_of_Yugoslavia	isLocatedIn	Kosovo
Jorge_Luis_da_Silva_Brum	playsFor	Londrina_Esporte_Clube
Michael_Langer	playsFor	VfB_Stuttgart_II
Paddy_McCourt	playsFor	Shamrock_Rovers_F.C.
System_of_Cooperation_Among_the_American_Air_Forces	isLocatedIn	Guatemala
Sigmund_Freud	influences	André_Breton
Rubinho_(footballer)	playsFor	A.S._Livorno_Calcio
Second_Northern_War	happenedIn	Central_Europe
Saša_Janić	playsFor	SpVgg_Ludwigsburg
Diego_Costa	playsFor	F.C._Penafiel
Rodrigo_Astudillo	playsFor	San_Lorenzo_de_Almagro
Roland_Wohlfarth	playsFor	FC_Bayern_Munich
Loukima_Tamoukini	playsFor	F.C._Maia
Jorge_Luis_Borges	influences	Mircea_Cărtărescu
Nathan_Coe	playsFor	PSV_Eindhoven
Alexander_Baumjohann	playsFor	FC_Bayern_Munich_II
Magaye_Gueye	playsFor	France_national_under-19_football_team
Leandro_Bernardi_Silva	playsFor	Daegu_FC
Levan_Mikadze	playsFor	FC_Dinamo_Zugdidi
Humberto_Maschio	hasGender	male
Mark_Albrighton	playsFor	Chester_City_F.C.
Miroslav_Savanović	playsFor	FK_Mladi_Radnik
Walter_Caprile	playsFor	Juventud_de_Las_Piedras
Miodrag_Anđelković	playsFor	Coritiba_Foot_Ball_Club
Radosav_Bulić	playsFor	FK_Radnički_Obrenovac
Jermaine_Jones	playsFor	Germany_national_football_team
Jhon_Viáfara	playsFor	Colombia_national_football_team
Nikos_Pantidos	playsFor	Panathinaikos_F.C.
Vitaly_Daraselia_(footballer_born_1978)	playsFor	Dinamo_Tbilisi
Joel_Theissen	playsFor	Sydney_FC
Vadym_Panas	playsFor	FC_Lviv
Sandro_Tomić	playsFor	NK_Imotski
Hans-Jörg_Butt	hasGender	male
Drissa_Diallo	playsFor	Sheffield_Wednesday_F.C.
Haruna_Babangida	playsFor	Apollon_Limassol
Claudio_Biaggio	playsFor	Estudiantes_de_Río_Cuarto
Mauricio_Donoso	playsFor	Club_Universidad_Nacional
Neill_Collins	playsFor	Sheffield_United_F.C.
Gordon_Kljestan	playsFor	Cleveland_City_Stars
Kakha_Kaladze	playsFor	Genoa_C.F.C.
Joseph_Laumann	playsFor	FC_Rot-Weiß_Erfurt
Oleksiy_Yakymenko	playsFor	FC_Vorskla_Poltava
Gary_Megson	playsFor	Norwich_City_F.C.
Ian_Woan	playsFor	Runcorn_F.C._Halton
Kraikiat_Beadtaku	playsFor	BEC_Tero_Sasana_F.C.
Paulo_Costa_(footballer)	playsFor	Aris_Limassol_F.C.
Alexander_Hleb	playsFor	FC_Dinamo-Juni_Minsk
Johnson_Monteiro_Pinto_Macaba	playsFor	Goiás_Esporte_Clube
Lee_Jenkins	playsFor	Kidderminster_Harriers_F.C.
Rivaldo_González	playsFor	A.S._Gubbio_1910
Juan_Pablo_Raponi	playsFor	Club_Atlético_River_Plate
Walter_Henrique_da_Silva	playsFor	Fluminense_FC
Iacopo_La_Rocca	hasGender	male
Catanha	playsFor	Marília_Atlético_Clube
Christian_Abbiati	playsFor	Italy_national_football_team
Esteban_Solari	playsFor	Estudiantes_de_La_Plata
Jon_Conway	playsFor	Chivas_USA
Willie_Fagan	hasGender	male
Simon_Bræmer	playsFor	Silkeborg_IF
Jordi_Lardín	hasGender	male
Marian_Damaschin	playsFor	Feyenoord
Nemanja_Pejčinović	playsFor	OGC_Nice
Wes_Daly	playsFor	Raith_Rovers_F.C.
Giovanni_Morabito	playsFor	A.C._Cesena
Ranko_Despotović	playsFor	UD_Salamanca
Branko_Lazarević	playsFor	OFK_Kikinda
Paddy_McCourt	playsFor	Celtic_F.C.
Liédson	hasGender	male
Tampereen_Pallo-Veikot	isLocatedIn	Tampere
Romas_Dressler	playsFor	SpVgg_Greuther_Fürth_II
Andrés_Lamas	hasGender	male
Velimir_Naumović	playsFor	Stade_Rennais_F.C.
Long_Beach,_California	isLocatedIn	Long_Beach
Oscar_Wilde	influences	Mateiu_Caragiale
John_Durnin	playsFor	Port_Vale_F.C.
Jean-Paul_Sartre	influences	Pierre_Bourdieu
Luxembourg	participatedIn	Western_Front_(World_War_II)
Ivan_Trabalík	playsFor	Aris_Limassol_F.C.
Pablo_Brenes	playsFor	Brujas_F.C.
Jens_Rasiejewski	playsFor	Eintracht_Frankfurt
Henry_White_(footballer)	hasGender	male
Gary_Brabin	playsFor	Bury_F.C.
Emmanuel_Mathias	playsFor	Heartland_F.C.
Adrian_Neaga	playsFor	Jeonnam_Dragons
Václav_Pilař	playsFor	FC_Hradec_Králové
Jimmy_Dunne_(footballer_born_1935)	playsFor	Cambridge_United_F.C.
Antonin_Koutouan	playsFor	Baniyas_SC
Hiroshi_Ibusuki	playsFor	Sevilla_FC
Imants_Bleidelis	playsFor	Southampton_F.C.
Andy_Ferrell	playsFor	York_City_F.C.
Alexander_Medina	playsFor	Liverpool_F.C._(Montevideo)
Norway	dealsWith	Germany
Heinz_Hermann	playsFor	Switzerland_national_football_team
Mark_Taylor_(footballer_born_1966)	playsFor	Bromsgrove_Rovers_F.C.
Oğuz_Sabankay	playsFor	Eskişehirspor
Chris_Beardsley	playsFor	Doncaster_Rovers_F.C.
Marshall_Soper	playsFor	Perak_FA
Dougie_Bell	playsFor	Hibernian_F.C.
Rafael_Dudamel	playsFor	Deportivo_Cali
Ivan_Leko	playsFor	HNK_Trogir
Jiří_Koubský	playsFor	FC_Fastav_Zlín
Ryan_Harley	playsFor	Weston-super-Mare_A.F.C.
Justo_Ruiz	playsFor	FC_Andorra
Siege_of_Malta_(World_War_II)	happenedIn	Malta
Steve_Watson	playsFor	Aston_Villa_F.C.
Andrea_Barzagli	playsFor	S.S.D._Piacenza_Calcio_1919
Mark_Cooper_(footballer_born_1968)	playsFor	Southend_United_F.C.
Erik_Kuld_Jensen	playsFor	Lille_OSC
George_Shaw_(footballer_born_1899)	playsFor	Doncaster_Rovers_F.C.
Henrik_Ojamaa	playsFor	Estonia_national_under-19_football_team
Martín_Palermo	playsFor	Real_Betis
Azubuike_Oliseh	playsFor	R.S.C._Anderlecht
Uğur_Yıldırım	playsFor	Netherlands_national_football_team
Yannick_Rott	playsFor	Étoile_Fréjus_Saint-Raphaël
Alexandre_Boucicaut	playsFor	Independiente_Santa_Fe
Marama_Vahirua	playsFor	FC_Lorient
John_Nutter	playsFor	Lincoln_City_F.C.
Jim_Hamilton_(footballer)	playsFor	Ross_County_F.C.
Juma_Mossi	playsFor	Dubai_CSC
Freddy_Rincón	playsFor	Sport_Club_Corinthians_Paulista
Kjetil_Rekdal	playsFor	Stade_Rennais_F.C.
Iago_Iglesias	playsFor	Valencia_CF_Mestalla
Kris_Stadsgaard	playsFor	Málaga_CF
Márcio_Amoroso	playsFor	Grêmio_Foot-Ball_Porto_Alegrense
Wes_Hoolahan	playsFor	Norwich_City_F.C.
Marko_Ilić	playsFor	PFC_Botev_Plovdiv
Matías_Urbano	playsFor	Cúcuta_Deportivo
Mustafa_Kocabey	playsFor	Samsunspor
Jean-Pierre_Serre	livesIn	Paris
Murat_Tleshev	playsFor	Kazakhstan_national_football_team
Dekel_Keinan	playsFor	Israel_national_football_team
Danny_Koevermans	playsFor	Toronto_FC
Branimir_Subašić	playsFor	FC_Amkar_Perm
Kerim_Zengin	hasGender	male
Craig_Bellamy	playsFor	Liverpool_F.C.
Davide_Baiocco	playsFor	Calcio_Catania
Fan_Weijun	playsFor	Shanghai_United_F.C.
Charles_Gbeke	playsFor	Herfølge_Boldklub
Richard_Vanigli	playsFor	A.C._Milan
Branislav_Obžera	playsFor	ŠK_Slovan_Bratislava
Henry_II_of_England	playsFor	S.C._Braga
Antonio_Domingo_Rojas_Melero	playsFor	CD_Ourense
Vincent_Ehouman	playsFor	CA_Paris-Charenton
Australia	participatedIn	Italian_Campaign_(World_War_II)
Bruno_Berner	playsFor	SC_Freiburg
Mourad_Meghni	playsFor	Al-Khor_Sports_Club
Francesco_Coco	playsFor	A.C._Milan
Cyril_Jeunechamp	playsFor	Montpellier_HSC
Kevin_Sharp_(footballer)	playsFor	Hamilton_Academical_F.C.
Gareth_Jelleyman	playsFor	Peterborough_United_F.C.
Vladimir_Mukhanov	playsFor	FC_Arsenal_Tula
Mourad_Meghni	playsFor	Clairefontaine
Davide_Marchini	playsFor	Unione_Triestina_2012_S.S.D.
Tommy_Knarvik	playsFor	Sogndal_Fotball
Ante_Razov	playsFor	LA_Galaxy
José_Emilio_Amavisca	playsFor	RCD_Espanyol
David_Zdrilic	playsFor	Aberdeen_F.C.
Pyotr_Kachura	playsFor	FC_Dinamo_Minsk
José_Juan_Luque	playsFor	Granada_74_CF
Vlada_Stošić	playsFor	Yugoslavia_national_football_team
Vsevolod_Romanenko	playsFor	FC_Prykarpattya_Ivano-Frankivsk
Erwin_Romero	playsFor	Club_Blooming
Synan_Braddish	playsFor	Drogheda_United_F.C.
Jonatan_Berg	playsFor	GAIS
Miloš_Krško	playsFor	MŠK_Žilina
Zsolt_Petry	playsFor	SV_Babelsberg_03
Alan_Ainscow	playsFor	Rochdale_A.F.C.
François_Brisson	playsFor	RC_Lens
Ruberth_Morán	playsFor	Venezuela_national_football_team
Nenad_Stojković	playsFor	FK_Partizan
Lars_Lunde	playsFor	FC_Baden
Adriano_Basso	playsFor	Wolverhampton_Wanderers_F.C.
Pierre-Rudolph_Mayard	hasGender	male
Bohemians_1905	isLocatedIn	Prague
Dylan_Hughes	playsFor	SSV_Jahn_Regensburg
Alan_Waddle	playsFor	Hartlepool_United_F.C.
Rolland_Courbis	playsFor	Olympique_de_Marseille
Brian_Etheridge_(footballer)	playsFor	Northampton_Town_F.C.
J._Wiley_Edmands	playsFor	Colombia_national_football_team
Marcos_Antonio_Aparecido_Cipriano	playsFor	Guarani_Futebol_Clube
Mario_Kirev	hasGender	male
Oscar_Más	playsFor	Club_Atlético_Sarmiento
Mike_Hanke	hasGender	male
Douglas_Galvão_Silva	playsFor	Grêmio_Esportivo_Brasil
Fausto_Pizzi	playsFor	Genoa_C.F.C.
Damián_Escudero	hasGender	male
Ahmed_Reda_Madouni	playsFor	FC_Energie_Cottbus
Nicklas_Bendtner	playsFor	Denmark_national_under-19_football_team
Winston_Bogarde	playsFor	A.C._Milan
Emerse_Faé	playsFor	FC_Nantes
Cologne_Bonn_Airport	isLocatedIn	North_Rhine-Westphalia
Neil_Martin	playsFor	Scotland_national_football_team
Tomáš_Pospíchal	playsFor	FC_Rouen
Abel_Aguilar	playsFor	Real_Zaragoza
José_Paulo_dos_Santos	playsFor	Paraná_Clube
Albeiro_Usuriaga	playsFor	Barcelona_Sporting_Club
Adam_Grad	playsFor	GKS_Tychy
José_Carlos_Ferreira_Filho	playsFor	Changchun_Yatai_F.C.
Arif_İsayev	playsFor	FK_Gänclärbirliyi_Sumqayit
Luis_Manuel_Seijas	playsFor	Deportivo_Quito
Andrei_Karyaka	playsFor	Russia_national_football_team
Ernest_King	playsFor	Celtic_F.C.
Dušan_Brković	playsFor	Serbia_national_under-19_football_team
Pat_Morrissey	playsFor	Wigan_Athletic_F.C.
Oscar_Alberto_Ortiz	playsFor	Grêmio_Foot-Ball_Porto_Alegrense
Lumír_Sedláček	playsFor	Polonia_Warsaw
Dyron_Daal	hasGender	male
Manfred_Linzmaier	playsFor	Austria_national_football_team
Miklós_Gaál	playsFor	Újpest_FC
Josef_Schneider_(footballer)	playsFor	Olympique_Alès
Giovanni_Federico	hasGender	male
Thiago_Gentil	playsFor	Aris_F.C._(Thessaloniki)
Elpídio_Silva	playsFor	Suwon_Samsung_Bluewings
Fabrice_Fiorèse	playsFor	Amiens_SC
Waldir_Peres	playsFor	São_Paulo_FC
Sercan_Güvenışık	playsFor	MSV_Duisburg
Steve_Robinson_(English_footballer)	playsFor	Peterborough_United_F.C.
Zbigniew_Gut	playsFor	Red_Star_F.C.
Tayfun_Seven	playsFor	Turkey_national_youth_football_team
Hamka_Hamzah	playsFor	Persik_Kediri
Danny_Shittu	playsFor	Charlton_Athletic_F.C.
Emir_Hadžić	playsFor	FK_Željezničar_Sarajevo
Itzik_Kornfein	playsFor	Hapoel_Jerusalem_F.C.
Evgheni_Hmaruc	playsFor	FC_Nistru_Otaci
Carlos_Alberto_de_Jesus	playsFor	Goiás_Esporte_Clube
Neil_Woods	playsFor	Southport_F.C.
José_Carvallo	playsFor	D.C._United
Bruno_Silva	playsFor	FC_Groningen
Maniche	playsFor	Atlético_Madrid
Levent_Osman	playsFor	Tampere_United
Gurban_Gurbanov	playsFor	FC_Fakel_Voronezh
Ben_Foster_(footballer)	playsFor	Kidderminster_Harriers_F.C.
Diogo_de_Lima_Barcelos	playsFor	Betim_Esporte_Clube
Ashkan_Dejagah	playsFor	Tennis_Borussia_Berlin
Nicolás_Muñoz	playsFor	Envigado_F.C.
Radomir_Đalović	playsFor	FK_Jedinstvo_Bijelo_Polje
Gabriel_Garcete	playsFor	C.D._Universidad_de_El_Salvador
Massimo_Gotti	playsFor	Udinese_Calcio
Gordon_Smith_(footballer_born_September_1954)	hasGender	male
Ryan_Salazar	playsFor	Alianza_Lima
Federico_Capece	playsFor	Club_Atlético_Tigre
José_Nunes	playsFor	Gil_Vicente_F.C.
Eugen_Polanski	playsFor	Poland_national_football_team
Jancarlos_de_Oliveira_Barros	playsFor	Rio_Branco_Atlético_Clube
Nicolás_Diez	playsFor	O'Higgins_F.C.
Rugby_Town_F.C.	isLocatedIn	Warwickshire
Patrick_Ghigani	playsFor	SpVgg_Unterhaching
Branislav_Vukomanović	playsFor	FC_Farul_Constanța
Julio_César_Yegros	playsFor	Cruz_Azul_Hidalgo
Bryan_Hodge	playsFor	Millwall_F.C.
Petter_Andersson	playsFor	FC_Groningen
Lasha_Jakobia	playsFor	FC_Rapid_București
Richard_Knopper	playsFor	Haaglandia
Chad_Bond	playsFor	Wales_national_semi-professional_football_team
Lee_Warren	playsFor	Stocksbridge_Park_Steels_F.C.
Tomislav_Dujmović	playsFor	NK_Međimurje
Wilson_Constantino_Novo_Estrela	playsFor	Angola_national_football_team
Pape_Sarr	playsFor	Paris_FC
Clemerson_de_Araújo_Soares	playsFor	Clube_Atlético_do_Porto
Igor_Sklyarov	playsFor	FC_Taganrog
Paul_Conway_(soccer)	playsFor	Portland_Timbers_(1985–90)
Duccio_Innocenti	playsFor	A.C.R._Messina
James_Chamanga	playsFor	Zambia_national_football_team
Danny_Murphy_(footballer,_born_1977)	playsFor	Blackburn_Rovers_F.C.
Gaston_Bachelard	influences	Paul_Feyerabend
Oğuz_Sabankay	playsFor	Bucaspor
Fabrice_Begeorgi	playsFor	FC_Istres
Kid_Rock	hasMusicalRole	wordnet_synthesist_110687231
Daniel_Xuereb	hasGender	male
Bangkok_Glass_F.C.	isLocatedIn	Bangkok
Philip_Mulryne	playsFor	Leyton_Orient_F.C.
Jamie_Waite	playsFor	Doncaster_Rovers_F.C.
Aleksandar_Mladenov	playsFor	FC_Etar_1924_Veliko_Tarnovo
Olivier_Boumelaha	playsFor	Tampereen_Peli-Pojat-70
Juliano_de_Andrade	hasGender	male
Simone_Grippo	playsFor	A.C._Lumezzane
Víctor_Herrera_Piggott	playsFor	Millonarios_Fútbol_Club
Franco_Mendoza	playsFor	Club_Sport_Emelec
Georgi_Chilikov	hasGender	male
Jon_Beswetherick	playsFor	Paulton_Rovers_F.C.
Selahattin_Kınalı	hasGender	male
Wayne_Gray_(footballer)	playsFor	Brighton_&_Hove_Albion_F.C.
Liam_Lawrence	hasGender	male
Emilio_Nsue	playsFor	Real_Sociedad
Herculez_Gomez	playsFor	LA_Galaxy
Christos_Melissis	playsFor	Panserraikos_F.C.
Narcisse_Yaméogo	playsFor	G.D._Ribeirão
Battle_of_the_Lys_(1918)	happenedIn	Belgium
Modestas_Stonys	playsFor	JK_Narva_Trans
Choi_Chul-woo	playsFor	Busan_IPark
Jozef_Vliers	playsFor	K.S.K._Tongeren
Maynor_Figueroa	playsFor	Honduras_national_under-23_football_team
Yanko_Sandanski	playsFor	PFC_Slavia_Sofia
Patrik_Ježek	playsFor	Karlsruher_SC
Ahmed_Reda_Madouni	playsFor	AS_Saint-Priest
Steven_Morris	playsFor	C.D._Marathón
Luke_Corbett	playsFor	Mangotsfield_United_F.C.
Carlos_Carneiro_(footballer)	playsFor	F.C._Paços_de_Ferreira
Bratislav_Ristić	playsFor	FK_Rad
Željko_Pavlović	playsFor	GNK_Dinamo_Zagreb
Bryan_Gilfillan	playsFor	Cowdenbeath_F.C.
Joseph_Cornell	influences	William_Gibson
Tommy_Wright_(footballer,_born_1984)	playsFor	Forest_Green_Rovers_F.C.
Jamie_Brooks_(footballer)	playsFor	Didcot_Town_F.C.
Fabrizio_Biava	playsFor	S.S.D._Acireale_Calcio_1946
Guido_Buchwald	playsFor	Karlsruher_SC
Don_Heath	playsFor	Norwich_City_F.C.
Avi_Tikva	playsFor	Israel_national_football_team
Rodrigo_Baldasso_da_Costa	playsFor	Goiás_Esporte_Clube
Milan_Jovanović_(footballer_born_1983)	playsFor	Red_Star_Belgrade
Mahamat_Hissein	playsFor	AS_Moulins
Maroš_Klimpl	playsFor	FC_Baník_Ostrava
Filippo_Carobbio	hasGender	male
Balkans_Campaign_(World_War_I)	happenedIn	Kingdom_of_Romania
Jérémie_Bréchet	playsFor	Olympique_Lyonnais
Gábor_Vayer	playsFor	Digenis_Akritas_Morphou
Alfred_North_Whitehead	influences	Willard_Van_Orman_Quine
Karen_Aleksanyan	playsFor	FC_Banants
Hicham_Mahdoufi	playsFor	Raja_Casablanca
Nils_Petersen	playsFor	Germany_national_under-21_football_team
John_Bramhall_(footballer)	hasGender	male
Maxi_Biancucchi	playsFor	Tacuary
Devran_Ayhan	playsFor	Batman_Petrolspor
Mehmet_Topal	playsFor	Dardanel_Spor_A.Ş.
Zlatko_Arambasic	playsFor	Bankstown_Berries_FC
Tjalling_Koopmans	influences	Leonid_Hurwicz
Chris_Waddle	playsFor	Tow_Law_Town_A.F.C.
Rodrigo_Juliano_Lopes_de_Almeida	playsFor	Sociedade_Esportiva_do_Gama
Sebastián_Ariel_Romero	playsFor	Quilmes_Atlético_Club
Ronnie_Ekelund	playsFor	Southampton_F.C.
Jean_Bouli	playsFor	FC_Luch-Energiya_Vladivostok
Oļegs_Karavajevs	playsFor	FSV_Zwickau
Danny_Alcock	playsFor	Nuneaton_Town_F.C.
Julien_Escudé	playsFor	AFC_Ajax
Brian_Rowland	playsFor	Halifax_Town_A.F.C.
Aleksandr_Filimonov	playsFor	FC_Tekstilshchik_Kamyshin
David_Lee_(footballer_born_1967)	playsFor	Carlisle_United_F.C.
Daniel_Aquino_Pintos	playsFor	Atlético_Madrid_C
Miloš_Milutinović	diedIn	Belgrade
Mohamed_Hubail	playsFor	Al-Gharafa_Sports_Club
Jamal_Campbell-Ryce	playsFor	Sheffield_United_F.C.
Ilian_Kiriakov	playsFor	FC_Etar_1924_Veliko_Tarnovo
Muscal_Mvuezolo	playsFor	DR_Congo_national_football_team
Éric_Mura	playsFor	LB_Châteauroux
Gabriel_Ferrari	playsFor	A.C._Perugia_Calcio
Ilie_Stan	playsFor	Romania_national_football_team
Ahmet_Görkem_Görk	playsFor	Adanaspor
Darío_Silva	playsFor	Peñarol
Des_Hamilton	playsFor	Huddersfield_Town_F.C.
Francesco_Coco	playsFor	Torino_F.C.
César_Cervo_Luca	hasGender	male
Paul_Simpson_(footballer)	playsFor	Blackpool_F.C.
Wayne_Henderson_(footballer)	playsFor	Brighton_&_Hove_Albion_F.C.
Eduardas_Kurskis	playsFor	FC_Smorgon
China	dealsWith	United_States
Jamie_Forrester	playsFor	Lincoln_Moorlands_Railway_F.C.
Wellington_Luís_de_Sousa	playsFor	Clube_Náutico_Capibaribe
José_Antônio_Martins_Galvão	playsFor	Esporte_Clube_Bahia
Bačka	isLocatedIn	Europe
Mikheil_Khutsishvili	hasGender	male
Wilf_Grant	hasGender	male
Gonzalo_Vargas	hasGender	male
Aurel_Țicleanu	playsFor	FC_Sportul_Studențesc_București
Barry_Endean	playsFor	Charlton_Athletic_F.C.
Víctor_Ormazábal	playsFor	Pontevedra_CF
Astrit_Ajdarević	playsFor	Falkenbergs_FF
Ali_El-Omari	playsFor	Apollon_Kalamarias
Federico_Sacchi	playsFor	Newell's_Old_Boys
Mark_Hughes_(Northern_Ireland_footballer)	playsFor	Chester_City_F.C.
Colin_Marrison	playsFor	Sheffield_United_F.C.
Vesko_Mihajlović	playsFor	Anorthosis_Famagusta_FC
Martin_Hansen	playsFor	Denmark_national_under-17_football_team
Marlon_Harewood	playsFor	FC_Haka
Moussa_Kaboré	playsFor	KF_Bylis_Ballsh
Paulo_César_Rocha_Rosa	hasGender	male
Marcos_Mondaini	playsFor	Atlético_Nacional
Leandro_Bernardi_Silva	playsFor	Centro_Sportivo_Alagoano
Julian_Joachim	playsFor	Boston_United_F.C.
Edder_Vaca	playsFor	LDU_Portoviejo
Robert_Kolendowicz	playsFor	Pogoń_Szczecin
Javier_Muñoz_Mustafá	playsFor	CD_Tenerife
Luis_Alonso_Sandoval	playsFor	Club_Atlas
Ned_Grabavoy	playsFor	Columbus_Crew
Leonson_Lewis	playsFor	Associação_Académica_de_Coimbra_–_O.A.F.
Laos	isLocatedIn	Southeast_Asia
Jason_Beardsley	playsFor	Notts_County_F.C.
Marko_Muslin	playsFor	FC_Lausanne-Sport
Nuno_Gomes	playsFor	S.L._Benfica
Wendel_Raul_Gonçalves_Gomes	hasGender	male
Dušan_Mihajlović_(footballer)	hasGender	male
Nelson_Benítez	playsFor	Club_Atlético_Lanús
Javier_Casquero	playsFor	Getafe_CF
Emad_Mohammed	playsFor	Sepahan_Isfahan_F.C.
Bernt_Haas	playsFor	Grasshopper_Club_Zürich
Constantin_Schumacher	playsFor	Romania_national_football_team
Hugo_Viana	playsFor	Gil_Vicente_F.C.
Malaysia	dealsWith	Singapore
Gabe_Garcia_(soccer)	playsFor	Carolina_Dynamo
Petar_Mihtarski	hasGender	male
Robbie_Russell_(soccer)	playsFor	Real_Salt_Lake
Jimmy_Kelly_(footballer_born_1973)	playsFor	Scarborough_F.C.
Yervand_Krbachyan	playsFor	FC_Yerevan
Rab_Shannon	playsFor	Dundee_United_F.C.
Nikolaj_Misiuk	playsFor	FBK_Kaunas
Hennadiy_Lytovchenko	playsFor	Ukraine_national_football_team
Mariano_González_Maroto	playsFor	FC_Barcelona_B
Phil_Starbuck	playsFor	Hereford_United_F.C.
Sam_Taylor_(footballer)	playsFor	Halifax_Town_A.F.C.
Yacine_Bezzaz	playsFor	JS_Kabylie
William_Gallas	hasGender	male
Sasho_Petrovski	playsFor	Sydney_FC
Giorgi_Kiknadze	playsFor	FC_Lokomotivi_Tbilisi
Sunday_Rotimi	hasGender	male
Mindaugas_Grigalevičius	playsFor	VMFD_Žalgiris_Vilnius
Rubén_Iván_Martínez	playsFor	Spain_national_under-23_football_team
Grégory_Dufrennes	playsFor	Dubai_CSC
Thomas_Hobbes	influences	Gottfried_Wilhelm_Leibniz
Papua_New_Guinea	exports	wordnet_gold_113371760
Damiano_Tommasi	playsFor	Queens_Park_Rangers_F.C.
Yura_Movsisyan	playsFor	Sporting_Kansas_City
Denys_Oliynyk	playsFor	FC_Dynamo_Kyiv
Stevland_Angus	playsFor	Bishop's_Stortford_F.C.
Kim_Chang-hoon	playsFor	South_Korea_national_under-20_football_team
Manuel_Castellano	playsFor	Spain_national_under-19_football_team
Wellington_Paulista	playsFor	Deportivo_Alavés
Vincent_Enyeama	playsFor	Bnei_Yehuda_Tel_Aviv_F.C.
Portugal	hasCapital	Coimbra
Danny_Wilson_(footballer,_born_1960)	playsFor	Chesterfield_F.C.
Energy_Murambadoro	playsFor	Zimbabwe_national_football_team
Alessio_Sarti	playsFor	Ravenna_F.C.
Steve_Pantelidis	playsFor	Perth_Glory_FC
Catalino_Rivarola	hasGender	male
Barry_Lyons_(footballer)	playsFor	Moldova_national_football_team
Kevin_Vandenbergh	playsFor	Beerschot_AC
Luca_Tognozzi	playsFor	A.S.D._SanGiovanniValdarno
Paul_Kpaka	playsFor	RWDM_Brussels_FC
Andrei_Kanchelskis	playsFor	ACF_Fiorentina
South-East_Asian_theatre_of_World_War_II	happenedIn	Sri_Lanka
Mary_Shelley	hasGender	female
Rubens_Rodrigues_dos_Santos_Júnior	playsFor	Clube_Atlético_Bragantino
Ânderson_Lima	playsFor	Albirex_Niigata
Jeff_Hopkins	playsFor	Wales_national_football_team
Battle_of_Blenheim	happenedIn	Prussia
Collin_Samuel	playsFor	East_Fife_F.C.
James_Chambers_(Irish_footballer)	playsFor	Hamilton_Academical_F.C.
Eugène_Dadi	playsFor	Tranmere_Rovers_F.C.
Mark_Kerr_(footballer)	playsFor	Asteras_Tripoli_F.C.
Román_Torres	playsFor	Millonarios_Fútbol_Club
Slimane_Raho	playsFor	Algeria_national_football_team
Alec_Cheyne	playsFor	Chelsea_F.C.
Jim_Adams_(soccer)	playsFor	New_England_Revolution
David_Knight_(English_footballer)	playsFor	Spennymoor_Town_F.C.
Louis_Gabrillargues	playsFor	France_national_football_team
Mateus_Alonso_Honorio	playsFor	Steel_Azin_F.C.
Anton_Shokh	playsFor	FC_Lada-Togliatti_Togliatti
Andrea_Manzo	playsFor	Vicenza_Calcio
Jean_Harbor	playsFor	Enugu_Rangers
Rob_Burch_(footballer)	playsFor	Bristol_City_F.C.
Kim_Shin-young	playsFor	Sagan_Tosu
Steve_Lovell_(Welsh_footballer)	playsFor	Weymouth_F.C.
Mohammed_Al-Hinai	playsFor	Qadsia_SC
Stewart_Greacen	playsFor	Livingston_F.C.
Santiago_Urquiaga	playsFor	Athletic_Bilbao
Marijan_Buljat	hasGender	male
Battle_of_the_Lys_(1918)	happenedIn	Ypres
Esad_Razić	playsFor	FC_Oss
Mike_Randolph	playsFor	Orange_County_Blues_FC
Marco_André_Azevedo_Gonçalves	playsFor	S.C._Espinho
Patrik_Baumann	playsFor	FC_Winterthur
Mathias_Christen	hasGender	male
Barry_Powell_(footballer)	playsFor	Wolverhampton_Wanderers_F.C.
Tommy_Knarvik	playsFor	Tromsø_IL
Gastón_Sangoy	playsFor	Boca_Juniors
Kyle_Critchell	playsFor	Dorchester_Town_F.C.
Bob_Latchford	playsFor	England_national_football_team
Christian_Wilhelmsson	playsFor	Al-Hilal_FC
Ivan_Korponai	playsFor	FC_Atyrau
Paulo_César_Arruda_Parente	hasGender	male
Margaret_Thatcher	playsFor	Millwall_F.C.
Masahiro_Fukasawa	playsFor	Yokohama_F._Marinos
Jeremy_Hall_(soccer)	playsFor	Toronto_FC
Faysal_El_Idrissi	playsFor	Coventry_City_F.C.
Alex_Tobin	hasGender	male
Jackie_Mudie	playsFor	Stoke_City_F.C.
Ger_O'Brien	hasGender	male
Pasquale_D'Aniello	playsFor	Bologna_F.C._1909
Juan_Manuel_Cavallo	playsFor	Persik_Kediri
Javier_Saviola	playsFor	S.L._Benfica
César_Lucena	playsFor	Guarani_Futebol_Clube
Daniel_Ginczek	playsFor	VfL_Bochum
Simeon_Hodson	playsFor	Lincoln_United_F.C.
Javed_Jaffrey	playsFor	FC_Metz
David_Pizanti	playsFor	Hapoel_Petah_Tikva_F.C.
Lutel_James	playsFor	Garforth_Town_A.F.C.
David_Brown_(footballer,_born_1978)	playsFor	Burton_Albion_F.C.
David_Freeman_(Irish_footballer)	playsFor	Cherry_Orchard_F.C.
Marcus_Lantz	playsFor	Torino_F.C.
Xandão	playsFor	Grêmio_Barueri_Futebol
Moreno_Torricelli	hasGender	male
Yacine_Bezzaz	hasGender	male
Giuseppe_Scurto	playsFor	A.C.D._Treviso_2013
Niger	dealsWith	United_Kingdom
Bozhidar_Iskrenov	playsFor	Washington_Warthogs
Alun_Armstrong_(footballer)	hasGender	male
Yannis_Salibur	playsFor	Clairefontaine
Kevin_Sharp_(footballer)	playsFor	Shrewsbury_Town_F.C.
Fousseni_Diawara	playsFor	AS_Saint-Étienne
Frank_Fahrenhorst	playsFor	Hammer_SpVg
Fábio_Gonçalves_dos_Santos	playsFor	Grêmio_Esportivo_Osasco
Ton_Lokhoff	hasGender	male
Dave_Bamber	playsFor	Coventry_City_F.C.
Marcell_Fodor	playsFor	FC_Ajka
Paul_McDonald_(footballer)	playsFor	Burnley_F.C.
Sergei_Pareiko	playsFor	FC_Tom_Tomsk
Aritz_Aduriz	hasGender	male
Steve_Nicol	playsFor	Doncaster_Rovers_F.C.
Lionel_Carole	playsFor	France_national_under-20_football_team
Toni_Kallio	playsFor	Molde_FK
Sean_Kilgannon	playsFor	Forfar_Athletic_F.C.
Martin_Smith_(footballer)	playsFor	Sunderland_A.F.C.
New_York_metropolitan_area	isLocatedIn	Trenton,_New_Jersey
Gregor_Stevens	playsFor	Motherwell_F.C.
Fábio_Alves_Félix	playsFor	Cerezo_Osaka
Serhiy_Zeldi	playsFor	FSC_Bukovyna_Chernivtsi
Burundi	exports	wordnet_coffee_bean_107929351
Maasoum_Abdah_Mouhammad	playsFor	Mash’al_Mubarek
Radoslav_Zabavník	playsFor	AC_Sparta_Prague
Willamis_de_Souza_Silva	playsFor	Fluminense_FC
Michel_de_Montaigne	influences	René_Descartes
Jonathan_Pérez_Olivero	playsFor	UD_Las_Palmas
Yannick_Djaló	playsFor	Toulouse_FC
Johann_Chapuis	playsFor	CS_Louhans-Cuiseaux
Sören_Seidel	playsFor	MSV_Duisburg
Nuno_Miguel_Mendes_Cavaleiro	playsFor	F.C._Vizela
Saxony	participatedIn	Battle_of_Cambrai_(1917)
Miguel_Bravo	playsFor	Universidad_Católica_del_Ecuador
Marco_Motta	playsFor	Genoa_C.F.C.
Péguy_Luyindula	playsFor	Chamois_Niortais_F.C.
Kleyr_Vieira_dos_Santos	playsFor	Associação_Portuguesa_de_Desportos
Fyodor_Dostoyevsky	influences	Richard_Yates_(novelist)
Teco_(footballer)	playsFor	Atlético_Clube_Goianiense
Anton_Allemann	playsFor	FC_Schaffhausen
Patrick_Bick	playsFor	1._FC_Saarbrücken
Kheireddine_Zarabi	playsFor	Algeria_national_football_team
Gabriel_Garcete	playsFor	C.D._Municipal_Limeño
Kegaska_Airport	isLocatedIn	Quebec
Toomas_Kallaste	playsFor	FF_Jaro
Eduard_Mor	playsFor	FC_Oryol
Vakhtang_Khvadagiani	playsFor	FC_Samtredia
Julian_Broddle	playsFor	St._Mirren_F.C.
Jamie_Smith_(footballer_born_1974)	playsFor	Bristol_City_F.C.
United_Kingdom	dealsWith	Netherlands
Cle_Kooiman	hasGender	male
J._D._Salinger	influences	Haruki_Murakami
Sylvain_Distin	playsFor	Newcastle_United_F.C.
Attila_Simon	playsFor	BKV_Előre_SC
Márcio_Rodrigues	playsFor	Clube_Náutico_Capibaribe
Daniel_Scheinhardt	playsFor	Hertha_BSC
Edgar_Bruno_da_Silva	playsFor	Al_Shabab_Al_Arabi_Club
Lee_Thorpe	playsFor	Blackpool_F.C.
Emre_Aygün	playsFor	Orduspor
Liam_Needham	playsFor	Notts_County_F.C.
Darren_Purse	playsFor	IFK_Mariehamn
Colin_Gordon_(footballer)	playsFor	Birmingham_City_F.C.
John_Arne_Riise	playsFor	Liverpool_F.C.
Harry_Travis	playsFor	Bradford_City_A.F.C.
Mustafa_El_Haddaoui	playsFor	Raja_Casablanca
Rene_Howe	playsFor	Peterborough_United_F.C.
Barry_Silkman	playsFor	Barnet_F.C.
Gabriel_Wüthrich	playsFor	FC_Lugano
Danny_Mills	playsFor	Hull_City_A.F.C.
Jones_Kusi-Asare	playsFor	Landskrona_BoIS
Micky_Quinn	playsFor	Watford_F.C.
Neil_Cutler	hasGender	male
Ernesto_Gómez_Gómez	playsFor	Spain_national_under-18_football_team
Tuscany	hasCapital	Florence
Atanas_Chipilov	playsFor	PFC_Beroe_Stara_Zagora
Marko_Andić	playsFor	K.S.C._Lokeren_Oost-Vlaanderen
Yemen	exports	wordnet_coffee_bean_107929351
Volkan_Yaman	playsFor	Galatasaray_S.K.
Theofanis_Gekas	playsFor	Eintracht_Frankfurt
John_Willie_Sutcliffe	hasGender	male
John_Fashanu	playsFor	Crystal_Palace_F.C.
Hrayr_Mkoyan	hasGender	male
Empire_of_Japan	participatedIn	Russian_Civil_War
Stan_Collymore	playsFor	Walsall_F.C.
Jeff_Cunningham	playsFor	FC_Dallas
Yakubu_Aiyegbeni	playsFor	Everton_F.C.
Fraser_Digby	playsFor	Barry_Town_United_F.C.
John_Herrick	playsFor	Shamrock_Rovers_F.C.
Sidney_Santos_de_Brito	playsFor	Sportfreunde_Lotte
Hakan_Aslantaş	hasGender	male
Vitaliy_Reva	playsFor	FC_Arsenal_Kyiv
Luís_Mário_Miranda_da_Silva	playsFor	Coritiba_Foot_Ball_Club
Ahmed_Salah_Hosny	playsFor	Al_Ahly_SC
Brad_Fiedel	hasMusicalRole	wordnet_synthesist_110687231
Wiborada	hasGender	female
Julio_Aguilar	playsFor	Club_Atlético_3_de_Febrero
Nebojša_Šćepanović	playsFor	FC_Prishtina
Oleg_Sergeyev	playsFor	FC_Torpedo-ZIL_Moscow
Roberto_Muzzi	playsFor	Udinese_Calcio
Patrick_Boyle_(footballer)	playsFor	Clyde_F.C.
Tomer_Chencinski	playsFor	Maccabi_Tel_Aviv_F.C.
Christopher_Wreh	playsFor	Al-Hilal_FC
John_Keister_(footballer_born_1970)	playsFor	Dover_Athletic_F.C.
Dawda_Bah	playsFor	Kuopion_Palloseura
Anderson_Santana_dos_Santos	hasGender	male
Derek_Townsley	playsFor	Hibernian_F.C.
Sławomir_Majak	playsFor	ŁKS_Łódź
Marcelo_Pletsch	playsFor	Panionios_G.S.S.
Florian_Fromlowitz	playsFor	MSV_Duisburg
Ronaldo_Soares_Giovanelli	playsFor	Sociedade_Esportiva_do_Gama
Owen_Coll	playsFor	Yeovil_Town_F.C.
Zyad_Chaabo	playsFor	Al-Karamah_SC
Sérgio_Manoel	playsFor	Club_Atlético_Independiente
Massimo_Ambrosini	playsFor	Vicenza_Calcio
Zaur_Khapov	hasGender	male
Bruno_Vale	hasGender	male
Leo_Franco	playsFor	RCD_Mallorca_B
Imants_Bleidelis	hasGender	male
Thomas_Villadsen	playsFor	FC_Emmen
Ben-Hur_Moreira_Peres	playsFor	Clube_de_Regatas_Brasil
Josip_Barišić_(footballer_born_1981)	playsFor	NK_Karlovac
Miguel_Vítor	playsFor	Leicester_City_F.C.
Jesús_Ángel_Solana	playsFor	Spain_national_under-16_football_team
Gary_Shaw	playsFor	Blackpool_F.C.
José_Yudica	playsFor	Talleres_de_Remedios_de_Escalada
Mansour_Boutabout	playsFor	Rodez_AF
Didier_Ovono	playsFor	FC_Sochaux-Montbéliard
David_Madden_(footballer)	playsFor	Arsenal_F.C.
Blagoje_Vidinić	diedIn	Strasbourg
Perica_Ognjenović	playsFor	Dalian_Shide_F.C.
Trevor_Carson	playsFor	Lincoln_City_F.C.
Arnar_Førsund	playsFor	Kongsvinger_IL_Toppfotball
Nadir_Benchenaa	playsFor	Assyriska_Föreningen
Bruno_Custos	playsFor	SpVgg_Unterhaching
Aleksandr_Denisov	playsFor	FC_Salyut_Belgorod
University_of_North_Dakota	isLocatedIn	United_States
North_African_Campaign	happenedIn	Poland
Tiago_Pereira	playsFor	CD_Tenerife
Pablo_Lanz	playsFor	Club_Destroyers
Wayne_Gray_(footballer)	playsFor	Cambridge_United_F.C.
Vedran_Muratović	playsFor	OFI_Crete
Paddy_Sloan	playsFor	Bath_City_F.C.
Thomas_Herbst_(footballer)	playsFor	Eintracht_Braunschweig
Yossi_Benayoun	playsFor	Maccabi_Haifa_F.C.
Steve_Lovell	hasGender	male
Aílton_Gonçalves_da_Silva	playsFor	Mogi_Mirim_Esporte_Clube
Miguel_Alfredo_Portillo	playsFor	FC_Lugano
First_Crusade	happenedIn	Republic_of_Genoa
Anthony_Stokes	playsFor	Sheffield_United_F.C.
Claudio_Enría	playsFor	CD_Leganés
Fábio_Hempel	hasGender	male
Adem_Ljajić	playsFor	Serbia_national_under-19_football_team
Tom_Aherne	playsFor	Belfast_Celtic_F.C.
Jonas_Jessue_da_Silva_Júnior	playsFor	Associação_Desportiva_São_Caetano
Marcelino_Galoppo	playsFor	Atlético_Tucumán
Bosco_Frontán	playsFor	Jaibos_Tampico_Madero
Demba_Ba	playsFor	Newcastle_United_F.C.
Attila_Ladinsky	playsFor	Valenciennes_FC
Douglas_Packer	playsFor	Betim_Esporte_Clube
Alfred_North_Whitehead	influences	Gilles_Deleuze
Noor_Sabri	playsFor	Al-Quwa_Al-Jawiya
José_Francisco_Ramírez	hasGender	male
Maxime_Chanot	playsFor	AS_Nancy
Giuseppe_Mazzarelli	playsFor	FC_St._Gallen
Pelé_(footballer,_born_1978)	playsFor	Falkirk_F.C.
Thomson_Airways	isLocatedIn	London
Kevin_Austin	playsFor	Bristol_Rovers_F.C.
Antoni_Brzeżańczyk	playsFor	Stal_Mielec
Ian_Thomas-Moore	hasGender	male
Ike_Shorunmu	playsFor	Samsunspor
Mensur_Kurtisi	playsFor	FC_Tobol
Hasney_Aljofree	playsFor	Plymouth_Argyle_F.C.
Otto_Rehhagel	playsFor	Germany_Olympic_football_team
Luiz_Carlos_Winck	playsFor	Brazil_national_football_team
Luis_Suárez_Miramontes	playsFor	FC_Barcelona
Paul_Anderson_(footballer)	playsFor	Liverpool_F.C.
Steve_Lovell	playsFor	Portsmouth_F.C.
Fernando_Nélson	playsFor	F.C._Porto
David_Farrell_(footballer_born_1971)	playsFor	Aston_Villa_F.C.
Mauricio_Ramos	playsFor	The_Strongest
Ivan_Zammit	playsFor	Valletta_F.C.
Kingdom_of_Italy	participatedIn	Operation_Barbarossa
Vojtěch_Schulmeister	playsFor	Almere_City_FC
Kristijan_Polovanec	playsFor	Football_Club_Libourne
Philippe_Fargeon	playsFor	Servette_FC
Ihor_Leonov	playsFor	FC_Metalurh_Donetsk
Ademola_Bankole	playsFor	Lewes_F.C.
Daniel_Díaz	playsFor	Boca_Juniors
Javier_Camuñas	playsFor	Getafe_CF
Chris_Turner_(footballer_born_1990)	playsFor	Accrington_Stanley_F.C.
Michael_Mason_(soccer)	playsFor	Hamburger_SV_II
Boubacar_Kébé	playsFor	Mali_national_football_team
Lee_Jones_(New_Zealand_footballer)	playsFor	FC_Jokerit
Charlie_Millington	playsFor	Birmingham_City_F.C.
Neil_Murray_(footballer)	playsFor	FC_Lorient
Stavros_Tziortziopoulos	playsFor	Iraklis_Thessaloniki_F.C.
Paul_Smith_(footballer_born_1962)	playsFor	Motherwell_F.C.
Marko_Baša	playsFor	Montenegro_national_football_team
Răzvan_Stanca	playsFor	Romania_national_football_team
Tyrol_(state)	isLocatedIn	Austria
Andrea_Bernini	playsFor	Montevarchi_Calcio_Aquila_1902
Flint,_Michigan	isLocatedIn	United_States
Nicole_Banecki	playsFor	Germany_women's_national_football_team
Christophe_Robert	playsFor	AS_Monaco_FC
Dmitriy_Lyapkin	playsFor	FC_Tekstilshchik_Kamyshin
Kevin_Gall	playsFor	FC_Dallas
Leandro_Machado	playsFor	C.D._Santa_Clara
KK_Zadar	isLocatedIn	Croatia
Andreas_Hilfiker	playsFor	Tennis_Borussia_Berlin
Battle_of_Novara_(1513)	happenedIn	Basel
Jan_Goossens	playsFor	Minnesota_Strikers
Florin_Răducioiu	playsFor	AS_Monaco_FC
Asa_Hall	playsFor	Aldershot_Town_F.C.
Archie_Stark	hasGender	male
Thomas_Myhre	playsFor	F.C._Copenhagen
Bath_Rugby	isLocatedIn	Bath,_Somerset
Luís_Oliveira	playsFor	Calcio_Catania
Michael_Turnbull_(footballer)	playsFor	Marconi_Stallions_FC
Edward_Plunkett,_18th_Baron_of_Dunsany	influences	Jack_Vance
Anderson_Luiz_Gomes_Ribeiro	playsFor	Clube_de_Regatas_do_Flamengo
Maxime_Agueh	playsFor	FC_Gueugnon
Igor_Mostarlić	playsFor	NK_Krško
Emeka_Ezeugo	playsFor	Estudiantes_de_Medicina
Gabriel_Álvez	playsFor	Real_Cartagena
Rodrigo_Silva_dos_Santos	playsFor	Fortaleza_Esporte_Clube
Szeto_Man_Chun	playsFor	Hong_Kong_national_football_team
Diego_Benedito_Galvão_Máximo	playsFor	Paykan_F.C.
Jess_Vanstrattan	playsFor	Central_Coast_Mariners_FC
Edmar_Bernardes	playsFor	Guarani_Futebol_Clube
Mario_Čižmek	playsFor	NK_Brotnjo
Virgil	influences	Jeffrey_Eugenides
United_States	participatedIn	Kosovo_War
Pavel_Zavadil	playsFor	1._FK_Příbram
Peter_de_Almeida	playsFor	Ypiranga_Futebol_Clube
Christian_Panucci	playsFor	A.S._Roma
Sergei_Ostapenko	playsFor	FC_Astana
Borja_Sánchez_Luque	playsFor	Burgos_CF
Geílson_de_Carvalho_Soares	hasGender	male
Milutin_Pajević	playsFor	Yugoslavia_national_football_team
Ben_Futcher	playsFor	Mansfield_Town_F.C.
Danny_Morgan_(footballer)	playsFor	Grays_Athletic_F.C.
Gerry_Armstrong_(footballer)	playsFor	Crawley_Town_F.C.
Leonel_Vielma	playsFor	Venezuela_national_football_team
Shakhboz_Erkinov	playsFor	Uzbekistan_national_football_team
Giorgi_Tsimakuridze	playsFor	FC_Illichivets_Mariupol
Ettore_Puricelli	playsFor	A.S.D._Legnano_Calcio_1913
Yehiel_Tzagai	playsFor	Hakoah_Amidar_Ramat_Gan_F.C.
Adam_Lockwood	playsFor	Forest_Green_Rovers_F.C.
Federico_Marchetti	playsFor	U.C._AlbinoLeffe
Jonti_Richter	playsFor	Brisbane_Roar_FC
Vladimir_Karalić	playsFor	FK_Sarajevo
Dan_Canter	playsFor	United_States_men's_national_soccer_team
Vincenzo_Italiano	playsFor	A.C._Chievo_Verona
Wes_Craven	hasGender	male
University_of_California,_Los_Angeles	isLocatedIn	California
Adeola_Lanre_Runsewe	playsFor	F.C._Ebedei
Manoel_da_Silva_Filho	playsFor	Shanghai_Shenxin_F.C.
Marek_Lemsalu	playsFor	Estonia_national_football_team
Kyle_Nix	playsFor	Chiangrai_United_F.C.
Moussa_Sissoko	hasGender	male
Santiago_Carpintero	playsFor	Albacete_Balompié
Ivair_Ferriera	playsFor	Sport_Club_Corinthians_Paulista
Sam_Ayorinde	playsFor	Guangzhou_R&F_F.C.
Philip_Hughes_(footballer_born_1981)	playsFor	University_College_Dublin_A.F.C.
Košice	isLocatedIn	Slovakia
Cândido_Costa	playsFor	F.C._Arouca
Luchi_Gonzalez	playsFor	Bodens_BK
Oleh_Kuznetsov	playsFor	FC_Desna_Chernihiv
Russia	participatedIn	War_on_Terror
José_Milton_Melgar	playsFor	Everton_de_Viña_del_Mar
Ignas_Dedura	hasGender	male
Nikola_Jozić	playsFor	AJ_Auxerre
Emmanuel_Ledesma	playsFor	Defensa_y_Justicia
Michal_Kovář	playsFor	SK_Sigma_Olomouc
Jamie_Day_(footballer_born_1979)	playsFor	Havant_&_Waterlooville_F.C.
Jofre_Mateu	playsFor	Levante_UD
Davi_Rodrigues_de_Jesus	playsFor	Avaí_Futebol_Clube
Godfrey_Ingram	playsFor	St_Albans_City_F.C.
Dariusz_Wosz	playsFor	Hallescher_FC
The_Adventures_of_Pinocchio_(1996_film)	isLocatedIn	Germany
Florian_Lucchini	hasGender	male
Alexandre_Edílson_de_Freitas	playsFor	FC_Baden
Bruno_Akrapović	playsFor	TuS_Celle_FC
Leandro_Carrijó	playsFor	Uberaba_Sport_Club
John_Melligan	hasGender	male
South_Africa	participatedIn	Great_War_(Harry_Turtledove)
Sergio_Vázquez	playsFor	Avispa_Fukuoka
Szilárd_Németh	playsFor	MFK_Košice
Diego_Romano	playsFor	Ergotelis_F.C.
Djamel_Mesbah	playsFor	FC_Aarau
Kakhaber_Mzhavanadze	hasGender	male
David_Thompson_(footballer_born_1968)	playsFor	Bristol_City_F.C.
Dido_Havenaar	hasGender	male
Marius_Popa	playsFor	FC_Progresul_București
Faryd_Mondragón	playsFor	Club_Atlético_Independiente
Allan_Smart	playsFor	Bury_F.C.
Edin_Ademović	playsFor	FK_Kolubara
Joaquín_(footballer)	playsFor	Real_Betis
Jos_Daerden	hasGender	male
Phil_Whitehead	playsFor	Bradford_City_A.F.C.
Ratko_Dostanić	playsFor	Red_Star_F.C.
José_Luis_Sierra	hasGender	male
Russell_Osman	hasGender	male
Craig_Beattie	playsFor	Swansea_City_A.F.C.
Rodrigo_Defendi	playsFor	Paraná_Clube
Caleb_Folan	playsFor	Chesterfield_F.C.
Confederate_States_of_America	isLocatedIn	North_America
Hermes_Neves_Soares	playsFor	Goiânia_Esporte_Clube
Pierre_Ebéde	playsFor	Tonnerre_Yaoundé
Chinesinho	playsFor	Vicenza_Calcio
Ilion_Lika	playsFor	Albania_national_football_team
Herbert_Banks	playsFor	Watford_F.C.
Tony_Towers	playsFor	Vancouver_Whitecaps_(1974–84)
Juan_Pablo_Caffa	playsFor	Boca_Juniors
Predrag_Ocokoljić	playsFor	Ethnikos_Achna_FC
Joseph_Dayo_Oshadogan	playsFor	A.C._Pisa_1909
Tomislav_Ivković	playsFor	Red_Star_Belgrade
Kamel_Larbi	playsFor	Étoile_Fréjus_Saint-Raphaël
Andy_Martin_(footballer)	playsFor	Croydon_Athletic_F.C.
Adelaide	isLocatedIn	Brisbane
Salaheddine_Bassir	playsFor	Al-Hilal_FC
Konstantin_Vassiljev	playsFor	FC_Levadia_Tallinn
David_Revivo	playsFor	Hapoel_Be'er_Sheva_F.C.
Mattia_Graffiedi	playsFor	A.C._Siena
Nelson_Haedo_Valdez	playsFor	Valencia_CF
Mahmoud_El_Sayed_Samir	playsFor	Al-Masry_SC
Jean_Narde	playsFor	São_Paulo_FC
Jorge_Huamán	playsFor	Veria_F.C.
Roei_Dayan	playsFor	Hapoel_Tel_Aviv_F.C.
Alan_Jones_(footballer_born_1951)	playsFor	Huddersfield_Town_F.C.
Bruno_Giordano	playsFor	S.S.C._Napoli
Ihar_Hurynovich	playsFor	CD_Castellón
Luis_Ramos_(Honduran_footballer)	playsFor	Nyíregyháza_Spartacus_FC
Stanimir_Georgiev	playsFor	Marsaxlokk_F.C.
Kyah_Simon	playsFor	Sydney_FC_W-League
Caleb_Folan	playsFor	Republic_of_Ireland_national_football_team
Brian_Martin_(footballer)	playsFor	Scotland_national_football_team
Vitaly_Daraselia_(footballer_born_1978)	playsFor	FC_Alania_Vladikavkaz
Sagi_Strauss	playsFor	Maccabi_Haifa_F.C.
Cleber_Resende_de_Oliveira	playsFor	Santa_Cruz_Futebol_Clube
Ljubo_Miličević	playsFor	FC_Thun
Bobby_Blood	playsFor	Buxton_F.C.
Joelson_José_Inácio	playsFor	Atalanta_B.C.
Bohdan_Yesyp	playsFor	FC_Hoverla_Uzhhorod
Antonio_Chimenti	playsFor	Cagliari_Calcio
Luis_Monti	hasGender	male
Marc_Williams	playsFor	Colwyn_Bay_F.C.
Ian_Ironside	playsFor	Stockport_County_F.C.
Serhiy_Puchkov	playsFor	FC_Dnipro_Dnipropetrovsk
Martin_Hurt	hasGender	male
Robert_Towne	created	The_Godfather_(film_series)
Christian_Eggert	playsFor	Borussia_Dortmund
Gerhard_Tremmel	playsFor	FC_Red_Bull_Salzburg
Manu_del_Moral	playsFor	Spain_national_under-23_football_team
Paul_Scharner	playsFor	Hamburger_SV_II
Uppland	hasCapital	Uppsala
Nicolás_Olivera	playsFor	Club_Atlas
Asmir_Begović	playsFor	Macclesfield_Town_F.C.
Éverton_Cardoso_da_Silva	playsFor	Suwon_Samsung_Bluewings
Lars_Hirschfeld	playsFor	Leicester_City_F.C.
Samuel_Koejoe	playsFor	Dynamo_Dresden
Manfred_Kaltz	hasGender	male
Bèbè_Kambou	playsFor	ASFA_Yennenga
Lazhar_Hadj_Aïssa	playsFor	Al_Sharjah_SC
Cherno_Samba	playsFor	FC_Haka
Rafael_Gordillo	playsFor	Spain_national_under-21_football_team
Franck_Songo'o	playsFor	FC_Barcelona_C
Radoslav_Zabavník	playsFor	PFC_CSKA_Sofia
Activision_Blizzard	isLocatedIn	Santa_Monica,_California
Miguel_Monteiro	hasGender	male
Paulo_Assunção	playsFor	Atlético_Madrid
Vitaliy_Berezovskyi	playsFor	FC_Sheriff_Tiraspol
Josemir_Lujambio	playsFor	Querétaro_F.C.
Nicolas_Malebranche	influences	George_Berkeley
Tomáš_Pospíchal	playsFor	FC_Baník_Ostrava
Károly_Erős	playsFor	BFC_Siófok
Glenn_Whelan	hasGender	male
Eduardo_Bustos_Montoya	playsFor	Levadiakos_F.C.
Willie_Morgan	playsFor	Burnley_F.C.
Dmytro_Vorobey	playsFor	FC_Zorya_Luhansk
Fabián_Estoyanoff	playsFor	Valencia_CF
Fininho	playsFor	Sport_Club_do_Recife
Herfried_Sabitzer	hasGender	male
Peter_Cormack	playsFor	Nottingham_Forest_F.C.
Sweden	participatedIn	Korean_War
Michu	playsFor	Swansea_City_A.F.C.
Mbaye_Leye	playsFor	K.A.A._Gent
Luke_Jackson_(basketball)	playsFor	Switzerland_national_football_team
Collin_Samuel	playsFor	Arbroath_F.C.
Marco_Grimm	playsFor	VfB_Stuttgart
Thiago_Martinelli	hasGender	male
Jimmy_Dunne_(footballer_born_1935)	playsFor	Tunbridge_Wells_F.C.
Mustafa_Yücedağ	playsFor	Fenerbahçe_S.K.
Leonid_Musin	playsFor	FC_Dinamo_Minsk
Paulo_Wanchope	playsFor	Chicago_Fire_Soccer_Club
Mick_O'Brien_(footballer_born_1893)	playsFor	Walsall_F.C.
David_Winters_(footballer)	playsFor	Dundee_United_F.C.
Jesús_Galván_Carrillo	playsFor	UE_Lleida
Sisinio_González_Martínez	playsFor	Recreativo_de_Huelva
Nick_Burton	playsFor	Harrow_Borough_F.C.
Mariusz_Piekarski	playsFor	Clube_Atlético_Paranaense
Radostin_Kishishev	playsFor	Leeds_United_A.F.C.
Chris_Smith_(footballer,_born_1981)	playsFor	Reading_F.C.
Xavier_Roca_Mateo	playsFor	CE_Sabadell_FC
United_Kingdom	imports	wordnet_machinery_103701640
Li_Haiqiang	playsFor	Chengdu_Tiancheng_F.C.
Federico_Capece	playsFor	A.S.D._Virtus_Casarano
Thorstein_Helstad	playsFor	Lillestrøm_SK
Dean_Williams_(footballer)	playsFor	Cobh_Ramblers_F.C.
Andrei_Karyaka	hasGender	male
Gonçalo_Brandão	playsFor	CFR_Cluj
Joelson_Santos_Silva	playsFor	Villa_Nova_Atlético_Clube
Walter_Meeuws	playsFor	K._Beerschot_V.A.C.
No_Byung-jun	playsFor	South_Korea_national_football_team
Miloš_Krstić	playsFor	FK_Rad
Cândido_Costa	hasGender	male
Radomir_Đalović	playsFor	Arminia_Bielefeld
Emmanuel_Dorado	playsFor	UD_Almería
Henry_León	playsFor	Centro_Deportivo_Olmedo
Hilko_Ristau	playsFor	1._FC_Saarbrücken
Franjo_Tepurić	playsFor	IL_Hødd
Cornell_Glen	playsFor	New_York_Red_Bulls
Carlo_Nash	playsFor	Wigan_Athletic_F.C.
Jurgen_Vandeurzen	playsFor	Stoke_City_F.C.
Márcio_Rodrigues	playsFor	Esporte_Clube_Santo_André
Aleksandr_Katasonov	playsFor	FC_Lokomotiv_Moscow
Nikola_Grubješić	playsFor	AEL_1964_FC
Russian_Civil_War	happenedIn	Ottoman_Empire
Nikolay_Shirshov	playsFor	FC_Ordabasy
Sebastián_Sciorilli	playsFor	Club_Atlético_River_Plate
Vadym_Milko	playsFor	Ukraine_national_under-21_football_team
Chris_Holroyd	playsFor	Stevenage_F.C.
Gunnar_Heiðar_Þorvaldsson	playsFor	Fredrikstad_FK
Mike_Conroy_(footballer_born_1965)	playsFor	Fulham_F.C.
Pedro_Roberto_Silva_Botelho	playsFor	Figueirense_Futebol_Clube
Adolfino_Cañete	playsFor	Cobreloa
Alen_Pamić	playsFor	NK_Istra_1961
Herbert_Chapman	playsFor	Tottenham_Hotspur_F.C.
Yasen_Petrov	playsFor	Bulgaria_national_football_team
Aleksandr_Khvostunov	playsFor	FK_Dinamo_Samarqand
Jonny_Walker	playsFor	FC_Dallas
Robbie_Fowler	playsFor	Liverpool_F.C.
Jonathan_Quartey	playsFor	Heart_of_Lions_F.C.
Matteo_Momentè	playsFor	U.S._Cremonese
Nicky_Weaver	playsFor	England_national_under-21_football_team
Luis_Eduardo_Zapata	hasGender	male
Andrei_Stepanov_(footballer)	playsFor	JK_Tervis_Pärnu
Billy_Whitehurst	playsFor	Crewe_Alexandra_F.C.
Serhiy_Kovalenko	playsFor	K.S.V._Roeselare
Tiberio_Guarente	playsFor	Atalanta_B.C.
Michel_Ngonge	playsFor	R.A.A._Louviéroise
David_Cobeño	playsFor	Sevilla_FC
Stephen_Wright_(English_footballer)	playsFor	England_national_under-20_football_team
Ángel_Bernuncio	playsFor	Club_Atlético_Platense
John_Gayle_(footballer)	playsFor	Burnley_F.C.
Nuno_Assis	playsFor	AC_Omonia
Valeri_Domovchiyski	hasGender	male
Rolf-Christel_Guié-Mien	playsFor	SC_Freiburg
Álvaro_Negredo	playsFor	Rayo_Vallecano_B
Kevin_Harper	playsFor	Walsall_F.C.
Yuriy_Kalitvintsev	playsFor	FC_Dynamo_Kyiv
Renzo_Yáñez	playsFor	San_Marcos_de_Arica
Vladimir_Karalić	playsFor	NK_GOŠK_Gabela
Smahi_Triki	playsFor	FC_Lausanne-Sport
Eyal_Ben_Ami	playsFor	Israel_national_under-21_football_team
Jon_Sheffield	playsFor	Plymouth_Argyle_F.C.
Ion_Heliade_Rădulescu	influences	Mihai_Eminescu
David_Wagner_(soccer)	playsFor	1._FSV_Mainz_05
Sasho_Petrovski	hasGender	male
Thiago_Gomes_Antequeira	playsFor	Associação_Portuguesa_de_Desportos
Robert_Grizha	playsFor	Shkumbini_Peqin
Alexandru_Popovici_(Moldovan_footballer)	playsFor	Simurq_PIK
Angola	exports	wordnet_fish_102512053
Riku_Riski	playsFor	Turun_Palloseura
Gaza_Strip	hasOfficialLanguage	Arabic_language
Jim_Rodwell	playsFor	Hednesford_Town_F.C.
Marcelo_Guerrero	playsFor	Club_Atlético_Colón
Andrew_Myler	playsFor	Waterford_United_F.C.
Sebastian_Svärd	playsFor	Roda_JC_Kerkrade
Welwyn_Garden_City	isLocatedIn	East_of_England
Neville_Southall	hasGender	male
Denni_Conteh	playsFor	FC_Nordsjælland
Marius_Stankevičius	playsFor	Lithuania_national_football_team
Ben_Watson_(footballer,_born_December_1985)	playsFor	Exeter_City_F.C.
Ernie_Jones_(footballer_born_1920)	playsFor	Southampton_F.C.
Adrián_Szekeres	playsFor	MTK_Budapest_FC
Lee_Ayres	playsFor	Tamworth_F.C.
Steve_Bruce	playsFor	England_national_under-18_football_team
John_Alvbåge	playsFor	Sweden_national_under-16_football_team
Steve_Guppy	playsFor	Celtic_F.C.
Fanis_Katergiannakis	playsFor	Greece_national_football_team
Vila_do_Conde	isLocatedIn	Portugal
Alexander_Walke	playsFor	FC_Red_Bull_Salzburg
Jaroslav_Drobný_(footballer)	playsFor	Czech_Republic_national_under-21_football_team
Emile_Heskey	playsFor	Newcastle_Jets_FC
Dallas	isLocatedIn	United_States
Rubén_Torrecilla	playsFor	Novelda_CF
Sebastián_Nayar	playsFor	Deportivo_Cali
Rodrigo_Barbosa_Rodrigues_Costa	playsFor	Resende_Futebol_Clube
Jônatas_Domingos	playsFor	Brazil_national_football_team
Daniele_Cacia	playsFor	Hellas_Verona_F.C.
Tom_Kelly_(footballer,_born_1964)	playsFor	Hibernian_F.C.
Hélder_Cabral	hasGender	male
Ian_Herring	playsFor	Swindon_Town_F.C.
Brian_Budd	playsFor	Canada_men's_national_soccer_team
Denys_Sokolovskyi	playsFor	FC_Metalurh_Donetsk
Mayer_Candelo	playsFor	Colombia_national_football_team
Christian_Maggio	playsFor	S.S.C._Napoli
University_of_California,_Berkeley	isLocatedIn	California
Yaroslav_Kutsyaba	playsFor	Ukraine_national_under-16_football_team
Giuseppe_Gemiti	playsFor	Germany_national_under-21_football_team
Mekan_Nasyrow	playsFor	PS_Barito_Putera
Jimmy_Dunne_(footballer_born_1935)	playsFor	Leicester_City_F.C.
Provence-Alpes-Côte_d'Azur	isLocatedIn	Marseille
Marcus_Feinbier	playsFor	Alemannia_Aachen
Serhiy_Skachenko	playsFor	FC_Metalist_Kharkiv
Jaroslav_Hílek	playsFor	SK_Dynamo_České_Budějovice
Mazinho	hasGender	male
Vitaliy_Hoshkoderya	playsFor	Ukraine_national_under-18_football_team
Milko_Gjurovski	playsFor	NK_Železničar_Maribor
Dudu_Georgescu	hasGender	male
Godfried_Aduobe	playsFor	Karlsruher_SC
Grover_Gibson	playsFor	Rot_Weiss_Ahlen
Rodrigo_Souto	playsFor	Clube_Náutico_Capibaribe
Lower_Normandy	hasCapital	Caen
Robbert_Schilder	playsFor	Netherlands_national_under-21_football_team
Patrick_Owomoyela	playsFor	Lüneburger_SK
Horacio_Chiorazzo	playsFor	Real_Santa_Cruz
Dylan_Macallister	playsFor	Australia_national_under-23_association_football_team
Carlos_Manuel_da_Silva_Cunha	playsFor	S.L._Benfica
Jan_van_Beveren	playsFor	Dallas_Sidekicks_(1984–2004)
Juan_Povedano_Martínez	playsFor	CD_Leganés
Marek_Kincl	playsFor	FK_Bohemians_Prague_(Střížkov)
Jahangir_Hasanzade	playsFor	Azerbaijan_national_football_team
Billy_Boyd_(footballer)	playsFor	Workington_A.F.C.
Lee_Bowyer	playsFor	Charlton_Athletic_F.C.
Alain_Junior_Ollé_Ollé	hasGender	male
Roger_Guerreiro	playsFor	Celta_de_Vigo
Babù	playsFor	Hellas_Verona_F.C.
Marco_Abreu	playsFor	A.D._Ovarense
Franck_Gava	playsFor	Olympique_Lyonnais
Kim_Yoo-jin_(footballer)	playsFor	Bangkok_United_F.C.
Rogelio_Domínguez	playsFor	C.A._Cerro
Paul_Reid_(footballer_born_1982)	playsFor	Preston_North_End_F.C.
Salim_Arrache	playsFor	Asteras_Tripoli_F.C.
Rubén_Sosa	playsFor	Club_Nacional_de_Football
Lenílson_Batista_de_Souza	playsFor	Clube_Atlético_Linense
Karol_Gregorek	playsFor	Wisła_Płock
Montana	isLocatedIn	United_States
Sebastián_Roco	playsFor	Everton_de_Viña_del_Mar
Nicola_Mingazzini	playsFor	Atalanta_B.C.
Antony_Gibbs	hasGender	male
Igor_Smolnikov	playsFor	FC_Zenit_Saint_Petersburg
Beto_(Portuguese_footballer_born_1976)	playsFor	Portugal_national_football_team
Nader_al-Tarhouni	playsFor	Al-Shaab_CSC
Dmytro_Hololobov	playsFor	FC_Obolon-2_Kyiv
Dean_Austin	playsFor	Tottenham_Hotspur_F.C.
James_McNulty_(footballer)	playsFor	Scotland_national_under-17_football_team
Gianluca_Falsini	playsFor	A.C._Siena
Lenny_Fernandes_Coelho	playsFor	S.C._Braga
Salvatore_Campilongo	playsFor	S.S.D._Città_di_Brindisi
Jean_Harbor	playsFor	Seattle_SeaDogs
Mate_Maleš	playsFor	HNK_Šibenik
Dave_Kitson	playsFor	Sheffield_United_F.C.
Essau_Kanyenda	playsFor	FC_Rostov
Erez_Mesika	playsFor	Hapoel_Haifa_F.C.
Nastja_Čeh	playsFor	Maccabi_Petah_Tikva_F.C.
Canada	participatedIn	Operation_Mountain_Fury
Sanel_Kuljić	playsFor	LASK_Linz
Colin_Larkin_(footballer)	playsFor	Republic_of_Ireland_national_under-17_football_team
Thomas_Helveg	playsFor	Inter_Milan
Baruch_Spinoza	influences	Friedrich_Nietzsche
Ryan_Williams_(footballer,_born_1978)	playsFor	Tranmere_Rovers_F.C.
Stuart_Malcolm	playsFor	Alloa_Athletic_F.C.
Gökhan_Inler	playsFor	Udinese_Calcio
David_Healy_(footballer)	playsFor	Rangers_F.C.
Samuel_Beckett	influences	Steven_Millhauser
Jack_Benny	influences	Richard_Pryor
Jorge_Luiz_Alves_Justino	playsFor	Associação_Desportiva_Confiança
Miloš_Ristanović	playsFor	FK_Kolubara
Florin_Pelecaci	playsFor	FC_Unirea_Urziceni
Elif_Ağca_Öner	playsFor	Galatasaray_S.K._(women's_volleyball)
Oscar_Echeverry	playsFor	New_York_Red_Bulls
Wayne_Hatswell	playsFor	Newport_County_A.F.C.
Vilnius	isLocatedIn	Lists_of_World_Heritage_Sites_in_Europe
Ezequiel_Miralles	playsFor	Club_Olimpo
Ricardo_Vaz_Tê	playsFor	S.C._Farense
Jésus_Sinisterra	playsFor	Colombia_national_football_team
Charles_Ademeno	playsFor	Southend_United_F.C.
Pavel_Fořt	playsFor	Czech_Republic_national_under-17_football_team
Gentian_Stojku	playsFor	KF_Teuta_Durrës
Jean-Jacques_Rousseau	influences	Johann_Gottlieb_Fichte
Alan_Mayer	playsFor	San_Diego_Sockers_(1978–96)
Wellington_Gonçalves	playsFor	Niki_Volos_F.C.
Víctor_Trossero	playsFor	Montpellier_HSC
Steve_Bowey	playsFor	Queen_of_the_South_F.C.
Oumar_Tchomogo	playsFor	Vitória_S.C.
Kenny_Sansom	playsFor	Brentford_F.C.
Edgar_Álvarez	playsFor	A.S._Livorno_Calcio
Hasim_Đoković	hasGender	male
Jérémy_Sopalski	playsFor	Associação_Naval_1º_de_Maio
Denis_Laktionov	playsFor	Russia_national_football_team
Edwin_Congo	playsFor	Sporting_de_Gijón
Chinesinho	playsFor	New_York_Cosmos
Justin_Fashanu	playsFor	England_national_under-21_football_team
Azubuike_Oliseh	hasGender	male
Josemi	playsFor	Liverpool_F.C.
George_Clegg	playsFor	Northwich_Victoria_F.C.
Phil_Jackson_Ibarguen_Sanchez	playsFor	FK_Laktaši
Michael_Schick	hasGender	male
Zetti	playsFor	União_Agrícola_Barbarense_Futebol_Clube
Himesh_Reshammiya	hasMusicalRole	wordnet_guitar_103467517
Bruce_Bennett	diedIn	Santa_Monica,_California
Rob_Friend	playsFor	Molde_FK
Isaac_Cuenca	playsFor	CF_Reus_Deportiu
Landry_Bonnefoi	playsFor	LB_Châteauroux
Markus_Berger	playsFor	Associação_Académica_de_Coimbra_–_O.A.F.
Sean_Astin	hasGender	male
Matthew_Berkeley	playsFor	Leigh_Genesis_F.C.
Rice_University	isLocatedIn	United_States
Lee_Sawyer	playsFor	Dover_Athletic_F.C.
Mark_Jackson_(footballer)	playsFor	Farsley_Celtic_A.F.C.
Mick_Meagan	playsFor	Everton_F.C.
Franco_Basaglia	diedIn	Venice
Cristian_Constantin	playsFor	FC_Unirea_Urziceni
Zineddine_Mekkaoui	playsFor	CS_Constantine
Taner_Demirbaş	playsFor	Adana_Demirspor
Tobias_Rau	playsFor	Eintracht_Braunschweig
Tomas_Žvirgždauskas	playsFor	Polonia_Warsaw
Peter_Barnes_(footballer)	playsFor	Manchester_United_F.C.
Paul_Simpson_(footballer)	playsFor	Finn_Harps_F.C.
Samuel_Beckett	influences	Don_DeLillo
Istvan_Bakx	hasGender	male
Ion_Heliade_Rădulescu	diedIn	Bucharest
Joe_Jakub	playsFor	Chester_City_F.C.
Jérôme_Colinet	playsFor	Lommel_United
Dean_Holdsworth	playsFor	England_national_football_B_team
Russell_Payne_(soccer)	playsFor	Maryland_Mania
Eduardo_Ribeiro_dos_Santos	hasGender	male
Harry_Storer,_Jr.	playsFor	Notts_County_F.C.
Aleksandar_Živković_(footballer_born_1912)	hasGender	male
Alan_Kirby	playsFor	St_Patrick's_Athletic_F.C.
Karl_Marx	influences	Guy_Debord
Adriano_Felício	playsFor	Itumbiara_Esporte_Clube
Jurica_Buljat	hasGender	male
Gilvan_Santos_Souza	playsFor	Gil_Vicente_F.C.
Jan_Berger_(footballer_born_1976)	playsFor	1._FK_Příbram
Matthias_Breitkreutz	playsFor	Aston_Villa_F.C.
Mate_Maleš	hasGender	male
Elias_Alves_da_Silva	playsFor	U.D._Leiria
Roberto_Palacios	playsFor	Sporting_Cristal
Karim_El_Mourabet	playsFor	France_national_under-21_football_team
Nozomi_Hiroyama	playsFor	Japan_national_football_team
Scott_Paterson	playsFor	Cove_Rangers_F.C.
Billy_Watson_(footballer)	playsFor	Fall_River_F.C.
Pablo_Lanz	playsFor	Club_Atlético_Platense
Nattaporn_Phanrit	playsFor	TTM_Customs_F.C.
Abdoulaye_Baldé_(footballer)	playsFor	Amiens_SC
Oleksandr_Hranovskyi	playsFor	FC_Spartak_Moscow
Alan_Mayer	playsFor	New_Jersey_Rockets_(MISL)
Deividas_Česnauskis	playsFor	Baku_FC
Andre_Luiz_de_Souza_Silva	playsFor	Sagan_Tosu
Fabio_Bazzani	playsFor	Brescia_Calcio
Marco_Weißhaupt	playsFor	FC_Rot-Weiß_Erfurt
Michael_Renwick	hasGender	male
Karl_Marginson	playsFor	Rotherham_United_F.C.
Francesco_Ruopolo	playsFor	Aurora_Pro_Patria_1919
Fatmir_Vata	playsFor	KF_Tirana
Otis_Roberts	playsFor	Harrow_Borough_F.C.
Alberto_Maria_Fontana	playsFor	A.S._Roma
Paul_Futcher	playsFor	Derby_County_F.C.
Emre_Aşık	playsFor	İstanbulspor_A.Ş.
Oleg_Belyakov	playsFor	Pakhtakor_Tashkent_FK
Kamran_Agayev	hasGender	male
Sergi_Barjuán	playsFor	FC_Barcelona_B
Cacá_(footballer_born_1979)	playsFor	UD_Las_Palmas
Paulino_Martínez_Soria	playsFor	Atlético_Madrid_B
Mamadou_Diallo	hasGender	male
Jerome_Watt	playsFor	Northampton_Town_F.C.
Kevin_Betsy	playsFor	Wycombe_Wanderers_F.C.
Diego_de_Lima_Barcelos	playsFor	Santos_FC
Alassane_N'Diaye	playsFor	Hastings_United_F.C.
Diogo_Antunes_de_Oliveira	playsFor	Vegalta_Sendai
Shohei_Ikeda	playsFor	JEF_United_Ichihara_Chiba
Jake_Speight	playsFor	Farsley_Celtic_A.F.C.
Rudy_Carlier	playsFor	US_Créteil-Lusitanos
Charis_Yulianto	playsFor	Persib_Bandung
Arthur_Schopenhauer	influences	Thomas_Bernhard
Michaël_Niçoise	playsFor	Paris_Saint-Germain_F.C.
Blagoje_Marjanović	playsFor	Yugoslavia_national_football_team
Alan_Skirton	playsFor	Bristol_City_F.C.
Ludwig_Wittgenstein	hasGender	male
Michael_Baird_(footballer)	playsFor	Central_Coast_Mariners_FC
Zelão	playsFor	Sport_Club_Corinthians_Paulista
Rafael_Bastos	playsFor	PFC_Levski_Sofia
Bobby_Ryan_(footballer)	playsFor	Monaghan_United_F.C.
Alemão_(footballer_born_1961)	playsFor	S.S.C._Napoli
Gustavo_Victoria	hasGender	male
Constantin_Schumacher	playsFor	Guangzhou_Pharmaceuticals
Gheorghe_Andronic	playsFor	HNK_Gorica
Roberto_Nurse	playsFor	C.F._La_Piedad
Jonathan_Bolaños	playsFor	C.S._Cartaginés
Guillermo_Suárez	playsFor	NK_Inter_Zaprešić
Lassina_Diabaté	playsFor	AS_Cannes
Andrew_Durante	hasGender	male
Greg_Vanney	hasGender	male
Dutch_Republic	participatedIn	Second_Anglo-Dutch_War
Silvio_Carrario	hasGender	male
Arthur_Bottom	playsFor	York_City_F.C.
Paul_Hayes	playsFor	Charlton_Athletic_F.C.
Kokushikan_University	isLocatedIn	Japan
Pakistan	hasCapital	Lahore
Davide_Moscardelli	playsFor	Unione_Triestina_2012_S.S.D.
Nikolay_Harizanov	playsFor	PFC_Beroe_Stara_Zagora
New_Zealand	participatedIn	European_theatre_of_World_War_II
Emile_Sinclair	playsFor	Bradford_City_A.F.C.
David_Karanka	playsFor	CF_Extremadura
Carlos_Oliva	playsFor	Platense_F.C.
Sergio_Ballesteros	playsFor	Villarreal_CF
Per_Nilsson_(footballer)	playsFor	Sweden_national_under-21_football_team
Alan_O'Hare	playsFor	York_City_F.C.
Juan_Velásquez	playsFor	Universidad_de_Los_Andes_FC
David_D'Errico	playsFor	Hartwick_College
Phil_Charnock	playsFor	Ballymena_United_F.C.
Augustine_of_Hippo	influences	Blaise_Pascal
Ansar_Ayupov	playsFor	FC_MVD_Rossii_Moscow
Eben_Dugbatey	playsFor	FC_Solothurn
Dragan_Kanatlarovski	playsFor	Karşıyaka_S.K.
Steffen_Iversen	hasGender	male
Andrey_Yeshchenko	hasGender	male
Pablo_Lenci	playsFor	Audax_Italiano
Harry_Morgan	diedIn	Los_Angeles
Mark_Quigley	playsFor	Sligo_Rovers_F.C.
Jon_Angelucci	playsFor	Sydney_United_58_FC
Sotirios_Kyrgiakos	playsFor	Rangers_F.C.
Kevin_Pezzoni	playsFor	FC_Erzgebirge_Aue
Víctor_Aristizábal	playsFor	Atlético_Nacional
Massimo_Gotti	playsFor	U.S._Grosseto_F.C.
Markus_Steinhöfer	playsFor	FC_Basel
Sanel_Jahić	playsFor	UD_Las_Palmas
Ahmed_Deen	playsFor	Hayes_&_Yeading_United_F.C.
Bojan_Jorgačević	playsFor	Al_Ahli_SC_(Doha)
Eduardo_Hurtado	playsFor	Colo-Colo
Wellington_Katzor_de_Oliveira	playsFor	Santos_FC
Ștefan_Grigorie	hasGender	male
Ivica_Mornar	hasGender	male
Ronny_Goodlass	playsFor	Tranmere_Rovers_F.C.
Lawrence_Lozzano	playsFor	New_York_Red_Bulls
Andy_Walker_(footballer_born_1965)	playsFor	Scotland_national_under-21_football_team
Roberto_Ayala	playsFor	Club_Atlético_River_Plate
Serhiy_Bezhenar	hasGender	male
Rodrigo_Barbosa_Rodrigues_Costa	playsFor	Santos_FC
Lee_Kyung-soo	playsFor	Daejeon_Citizen_FC
David_Steele_(footballer)	playsFor	St._Mirren_F.C.
Seo_Dong-won	playsFor	Gwangju_Sangmu_FC
Boima_Karpeh	playsFor	Perth_Glory_FC
Jader_Volnei_Spindler	playsFor	Al_Ahli_Club_(Dubai)
Manuel_José_Vieira	playsFor	Vitória_F.C.
Saúl_Martínez	playsFor	Long_Island_Rough_Riders
Tininho_(Portuguese_footballer)	playsFor	Leixões_S.C.
Viktor_Prokopenko	playsFor	FC_Krystal_Kherson
United_Kingdom	participatedIn	Gulf_War
Ian_Stewart_(Northern_Ireland_footballer)	playsFor	Newcastle_United_F.C.
Gary_O'Neil	playsFor	England_national_under-19_football_team
David_Bentley	playsFor	West_Ham_United_F.C.
Gary_Alexander_(footballer)	playsFor	Exeter_City_F.C.
Jan_Laštůvka	playsFor	Fulham_F.C.
Callum_Tapping	playsFor	Tottenham_Hotspur_F.C.
Gary_Hooper	playsFor	Norwich_City_F.C.
Serhiy_Kravchenko_(footballer_born_1983)	playsFor	FC_Dnipro_Dnipropetrovsk
Curt_Onalfo	playsFor	Virginia_Beach_Mariners
Ștefan_Kovács	playsFor	R.O.C._de_Charleroi-Marchienne
Sérgio_Ricardo_Messias_Neves	playsFor	Fenerbahçe_S.K.
Leandro_Marcolini_Pedroso_de_Almeida	playsFor	Debreceni_VSC
Daniel_Fernandes_(footballer)	playsFor	Portugal_national_under-21_football_team
Sebastián_Abreu	playsFor	Grêmio_Foot-Ball_Porto_Alegrense
Henrik_Ojamaa	playsFor	Estonia_national_under-21_football_team
Rafael_da_Silva_Francisco	playsFor	Associação_Desportiva_São_Caetano
Emil_Angelov	playsFor	PFC_Litex_Lovech
Adolfo_Valencia	playsFor	América_de_Cali
University_of_North_Carolina_at_Chapel_Hill	isLocatedIn	North_Carolina
Dermot_Curtis	playsFor	Exeter_City_F.C.
Łukasz_Surma	playsFor	FC_Admira_Wacker_Mödling
Aleksandar_Benko	hasGender	male
Lee_Camp_(footballer)	playsFor	A.F.C._Bournemouth
Rudy_Doliscat	playsFor	Buffalo_Blizzard
Lawrie_Madden	playsFor	Wolverhampton_Wanderers_F.C.
José_Luís_Santos_da_Visitação	playsFor	Paraná_Clube
John_Harkes	playsFor	D.C._United
Paul_Elliott_(footballer)	playsFor	England_national_football_B_team
Thiago_Marin_Martir	playsFor	Uberaba_Sport_Club
Idrissa_Keita	playsFor	Levante_UD
Michał_Probierz	playsFor	Pogoń_Szczecin
York_City_F.C.	isLocatedIn	York
Noah_Hickey	playsFor	Tampere_United
Stephen_Hunt_(footballer_born_1981)	hasGender	male
Dmitri_Khokhlov	playsFor	FC_Dynamo_Moscow
Kalmar	isLocatedIn	Sweden
Anders_Jacobsen_(footballer)	playsFor	Notts_County_F.C.
Pedro_Torrão	playsFor	S.C._Salgueiros
Viktor_Bulatov	playsFor	FC_SKA-Energiya_Khabarovsk
Timo_Kunert	hasGender	male
John_Stewart_(footballer)	playsFor	Ross_County_F.C.
Fellipe_Bastos	playsFor	Botafogo_de_Futebol_e_Regatas
Erwin_Koen	playsFor	FC_Groningen
Selim_Benachour	playsFor	Vitória_S.C.
Graeme_Atkinson	playsFor	Preston_North_End_F.C.
Miguel_Mea_Vitali	playsFor	Aragua_FC
Christian_Castillo_(footballer)	playsFor	El_Salvador_national_football_team
John_O'Brien_(soccer)	playsFor	Chivas_USA
Arthur_Rimbaud	diedIn	Marseille
Predrag_Lazić	playsFor	CS_Otopeni
André_Ferreira_da_Silva	playsFor	Montedio_Yamagata
Gradimir_Crnogorac	playsFor	Randers_Sportsklub_Freja
Nigel_Quashie	playsFor	Nottingham_Forest_F.C.
Mido_(footballer)	playsFor	Olympique_de_Marseille
Peter_Rufai	hasGender	male
Ján_Kozák_(footballer_born_1954)	playsFor	FC_Lokomotíva_Košice
Robert_Betts	playsFor	Coventry_City_F.C.
Neil_Janczyk	playsFor	Clyde_F.C.
Shaun_Reay	playsFor	Darlington_F.C.
Mike_Trusson	hasGender	male
Alessandro_Turchetta	playsFor	U.S._Grosseto_F.C.
Christophe_Robert	playsFor	Club_Ferro_Carril_Oeste
David_Caiado	playsFor	Associação_Académica_de_Coimbra_–_O.A.F.
Claudio_Graf	playsFor	Quilmes_Atlético_Club
Lee_Baxter	playsFor	Bodens_BK
Nelson_Cuevas	playsFor	Club_Libertad
Roque_Avallay	hasGender	male
Mark_Foran	playsFor	Oldham_Athletic_A.F.C.
Luca_Mezzano	playsFor	U.S._Arezzo
Kostadin_Vidolov	playsFor	Bursaspor
Santiago_Raymonda	playsFor	Argentinos_Juniors
Dekel_Keinan	playsFor	Blackpool_F.C.
Fábio_dos_Santos_Barbosa	playsFor	Fluminense_FC
Andy_Brownrigg	playsFor	Ossett_Albion_A.F.C.
Vincent_Planté	playsFor	AS_Saint-Étienne
Ramiz_Mamedov	hasGender	male
Jermaine_Palmer	playsFor	Stoke_City_F.C.
Frank_Seifert	playsFor	FC_Rot-Weiß_Erfurt
Francesco_Parravicini	playsFor	A.C._Siena
José_Ramalho_Carvalho_de_Freitas	playsFor	Esporte_Clube_Santo_André
Jero_Shakpoke	playsFor	A.C._Reggiana_1919
Marco_Almeida_(footballer_born_1977)	playsFor	F.C._Alverca
Rafael_Barber	playsFor	Ontinyent_CF
Allan_Simonsen	playsFor	Borussia_Mönchengladbach
Paul_Marshall_(footballer)	playsFor	Blackpool_F.C.
Serge_Dié	playsFor	Veria_F.C.
Irmantas_Zelmikas	playsFor	FK_Šilutė
Ahmad_Salah_Alwan	playsFor	Erbil_SC
Mariano_González_Maroto	playsFor	SD_Ponferradina
Don_Hutchison	playsFor	Millwall_F.C.
Derek_Lilley	playsFor	Leeds_United_A.F.C.
Dmitry_Alexandrovich_Smirnov	playsFor	FC_Torpedo_Moscow
Iran	participatedIn	Shia_insurgency_in_Yemen
Sergio_Clerici	playsFor	Associação_Portuguesa_de_Desportos
Aleksandr_Kuchma	hasGender	male
Agustín_Castillo	playsFor	C.S._Herediano
William_James	influences	Martin_Gardner
Igor_Pavlović	playsFor	FK_Napredak_Kruševac
Carlos_Diaz_(American_soccer)	playsFor	Paysandu_Sport_Club
Paul_Peschisolido	playsFor	Luton_Town_F.C.
Igors_Savčenkovs	playsFor	Dinaburg_FC
Ori_Uzan	playsFor	Maccabi_Haifa_F.C.
Elizabeth_Blackburn	hasGender	female
Marcelo_dos_Santos_Marinho	playsFor	Sport_Club_Corinthians_Paulista
Ventsislav_Velinov	playsFor	PFC_Botev_Plovdiv
Lund	isLocatedIn	Scania
Georgi_Bizhev	playsFor	FC_Dorostol_2003
Walter_Guglielmone	playsFor	Neftchi_Baku_PFK
Dorothy_Spencer	edited	Cleopatra_(1963_film)
Nikola_Kalinić	playsFor	HNK_Šibenik
Hans_van_de_Haar	hasGender	male
Nassim_Mendil	playsFor	Paganese_Calcio_1926
Free_French_Forces	participatedIn	Western_Front_(World_War_II)
Gordon_Cowans	hasGender	male
Dragoje_Leković	playsFor	FK_Budućnost_Podgorica
Andreu_Guerao_Mayoral	playsFor	Auckland_City_FC
Willy_Scheepers	playsFor	SV_Darmstadt_98
Thiago_Constância	playsFor	Clube_Atlético_Bragantino
Marco_Airosa	playsFor	Angola_national_football_team
Dawid_Jarka	playsFor	Polonia_Bytom
Martin_Jirouš	playsFor	AC_Sparta_Prague
Armand_Traoré	playsFor	Juventus_F.C.
Peter_McDonnell	playsFor	Dallas_Tornado
Jürgen_Säumel	playsFor	MSV_Duisburg
Mohammed_Abubakari	playsFor	Doxa_Drama_F.C.
Murad_Hüseynov	playsFor	FC_Daugava
Luís_Loureiro	playsFor	Boavista_F.C.
Đorđe_Vlajić	playsFor	FK_Hajduk_Beograd
Geoff_Thomas_(footballer_born_1964)	playsFor	Rochdale_A.F.C.
Andy_Gray_(footballer,_born_1955)	playsFor	Cheltenham_Town_F.C.
Franck_Signorino	playsFor	Stade_Lavallois
Chris_Lemons	playsFor	Cleveland_City_Stars
James_Thompson_(footballer)	playsFor	Luton_Town_F.C.
Robert_Akaruye	playsFor	Al_Ahly_SC
Tom_Ramasut	playsFor	Llanelli_A.F.C.
Djamel_Belmadi	playsFor	Manchester_City_F.C.
Steve_Archibald	playsFor	Blackburn_Rovers_F.C.
Samy-Oyame_Mawene	playsFor	Paris_FC
Alan_Moore_(footballer)	playsFor	Republic_of_Ireland_national_under-17_football_team
Paolo_Sammarco	playsFor	A.C._Milan
Lee_Cook	hasGender	male
Amarildo_Tavares_da_Silveira	playsFor	A.C._Milan
Alexander_Pushkin	hasGender	male
Amarildo_Souza_do_Amaral	playsFor	A.C._Cesena
Preki	playsFor	United_States_men's_national_soccer_team
William_H._Reynolds	edited	Yellowbeard
Yordan_Todorov_(footballer_born_July_1981)	playsFor	FC_Steaua_București
Jiří_Štajner	playsFor	AC_Sparta_Prague
Aleks_Vrteski	playsFor	Perth_Glory_FC
Edison_Fonseca	playsFor	Envigado_F.C.
Paul_Pogba	playsFor	France_national_under-17_football_team
Mario_Suárez_Mata	playsFor	Celta_de_Vigo
Erton_Fejzullahu	hasGender	male
Jonathan_Bachini	playsFor	U.S._Alessandria_Calcio_1912
Don_Heath	playsFor	Crook_Town_A.F.C.
Pachín	playsFor	Real_Betis
Battle_of_the_Somme	isLocatedIn	France
Klaus_Allofs	playsFor	Olympique_de_Marseille
Roberto_Alcântara_Ballesteros	playsFor	Vila_Nova_Futebol_Clube
Luis_Tejada	playsFor	Deportivo_Toluca_F.C.
Wilson_Eduardo	playsFor	Associação_Académica_de_Coimbra_–_O.A.F.
Park_Jae-hong_(footballer_born_1978)	playsFor	Jeonnam_Dragons
Mark_Ovendale	playsFor	Barry_Town_United_F.C.
Gulf_War	happenedIn	Kuwait
Esmail_Halali	hasGender	male
Ismail_Al-Ajmi	playsFor	Kuwait_SC
Richard_Farrer	playsFor	Lincoln_City_F.C.
Siniša_Janković	playsFor	FK_Kolubara
Sebastjan_Cimirotič	playsFor	NK_Olimpija_Ljubljana_(2005)
Luís_Carlos_Correia_Pinto	playsFor	S.L._Benfica
Luís_Gabriel_Sacilotto	playsFor	U.S._Lecce
Dean_Crowe	playsFor	Luton_Town_F.C.
Aleksandar_Madžar_(soccer)	playsFor	Floriana_F.C.
Denni_Conteh	playsFor	KÍ_Klaksvík
Kafoumba_Coulibaly	playsFor	Chonburi_F.C.
Hope_Solo	playsFor	Seattle_Reign_FC
Henry_Onwuzuruike	playsFor	SV_Darmstadt_98
Ștefan_Preda	playsFor	FC_Unirea_Urziceni
Rinaldo_Martino	diedIn	Buenos_Aires
Nicky_Maynard	playsFor	Bristol_City_F.C.
Rasoul_Khatibi	playsFor	PAS_Tehran_F.C.
Antonio_Carlos_da_Silva_Neto	playsFor	Guarani_Futebol_Clube
Neil_Emblen	playsFor	Crystal_Palace_F.C.
Volkan_Kahraman	playsFor	SC_Eisenstadt
William_Aitken_(footballer)	playsFor	AS_Cannes
Yuriy_Martyshchuk	playsFor	Ukraine_national_under-19_football_team
Aleš_Pikl	playsFor	FK_Chmel_Blšany
René_Raphy	playsFor	A.S.D._Sanremese
Yemeni_detainees_at_Guantanamo_Bay	playsFor	Júbilo_Iwata
Demy_de_Zeeuw	playsFor	R.S.C._Anderlecht
Pablo_Coira	playsFor	Recreativo_de_Huelva
Richie_Foran	playsFor	Inverness_Caledonian_Thistle_F.C.
Mariano_Corsico	hasGender	male
Julian_Gray	playsFor	Barnsley_F.C.
Sergio_Floccari	playsFor	Calcio_Montebelluna
Vilmos_Sipos	playsFor	FK_Srem
Fabio_Celestini	playsFor	Levante_UD
Jack_Cork	playsFor	England_national_under-16_football_team
Lampros_Choutos	playsFor	Panionios_G.S.S.
Hanover	isLocatedIn	Lower_Saxony
Stephan_Schulz-Winge	playsFor	1._FC_Kleve
Jon_Stead	playsFor	Sunderland_A.F.C.
Bruno_Vale	playsFor	Varzim_S.C.
Seán_Dillon	playsFor	Republic_of_Ireland_national_under-17_football_team
Ibrahim_Kante	playsFor	Rockford_Rampage
Gualberto_Mojica	playsFor	CFR_Cluj
Andrey_Paryvaew	hasGender	male
Riga_International_Airport	isLocatedIn	Riga
Steve_Evans_(footballer,_born_1962)	playsFor	Clyde_F.C.
Ante_Žanetić	playsFor	HNK_Hajduk_Split
Zdravko_Drinčić	playsFor	FK_Rad
Eduardo_Rergis	playsFor	Jaibos_Tampico_Madero
Maksim_Zinovyev	playsFor	FC_Khimki
Ivans_Lukjanovs	playsFor	FC_Metalurh_Zaporizhya
William_Powell	hasGender	male
Kevin_Ratcliffe	playsFor	Wales_national_football_team
Pavlo_Stepanets	playsFor	FC_Spartak_Nizhny_Novgorod
Jean-Claude_Pagal	playsFor	AS_Saint-Étienne
Markus_Neumayr	playsFor	Viktoria_Aschaffenburg
Clayton_Ferreira_Cruz	playsFor	Sporting_Clube_de_Portugal
Bournemouth_Airport	isLocatedIn	Dorset
Antonio_Núñez	playsFor	Deportivo_de_La_Coruña
Moussa_N'Diaye	playsFor	AC_Ajaccio
Ronny_Johnsen	playsFor	Newcastle_United_F.C.
Rémerson_dos_Santos	playsFor	Clube_Náutico_Capibaribe
Togo	dealsWith	China
Oleg_Sergeyev	playsFor	Russia_national_football_team
David_Belenguer	playsFor	Albacete_Balompié
Vasileios_Pliatsikas	playsFor	AEK_Athens_F.C.
Nikolas_Asprogenis	playsFor	AEP_Paphos_F.C.
Hamad_International_Airport	isLocatedIn	Qatar
Tuto	hasGender	male
Sebastián_Rusculleda	playsFor	Club_Atlético_Tigre
Nikola_Drinčić	playsFor	FK_Partizan
Luanda	isLocatedIn	Africa
Reinaldo_Vicente_Simão	playsFor	Goiás_Esporte_Clube
Cícero_Herbete_de_Oliveira_Melo	playsFor	Brasiliense_Futebol_Clube
Oh_Jang-eun	playsFor	Daegu_FC
Andrija_Delibašić	playsFor	Real_Sociedad
Shingo_Suzuki	playsFor	Albirex_Niigata
Gerrie_Mühren	playsFor	AFC_Ajax
Dušan_Brković	playsFor	FK_Smederevo
Miguel_Mostto	playsFor	Sport_Huancayo
Fabrice_Pancrate	hasGender	male
Joaquín_Caparrós	playsFor	CD_Leganés
Firman_Utina	playsFor	Persma_Manado
Javier_Urruticoechea	playsFor	FC_Barcelona
Siramana_Dembélé	playsFor	AS_Cannes
Keith_Scott_(footballer)	playsFor	Tamworth_F.C.
Daniel_Andersson_(footballer_born_1977)	playsFor	Sweden_national_under-21_football_team
Nikolay_Todorov	playsFor	AS_Cannes
Canada	participatedIn	Operation_Enduring_Freedom_–_Horn_of_Africa
Garry_Kimble	playsFor	Dagenham_&_Redbridge_F.C.
Elliott_Ward	playsFor	Coventry_City_F.C.
Billy_Felton	diedIn	Manchester
Kallum_Higginbotham	playsFor	Accrington_Stanley_F.C.
Imoro_Lukman	playsFor	Hapoel_Rishon_LeZion_F.C.
Steven_Schumacher	playsFor	Everton_F.C.
Josef_Kaufman	playsFor	SK_Slavia_Prague
Sergey_Sosnovski	playsFor	FC_Tom_Tomsk
Wélton_Araújo_Melo	playsFor	Clube_de_Regatas_do_Flamengo
Mate_Dugandžić	playsFor	NK_Lokomotiva
Julio_César_Ribas	playsFor	Sud_América
Michael_Guevara	playsFor	Sport_Boys
Mihail_Majearu	playsFor	FCM_Dunărea_Galați
Zhijiang_Airport	isLocatedIn	Hunan
Alexandre_Kojève	influences	Giorgio_Agamben
Richard_Johnson_(footballer)	playsFor	Newcastle_Jets_FC
Po_(river)	isLocatedIn	Europe
Milan_Belić	playsFor	OFK_Beograd
Marc_Crosas	playsFor	FC_Barcelona_C
Vincenzo_Chiarenza	playsFor	S.S._Lazio
Alex_Dias	playsFor	Brasiliense_Futebol_Clube
Bucharest	isLocatedIn	Europe
Nicolae_Dică	playsFor	FC_Steaua_București
Spain	imports	wordnet_foodstuff_107566340
Alen_Škoro	playsFor	NK_Olimpija_Ljubljana_(defunct)
Daniel_Chiriță	playsFor	FC_UTA_Arad
Upper_Austria	isLocatedIn	Austria
Michael_Lumb_(footballer)	hasGender	male
Ryan_Cresswell	playsFor	Ferencvárosi_TC
Örebro_County	hasCapital	Örebro
No_Byung-jun	playsFor	Ulsan_Hyundai_FC
Paulo_Santos_(Portuguese_footballer)	playsFor	Portugal_national_under-21_football_team
Éldis_Fernando_Damasio	playsFor	CR_Vasco_da_Gama
Anel_Džaka	playsFor	VfL_Osnabrück
Óscar_López_Hernández	playsFor	Go_Ahead_Eagles
Tim_Jerat	playsFor	SG_Wattenscheid_09
Grêmio_Foot-Ball_Porto_Alegrense	isLocatedIn	Porto_Alegre
Igor_Shalimov	playsFor	Soviet_Union_national_football_team
Bruno_Bianchi_(footballer)	playsFor	Atlético_Tucumán
Seven_Years'_War	happenedIn	Kingdom_of_Great_Britain
Jarmo_Ahjupera	playsFor	JK_Viljandi_Tulevik
Erick_Weeks_Lewis	playsFor	Sriwijaya_F.C.
Matías_Cresseri	hasGender	male
Darren_Sheridan	hasGender	male
Clint_Marcelle	playsFor	Scunthorpe_United_F.C.
Jason_Jarrett_(footballer)	playsFor	Bury_F.C.
Jiang_Kun	playsFor	Sichuan_Guancheng_F.C.
Independent_State_of_Croatia	participatedIn	Operation_Barbarossa
Renato_Rafael_Bondi	playsFor	Clube_Atlético_Paranaense
Thiago_Carpini_Barbosa	playsFor	Clube_Recreativo_e_Atlético_Catalano
Rob_Jones_(footballer,_born_1979)	playsFor	Grimsby_Town_F.C.
Bleriot_Heuyot	playsFor	Ciudad_de_Murcia
Jérôme_Boateng	playsFor	Tennis_Borussia_Berlin
Paulo_Ribeiro	playsFor	Vitória_F.C.
Maciej_Szczęsny	playsFor	Legia_Warsaw
John_Barnes_(footballer)	playsFor	England_national_under-21_football_team
Gerard_Piqué	playsFor	Manchester_United_F.C.
Francesco_Virdis	playsFor	U.C._Sampdoria
Battle_of_Vienna	isLocatedIn	Vienna
Marcinho_Guerreiro	playsFor	Real_Murcia
Tommy_Gaynor	playsFor	Shamrock_Rovers_F.C.
Jack_Pelter	playsFor	New_Zealand_national_under-17_football_team
Sugiantoro	hasGender	male
Mark_Bright	playsFor	Crystal_Palace_F.C.
Dmytro_Zozulya	playsFor	FC_Volyn_Lutsk
Miguel_Palanca	playsFor	Elche_CF
Warren_Aspinall	playsFor	Colchester_United_F.C.
Nazi_Germany	participatedIn	North_African_Campaign
João_Pedro_Santos_Gonçalves	playsFor	C.D._Beja
Timișoara	isLocatedIn	Romania
Edmundo_Zura	playsFor	Deportivo_Quito
Benito_Carbone	playsFor	Aston_Villa_F.C.
Sekou_Baradji	playsFor	Le_Mans_FC
Neil_Franklin	playsFor	Crewe_Alexandra_F.C.
Carlos_García_Badías	playsFor	UD_Almería
Derek_Doyle	hasGender	male
Oleg_Kuzmin	playsFor	FC_Spartak_Moscow
Sergei_Kiriakov	playsFor	Russia_national_football_team
Matt_Derbyshire	playsFor	Blackburn_Rovers_F.C.
Song_Zhenyu	playsFor	Chongqing_Lifan_F.C.
Anri_Khagush	playsFor	FC_Spartak_Nizhny_Novgorod
Kid_Rock	hasMusicalRole	wordnet_violin_104536866
Tonnie_Cusell	hasGender	male
Megat_Amir_Faisal_Al_Khalidi_Ibrahim	playsFor	Kedah_FA
Moustapha_Salifou	playsFor	Stade_Brestois_29
Saint-Brieuc	isLocatedIn	Île-de-France
Wýaçeslaw_Krendelew	playsFor	FC_Terek_Grozny
Bob_Mountford	playsFor	Stockport_County_F.C.
Haruki_Seto	playsFor	Balestier_Khalsa_FC
Jimmy_Broad	playsFor	Stoke_City_F.C.
Habib_Sissoko	playsFor	Nîmes_Olympique
Nando_Yosu	playsFor	Gimnástica_de_Torrelavega
Peter_Luccin	playsFor	Real_Zaragoza
British_Raj	participatedIn	Burma_Campaign_1944
Jimmy_Mulisa	playsFor	R.F.C._Tournai
Markus_Münch_(footballer)	hasGender	male
Dionizije_Dvornić	playsFor	FC_Lausanne-Sport
Juninho_Pernambucano	playsFor	Brazil_national_football_team
Alfreð_Finnbogason	playsFor	SC_Heerenveen
John_Tarkpor_Sonkaliey	playsFor	Mighty_Barrolle
Antoni_Łukasiewicz	playsFor	Elche_CF
Alejandro_Sequeira	playsFor	Proodeftiki_F.C.
Steve_Anthrobus	playsFor	Shrewsbury_Town_F.C.
Neco_Martínez	playsFor	Atlético_Nacional
Katowice	isLocatedIn	Silesian_Voivodeship
Emily_Zurrer	playsFor	Canada_women's_national_soccer_team
Omri_Kende	playsFor	Israel_national_under-21_football_team
Bradley_Thomas_(footballer)	playsFor	Crawley_Town_F.C.
Danny_Blanchett	playsFor	Northwood_F.C.
Paddy_Sloan	playsFor	Republic_of_Ireland_national_football_team
Giorgos_Nicolaou	playsFor	Ayia_Napa_F.C.
Martin_Devaney	playsFor	Cheltenham_Town_F.C.
Miguel_Ángel_Benítez	hasGender	male
Chris_Allen_(footballer_born_1989)	playsFor	Swindon_Town_F.C.
Wellington_Silva_(footballer_born_1988)	playsFor	Grêmio_Foot-Ball_Porto_Alegrense
Mirco_Antenucci	playsFor	Calcio_Catania
Stefan_Blank	playsFor	VfB_Stuttgart
University_of_Hamburg	isLocatedIn	Hamburg
Marco_André_Azevedo_Gonçalves	playsFor	Gil_Vicente_F.C.
Cristóbal_Parralo	playsFor	Spain_national_under-21_football_team
Andrej_Komac	playsFor	NK_Olimpija_Ljubljana_(defunct)
Jean-Louis_Borloo	isPoliticianOf	France
Roberto_Maltagliati	playsFor	Cagliari_Calcio
Malcolm_Robertson_(footballer)	playsFor	Raith_Rovers_F.C.
Joseph-Antoine_Bell	playsFor	Olympique_de_Marseille
Patrick_Nyema_Gerhardt	playsFor	CS_Otopeni
Paulo_Antônio_de_Oliveira	playsFor	Al-Ahli_SC_(Jeddah)
Sergei_Filippenkov	playsFor	PFC_CSKA_Moscow
Bayonne	isLocatedIn	Aquitaine
Neil_Cohen	playsFor	Dallas_Sidekicks_(1984–2004)
Nebojša_Vučićević	playsFor	NK_Mura
Moussa_N'Diaye	hasGender	male
Lee_Chun-soo	playsFor	Suwon_Samsung_Bluewings
Jeremy_Christie	playsFor	Perth_Glory_FC
Scott_Shearer	playsFor	Crawley_Town_F.C.
Mame_Niang	playsFor	VfL_Wolfsburg
Erwin_Kostedde	playsFor	MSV_Duisburg
Lucas_António_Silva_de_Oliveira	hasGender	male
Central_African_Republic	dealsWith	Netherlands
Paul_Adcock	playsFor	Saltash_United_F.C.
Ian_Ferguson_(footballer_born_1967)	playsFor	Scotland_national_football_team
Sonny_Anderson	playsFor	Servette_FC
Hoalid_Regragui	playsFor	Grenoble_Foot_38
Cláudio_Pitbull	playsFor	Manisaspor
Lê_Công_Vinh	playsFor	Hanoi_F.C.
Piá_(footballer_born_1982)	playsFor	Calcio_Catania
Elvis_Abbruscato	playsFor	Torino_F.C.
Gianni_Munari	playsFor	A.C._Chievo_Verona
Michelangelo_Minieri	playsFor	A.C._Perugia_Calcio
Netherlands	isLocatedIn	North_America
Arnie_Mausser	playsFor	Jacksonville_Tea_Men
Jussi_Nuorela	playsFor	FC_Haka
Manfred_Seissler	playsFor	1._FC_Pforzheim
Maciej_Kowalczyk	playsFor	Widzew_Łódź
Zekirija_Ramadan	hasGender	male
Mancini_(Brazilian_footballer)	hasGender	male
Geoffrey_Claeys	playsFor	R.E._Mouscron
Oleksandr_Maksymov	playsFor	FC_Metalurh_Zaporizhya
Scott_Fitzgerald_(footballer_born_1979)	playsFor	Hemel_Hempstead_Town_F.C.
Antonio_Calderón	playsFor	UE_Lleida
Ed_de_Goey	playsFor	Sparta_Rotterdam
Pablo_Ibáñez	playsFor	Albacete_Balompié_B
Josef_Obajdin	playsFor	AC_Omonia
Viseu_District	isLocatedIn	Centro_Region,_Portugal
Albert_Einstein	influences	Rudolf_Carnap
Tibetan_Freedom_Concert	happenedIn	Amsterdam
João_Pedro_Silva	playsFor	F.C._Porto_B
Aleksandr_Belozyorov	playsFor	FC_Krylia_Sovetov_Samara
Harold_Halse	diedIn	Colchester
Arthur_Boka	playsFor	ASEC_Mimosas
Marcus_Piossek	playsFor	Germany_national_youth_football_team
Paul_Cézanne	influences	Wallace_Stevens
University_of_Coimbra	isLocatedIn	Centro_Region,_Portugal
Joaquín_Caparrós	playsFor	Real_Madrid_Castilla
Napoléon_(miniseries)	isLocatedIn	United_States
Paul_Masefield	playsFor	Doncaster_Rovers_F.C.
Cristian_Tavio	playsFor	Estudiantes_de_Buenos_Aires
André_Martins	playsFor	Portugal_national_football_team
Mohamed_Sarr	hasGender	male
Scott_Golbourne	playsFor	Reading_F.C.
Kim_Min-soo_(footballer)	playsFor	Gyeongnam_FC
Brandão_(footballer_born_1980)	playsFor	FC_Shakhtar_Donetsk
Peter_Shilton	playsFor	Plymouth_Argyle_F.C.
John_Stuart_Mill	influences	John_Maynard_Keynes
Kiril_Pavlyuchek	playsFor	FC_Luch-Energiya_Vladivostok
Billy_Hibbert	hasGender	male
Srgjan_Zaharievski	playsFor	Anagennisi_Karditsa_F.C.
Robert_Nauseb	playsFor	Bloemfontein_Celtic_F.C.
Vule_Trivunović	playsFor	FC_Khimki
Rudnei_da_Rosa	playsFor	Cruzeiro_Esporte_Clube
Juan_Carlos_Rojo	hasGender	male
Gábor_Demjén	playsFor	Hungary_national_under-17_football_team
Poli_Garcia	playsFor	Cleveland_Force_(1978–88)
Dmitri_Parkhachev	playsFor	FC_Kaisar
Andrzej_Kobylański	playsFor	Tennis_Borussia_Berlin
Jefferson_Bernárdez	playsFor	Deportivo_Petapa
Rocco_Placentino	playsFor	Montreal_Impact
Robert_Kozluk	playsFor	Preston_North_End_F.C.
Haim_Megrelashvili	playsFor	Maccabi_Haifa_F.C.
Thomas_Røll	playsFor	Viborg_FF
Bojan_Krkić	playsFor	Spain_national_football_team
Emmanuel_Omoyinmi	playsFor	Ebbsfleet_United_F.C.
Chris_Whyte	playsFor	Los_Angeles_Lazers
Ivan_Fatić	playsFor	Genoa_C.F.C.
Dragoslav_Šekularac	playsFor	América_de_Cali
Luís_Henrique_Silveira	playsFor	Associação_Ferroviária_de_Esportes
Kevin_Nicol	playsFor	Moss_FK
Donovan_Ricketts	playsFor	LA_Galaxy
Fernando_Horácio_Ávalos	playsFor	Nea_Salamis_Famagusta_FC
Luke_Medley	playsFor	Tottenham_Hotspur_F.C.
Lars_Hirschfeld	playsFor	Tromsø_IL
Urs_Güntensperger	playsFor	FC_Winterthur
Nicolae_Mitea	playsFor	AFC_Ajax
Kazuo_Ozaki	playsFor	Japan_national_under-20_football_team
Thiago_Gentil	playsFor	Sociedade_Esportiva_Palmeiras
Jimmy_Kelly_(Irish_footballer)	playsFor	Liverpool_F.C.
Ronaldo_Rodrigues_de_Jesus	playsFor	Coritiba_Foot_Ball_Club
Kurniawan_Dwi_Yulianto	playsFor	Persela_Lamongan
Bambang_Pamungkas	playsFor	Indonesia_national_under-23_football_team
Willem_van_Hanegem	playsFor	XerxesDZB
Winnie_Haatrecht	playsFor	AFC_Ajax
Dejan_Lekić	playsFor	Serbia_national_football_team
Filip_Marčić	playsFor	HNK_Hajduk_Split
Jocelyn_Blanchard	playsFor	USL_Dunkerque
Arvid_Smit	playsFor	SC_Telstar
Netan_Sansara	playsFor	Walsall_F.C.
David_Graham_(footballer_born_1978)	playsFor	Worksop_Town_F.C.
Jake_Cole	playsFor	Barnet_F.C.
Kenneth_Gustafsson_(footballer_born_1982)	playsFor	Malmö_FF
John_Eriksen	playsFor	FC_Svendborg
Justin_Haber	playsFor	US_Quevilly
Sean_Webb	playsFor	Þór_Akureyri
Steve_Banks	playsFor	St._Johnstone_F.C.
Takafumi_Akahoshi	playsFor	Montedio_Yamagata
Roman_Akhalkatsi	playsFor	Karvan_FK
Eduardo_Souza_Reis	playsFor	Nacional_Esporte_Clube_(MG)
Christian_Saba	playsFor	Hertha_BSC
Marco_Navas	playsFor	CD_Guadalajara_(Spain)
Sicily	isLocatedIn	Palermo
Alen_Orman	playsFor	Dynamo_Dresden
Patrick_Falk	playsFor	Kickers_Offenbach
Edin_Husić	playsFor	FK_Sarajevo
Flórián_Urbán	playsFor	SC_Eendracht_Aalst
Steve_Williams_(footballer_born_1974)	playsFor	Drogheda_United_F.C.
Nicky_Eaden	playsFor	Barnsley_F.C.
Fouad_Bouguerra	playsFor	Nyíregyháza_Spartacus_FC
Roger_Van_Gool	playsFor	Coventry_City_F.C.
Antoine_Devaux	playsFor	Le_Havre_AC
Rafael_Jacques	playsFor	São_Paulo_FC
Nigel_Quashie	playsFor	Southampton_F.C.
Jun_Marques_Davidson	playsFor	Vancouver_Whitecaps_FC
Wágner	playsFor	Cruzeiro_Esporte_Clube
Serhiy_Zeldi	playsFor	SC_Tavriya_Simferopol
Fabricio_Coloccini	playsFor	Newcastle_United_F.C.
Sascha_Bigalke	playsFor	1._FC_Köln
Miguel_Miranda	playsFor	Deportivo_Wanka
Scott_Paterson	playsFor	Liverpool_F.C.
Rob_Matthaei	hasGender	male
Laurent_Merlin	hasGender	male
Teddy_Sheringham	playsFor	Colchester_United_F.C.
Ian_Harte	playsFor	Reading_F.C.
Daniel_Lins_Côrtes	playsFor	FC_Twente
Fabio_Borini	playsFor	Parma_F.C.
Ivan_Klasnić	playsFor	Croatia_national_football_team
Per_Frandsen	playsFor	Wigan_Athletic_F.C.
Graeme_Crawford	playsFor	Scunthorpe_United_F.C.
Bruno_da_Silva_Lopes	playsFor	Albirex_Niigata
Neil_Alexander	playsFor	Ipswich_Town_F.C.
Sam_Wedgbury	playsFor	England_national_football_C_team
Olivier_Kapo	playsFor	Al_Ahli_SC_(Doha)
Tony_Kurbos	playsFor	OGC_Nice
Finland	dealsWith	Norway
Ivica_Iliev	playsFor	FK_Partizan
Carl_Muggleton	playsFor	Cardiff_City_F.C.
Stanislav_Murygin	playsFor	FC_Torpedo_Moscow
Lloyd_Kerry	playsFor	Kidderminster_Harriers_F.C.
Tiago_Rannow	playsFor	Brusque_Futebol_Clube
Faton_Toski	playsFor	Eintracht_Frankfurt
Sigurd_Rushfeldt	playsFor	Birmingham_City_F.C.
Yevgeni_Kuznetsov_(footballer_born_1961)	playsFor	Jeonnam_Dragons
Danny_Crow	hasGender	male
Stanislav_Dubrovin	playsFor	FC_Dynamo_Vologda
Jørgen_Nielsen	playsFor	Wolverhampton_Wanderers_F.C.
Vasile_Ghindaru	playsFor	FC_Astra_Giurgiu
Bartłomiej_Niedziela	playsFor	Ruch_Wysokie_Mazowieckie
Oren_Nissim	playsFor	Hapoel_Be'er_Sheva_F.C.
Alípio	hasGender	male
Carlos_Pavón	playsFor	Real_Valladolid
Don_Goodman	playsFor	Walsall_F.C.
Klaus_Wunder	playsFor	Hannover_96
Jamie_Day_(footballer_born_1979)	playsFor	Crawley_Town_F.C.
Kris_Trajanovski	playsFor	Brisbane_Strikers_FC
Matías_Manrique	playsFor	Peñarol
Tim_Matthys	playsFor	Panthrakikos_F.C.
Rui_Lima	playsFor	Nea_Salamis_Famagusta_FC
Renato_Silva	playsFor	São_Paulo_FC
Alhassane_Keita	playsFor	Horoya_AC
Cornel_Țălnar	playsFor	Romania_national_football_team
Dan_Alexa	playsFor	FC_Dinamo_București
Hernán_Rengifo	playsFor	Lech_Poznań
Nicola_Amoruso	playsFor	A.C._Siena
Stevland_Angus	playsFor	Cambridge_United_F.C.
Michał_Matyas	diedIn	Kraków
Sławomir_Majak	playsFor	Anorthosis_Famagusta_FC
Rasmus_Bengtsson	playsFor	Hertha_BSC
Danny_Waltman	playsFor	Missouri_Comets
Enkeleid_Alikaj	playsFor	KF_Teuta_Durrës
Alessandro_Cambalhota	playsFor	Grêmio_Esportivo_Novorizontino
Bruno_Coutinho_Martins	playsFor	Esporte_Clube_Pelotas
Tenema_N'Diaye	playsFor	Dubai_CSC
Uwe_Wolf	playsFor	S.C._Freamunde
Serkan_Özsoy	playsFor	Manisaspor
Richard_Rorty	isInterestedIn	Philosophy_of_language
Wiborada	playsFor	Republic_of_Ireland_national_under-23_football_team
Khalilou_Fadiga	playsFor	Lommel_United
Ion_Testemițanu	playsFor	Bristol_City_F.C.
Roman_Adamov	playsFor	FC_Rostov
United_States	participatedIn	Operation_Enduring_Freedom
Peter_Buljan	playsFor	Canberra_Cosmos_FC
Farhad_Majidi	playsFor	Esteghlal_F.C.
Luca_Lacrimini	playsFor	A.C._Perugia_Calcio
Mario_Been	playsFor	A.C._Pisa_1909
Kjetil_Wæhler	playsFor	IFK_Göteborg
Emerson_da_Luz	playsFor	F.C._Maia
Narongchai_Vachiraban	playsFor	Thailand_national_football_team
Carlos_Villagra	playsFor	C.S.D._Municipal
Eduardo_Carvalho	playsFor	Vitória_F.C.
Adebayo_Akinfenwa	playsFor	Swansea_City_A.F.C.
Attila_Polonkai	playsFor	Rákospalotai_EAC
Diogo_Lézico_da_Silva	playsFor	Associação_Naval_1º_de_Maio
Kakhaber_Gogichaishvili	playsFor	FC_Dinamo_Tbilisi
Stewart_Greacen	playsFor	Greenock_Morton_F.C.
Graham_Hyde	playsFor	Worcester_City_F.C.
Andy_King_(footballer,_born_1956)	playsFor	Southport_F.C.
Gustavo_Lombardi	playsFor	Deportivo_Alavés
Andrija_Anković	hasGender	male
Rob_Quinn	playsFor	Cray_Wanderers_F.C.
Trifon_Ivanov	playsFor	FK_Austria_Wien
Evgeni_Yordanov_(footballer)	playsFor	PFC_Pirin_Blagoevgrad
Marco_Engelhardt	playsFor	Germany_national_football_B_team
Felipe_Manoel_Gonçalves	playsFor	Levante_UD
Roger_Milla	playsFor	Putra_Samarinda_F.C.
Yuri_Shishkin	playsFor	Rio_Branco_Esporte_Clube
Viktor_Paço	playsFor	Flamurtari_Vlorë
Danny_Tiatto	playsFor	FC_Baden
Denis_Calincov	playsFor	Heracles_Almelo
Mário_Carlos	playsFor	F.C._Barreirense
Bertin_Tomou	playsFor	Guangzhou_Evergrande_F.C.
Mike_Huwiler	hasGender	male
Ismael_Urzaiz	playsFor	Celta_de_Vigo
Oscar_Dertycia	playsFor	Club_Atlético_Belgrano
Jaime_Miguel_Linares	playsFor	Gondomar_S.C.
Bobby_Ham	hasGender	male
Henri_Bergson	influences	Zaki_al-Arsuzi
Daniel_Francis_(footballer)	playsFor	Leyton_F.C.
Ion_Dumitru	playsFor	Romania_national_football_team
Samir_Hadjaoui	playsFor	JS_Kabylie
Lee_Morris_(footballer)	playsFor	Huddersfield_Town_F.C.
Louis-Ferdinand_Céline	influences	Kurt_Vonnegut
Kevaughn_Connell	hasGender	male
I_Gusti_Bayu_Sutha	playsFor	Persiram_Raja_Ampat
Jorge_Curbelo	playsFor	Real_Valladolid
Mikko_Paatelainen	hasGender	male
Mark_Staunton	playsFor	Berwick_Rangers_F.C.
Tommy_Rigg	playsFor	Watford_F.C.
Lucian_Goian	playsFor	Foresta_Fălticeni
Moacir_Rodrigues_Santos	playsFor	Associação_Portuguesa_de_Desportos
Bakary_Diakité	playsFor	TuS_Koblenz
Jiří_Homola	playsFor	FK_Baumit_Jablonec
Abbas_Saad	playsFor	Al_Sadd_SC
Dave_Rainford	playsFor	Scarborough_F.C.
Ike_Shorunmu	playsFor	Beşiktaş_J.K.
Julien_Rantier	playsFor	S.S.D._Piacenza_Calcio_1919
Erman_Güraçar	playsFor	Gaziantepspor
Arie_van_Lent	playsFor	Rot-Weiss_Essen
Nenad_Brnović	playsFor	FK_Hajduk_Kula
Romik_Khachatryan	playsFor	AEP_Paphos_F.C.
Brian_Bliss	playsFor	Sporting_Kansas_City
Leandro_Rodrigues	playsFor	Mogi_Mirim_Esporte_Clube
Peter_Løvenkrands	playsFor	Akademisk_Boldklub
Federico_Peluso	playsFor	Atalanta_B.C.
Nebojša_Marinković	playsFor	FK_Partizan
Luís_Oliveira	playsFor	Bologna_F.C._1909
Elbe	isLocatedIn	Hamburg
Guillem_Bauzà	playsFor	Swansea_City_A.F.C.
Chris_Ward_(footballer)	playsFor	Bamber_Bridge_F.C.
Manuel_Gaspar_Haro	playsFor	Atlético_Malagueño
Stevie_Nicholas	hasGender	male
Murat_Şahin	playsFor	Belediye_Vanspor
Paweł_Buśkiewicz	playsFor	Flota_Świnoujście
Allan_Oviedo	playsFor	L.D._Alajuelense
Max_Vieri	playsFor	Ternana_Calcio
David_Addy	playsFor	All_Stars_F.C.
Antonio_Ghomsi	hasGender	male
Gabriel_Álvez	playsFor	Defensor_Sporting
Dare_Vršič	playsFor	FK_Austria_Wien
Dean_Delany	playsFor	Waterford_United_F.C.
Ilyos_Zeytulayev	hasGender	male
Felipe_Dias_da_Silva	playsFor	Clube_Atlético_Juventus
Joël_Tiéhi	playsFor	Ivory_Coast_national_football_team
Marco_Né	playsFor	Beerschot_AC
Leo_Canjels	playsFor	NAC_Breda
Axel_Smeets	playsFor	R._Charleroi_S.C.
Phil_Kite	playsFor	Plymouth_Argyle_F.C.
Arnar_Gunnlaugsson	playsFor	1._FC_Nürnberg
Dejan_Živković_(footballer_born_1979)	playsFor	FK_Voždovac
Paulo_Chávez	playsFor	C.D._Guadalajara
Witold_Wawrzyczek	playsFor	Ruch_Chorzów
Jack_Brand	playsFor	Seattle_Sounders_(1974–83)
Mike_Lapper	hasGender	male
Lucas_Ayala	hasGender	male
Arthur_Rimbaud	influences	André_Breton
Danny_Hay	playsFor	Walsall_F.C.
Tuta_(footballer)	playsFor	Figueirense_Futebol_Clube
Sylwester_Czereszewski	playsFor	Legia_Warsaw
Igor_Petković	playsFor	FK_Srem
Saša_Kovačević	playsFor	Erzurumspor
Steven_Pelé	playsFor	FC_Gueugnon
Ha_Seok-ju	playsFor	South_Korea_national_under-23_football_team
Mohamed_Farouk	playsFor	Al_Ahly_SC
Chu_Siu_Kei	playsFor	Hong_Kong_Rangers_FC
Jesús_María_Lacruz	playsFor	CA_Osasuna_B
Alejandro_Mello	playsFor	Atlético_Bucaramanga
Jean-Pierre_Cyprien	playsFor	Neuchâtel_Xamax
Malvin_Kamara	playsFor	Sierra_Leone_national_football_team
Craig_Farrell_(footballer)	playsFor	A.F.C._Telford_United
Ahmad_Latiff_Khamaruddin	playsFor	Tanjong_Pagar_United_FC
Predrag_Filipović_(footballer)	playsFor	Roda_JC_Kerkrade
Mikheil_Jishkariani	playsFor	Wormatia_Worms
Stephen_Armstrong	playsFor	Watford_F.C.
Ljubiša_Ranković	playsFor	Stade_Malherbe_Caen
Jani_Tapani_Virtanen	playsFor	Udinese_Calcio
Milan_Živadinović	playsFor	Red_Star_Belgrade
Kevin_Mirallas	playsFor	AS_Saint-Étienne
Robbie_Winters	playsFor	Luton_Town_F.C.
Darren_Young_(Scottish_footballer)	playsFor	Queen_of_the_South_F.C.
Dean_Saunders	playsFor	Sheffield_United_F.C.
Willian_Gomes_de_Siqueira	playsFor	Guarani_Futebol_Clube
Worcester	isLocatedIn	England
Landon_Ling	playsFor	FK_Baumit_Jablonec
Periklis_Bousinakis	playsFor	Olympiacos_Volou_1937_F.C.
Sam_Vokes	playsFor	Burnley_F.C.
Reginaldo_Araújo	playsFor	Clube_de_Regatas_do_Flamengo
Danny_Graham_(footballer)	playsFor	Blackpool_F.C.
Diego_Rodríguez_Fernández	playsFor	CD_Tenerife
Metin_Aktaş	playsFor	Adana_Demirspor
David_Myrie	playsFor	Costa_Rica_national_under-20_football_team
Matt_Dickins	playsFor	Leyton_Orient_F.C.
Kosovo	hasCurrency	Euro_sign
Juan_Sánchez_Moreno	playsFor	Valencia_CF
Emmanuel_Culio	playsFor	Deportes_La_Serena
Anwar_Uddin	playsFor	Sutton_United_F.C.
Javier_de_Pedro	playsFor	Spain_national_football_team
Kevin_Schindler	playsFor	F.C._Hansa_Rostock
Gilles_Sunu	playsFor	Arsenal_F.C._Academy
James_Keene_(footballer)	playsFor	IF_Elfsborg
Risto_Kallaste	playsFor	Viborg_FF
Paulo_Costa_(footballer)	playsFor	APOEL_FC
Murat_Suyumagambetov	playsFor	Kazakhstan_national_under-21_football_team
Taro_Hasegawa	playsFor	Ventforet_Kofu
Māris_Smirnovs	playsFor	Latvia_national_football_team
Deni_Gaisumov	playsFor	FC_Atyrau
Almamy_Doumbia	playsFor	A.S._Bari
Martín_Romagnoli	playsFor	Club_Atlético_Colón
Francisco_De_Paula_Bazán	playsFor	Deportivo_Wanka
Iago_Bouzón	hasGender	male
Matteo_Ferrari	hasGender	male
Jérôme_Boateng	playsFor	Hamburger_SV
Jussi_Nuorela	hasGender	male
Erich_Brabec	playsFor	FK_Drnovice
Gareth_Sheldon	playsFor	England_national_football_C_team
Barry_Horne_(footballer)	playsFor	Portsmouth_F.C.
Aslan_Kerimov	playsFor	Baku_FC
Eintracht_Frankfurt	isLocatedIn	Hesse
Serhiy_Kovalenko	hasGender	male
Luís_Lourenço	hasGender	male
Andy_Marshall	playsFor	England_national_under-18_football_team
Patrice_Kwedi	playsFor	HNK_Šibenik
John_Devine_(footballer_born_1958)	playsFor	Norwich_City_F.C.
Kevin_Kilbane	playsFor	Republic_of_Ireland_national_under-21_football_team
Mark_Stuart_(footballer)	playsFor	Southport_F.C.
Niklas_Sandberg	playsFor	Helsingborgs_IF
Joe_Devine	playsFor	Burnley_F.C.
David_Mills_(footballer)	playsFor	Darlington_F.C.
Davide_Carrus	playsFor	Cagliari_Calcio
Ally_MacLeod	playsFor	Hibernian_F.C.
Raffaele_Palladino	hasGender	male
Maurice_Merleau-Ponty	influences	Cornelius_Castoriadis
Ismaël_Alassane	playsFor	Enyimba_International_F.C.
Ally_Pickering	playsFor	Rotherham_United_F.C.
Wilfrid_Loizeau	playsFor	Guadeloupe_national_football_team
Kire_Ristevski	playsFor	FK_Pelister
Farzad_Hatami	playsFor	Tractor_Sazi_F.C.
Marvin_Pourié	hasGender	male
Anthony_Barry_(footballer)	playsFor	Accrington_Stanley_F.C.
Josh_Hansen	playsFor	Vancouver_Whitecaps_(1986–2010)
Michael_Mancienne	playsFor	England_national_under-16_football_team
Gennaro_Delvecchio	playsFor	U.C._Sampdoria
Joe_Lawless	playsFor	St_Patrick's_Athletic_F.C.
Chad_Severs	playsFor	Pittsburgh_Riverhounds
Amrish_Puri	hasGender	male
Josh_Gardner_(soccer)	playsFor	Carolina_RailHawks
Marcelo_Espina	playsFor	Argentina_national_football_team
Cayetano_Ré	playsFor	Terrassa_FC
Carl_Fletcher_(Canadian_soccer)	playsFor	Canada_men's_national_soccer_team
Budimir_Vujačić	playsFor	FK_Vojvodina
Maciej_Kowalczyk	playsFor	Kolejarz_Stróże
Franco_Zuculini	playsFor	Argentina_national_football_team
Ferdinand_Swatosch	playsFor	1._Simmeringer_SC
Victor_Nogueira	hasGender	male
Michael_Panopoulos	playsFor	Oakleigh_Cannons_FC
Jackie_Brown_(footballer)	playsFor	Ipswich_Town_F.C.
Tomas_Danilevičius	playsFor	U.S._Latina_Calcio
Anselmo_Ramon	playsFor	Avaí_Futebol_Clube
Steve_Lovell	playsFor	Dundee_F.C.
Leandro_Costa_Miranda_Moraes	playsFor	FC_Spartak_Kostroma
Ashley_Carew	hasGender	male
Hadis_Zubanović	playsFor	Zagłębie_Sosnowiec
Scott_McGarvey	playsFor	Aris_Limassol_F.C.
Boxer_Rebellion	happenedIn	Russian_Empire
Ali_Krieger	hasGender	female
Gennaro_Troianiello	playsFor	S.S._Ischia_Isolaverde
Evandro_Teixeira_Magalhães	playsFor	Fortaleza_Esporte_Clube
Bogdan_Zając	playsFor	Hutnik_Nowa_Huta
Marco_Navas	hasGender	male
Kakhaber_Tskhadadze	playsFor	FC_Dinamo_Tbilisi
Markus_von_Ahlen	playsFor	SV_Meppen
Marcelo_Elizaga	playsFor	Club_Sport_Emelec
Édgar_Barreto	playsFor	N.E.C._(football_club)
Jan_Seifert	hasGender	male
Sergei_Serdyukov	playsFor	FC_Tyumen
Sergio_Ramos	hasGender	male
Marcus_Bignot	playsFor	Rushden_&_Diamonds_F.C.
Lee_Jones_(footballer_born_1970)	playsFor	Morecambe_F.C.
Ousseni_Zongo	playsFor	F.C._Arouca
Craig_Foster	playsFor	Australia_national_under-17_association_football_team
Tony_Agana	playsFor	Cliftonville_F.C.
Bruno_Carotti	playsFor	FC_Nantes
Jon_Brady	playsFor	Chester_City_F.C.
Patrik_Lomski	playsFor	Seinäjoen_Jalkapallokerho
John_Colquhoun_(footballer)	playsFor	Celtic_F.C.
Bulgaria	dealsWith	Germany
Philip_McCloy	playsFor	Scotland_national_football_team
Diego_Pereira_Corrêa	playsFor	Mirassol_Futebol_Clube
Alexander_Ødegaard	playsFor	FC_Metz
Philip_Ifil	playsFor	England_national_under-16_football_team
Jean_Deloffre	playsFor	France_national_football_team
Scott_Booth	playsFor	FC_Twente
Ray_Hankin	playsFor	Middlesbrough_F.C.
Marlon_Beresford	playsFor	Wolverhampton_Wanderers_F.C.
Democratic_Party_of_Japan	isLocatedIn	Tokyo_(prefecture)
Stavanger_Airport,_Sola	isLocatedIn	Sola
Ilyos_Zeytulayev	playsFor	HNK_Gorica
Ebelio_Ordóñez	playsFor	Club_9_de_Octubre
Adam_Łagiewka	playsFor	Tur_Turek
Stewart_Jump	playsFor	Houston_Hurricane
Oleh_Protasov	playsFor	Proodeftiki_F.C.
Jason_van_Blerk	playsFor	Shrewsbury_Town_F.C.
Florin_Prunea	playsFor	FCM_Bacău
Jean_Fernandez	playsFor	Olympique_de_Marseille
Leonardo_Pereira_de_Oliveira	hasGender	male
Peter_Jackson_(footballer_born_1937)	playsFor	Altrincham_F.C.
Steve_Mildenhall	playsFor	Oldham_Athletic_A.F.C.
Edson_Ratinho	hasGender	male
Unai_Expósito	playsFor	Barakaldo_CF
Mamuka_Tsereteli	playsFor	Saba_Qom_F.C.
Finland	participatedIn	War_on_Terror
Lloyd_Dyer	playsFor	Leicester_City_F.C.
Diego_de_Souza_Andrade	playsFor	FC_Metalist_Kharkiv
Thiago_Marin_Martir	playsFor	Araxá_Esporte_Clube
The_Bahamas	dealsWith	Canada
Libya	exports	wordnet_chemical_114806838
Marcelo_Delgado	hasGender	male
Robin_Shroot	playsFor	Stevenage_F.C.
Paul_Brayson	hasGender	male
Ronaldo_Tres	playsFor	Clube_Atlético_Paranaense
K._Balachander	hasGender	male
Cayetano_Ré	hasGender	male
Johnny_Ekström	playsFor	AS_Cannes
Junichi_Inamoto	playsFor	Cardiff_City_F.C.
Andrea_Pazzagli	playsFor	A.C._Prato
Wellington_da_Silva_Serezuella	playsFor	América_Futebol_Clube_(SP)
Viorel_Ion	playsFor	FC_Steaua_București
Paul_Cominges	playsFor	Estudiantes_de_Medicina
Yokohama	isLocatedIn	Kanagawa_Prefecture
Wes_Hoolahan	playsFor	Livingston_F.C.
Jaroslav_Kolbas	playsFor	1._FC_Tatran_Prešov
Aleksandar_Popović_(footballer)	playsFor	NK_Olimpija_Ljubljana_(defunct)
Tiago_Mendes	hasGender	male
Piero_Braglia	playsFor	Calcio_Catania
Eduard_Grosu	playsFor	Moldova_national_football_team
F._Scott_Fitzgerald	influences	Mohsin_Hamid
Moldova	dealsWith	Germany
Alfredo_Obberti	playsFor	Newell's_Old_Boys
Henrik_Agerbeck	playsFor	US_Orléans
Daigo_Kobayashi	playsFor	Tokyo_Verdy
Jhonny_Cubero	playsFor	Club_Xelajú_MC
Predrag_Ocokoljić	playsFor	AEL_Limassol
Mark_Watson_(Canadian_soccer)	playsFor	New_England_Revolution
Mykhaylo_Olefirenko	playsFor	FC_Shakhtar_Donetsk
Bruno_Akrapović	playsFor	VfL_Wolfsburg
Eyjólfur_Héðinsson	playsFor	Fylkir
Ernie_Campbell	playsFor	Chelsea_F.C.
Julio_Irrazábal	playsFor	Hércules_CF
Josh_Lennie	playsFor	AFC_Wimbledon
Danleigh_Borman	playsFor	Mpumalanga_Black_Aces_F.C.
Teemu_Pukki	playsFor	Sevilla_FC
Pavel_Byahanski	playsFor	FC_Illichivets_Mariupol
Cono_Aguiar	playsFor	Club_Atlético_River_Plate_(Montevideo)
Mark_Roberts_(footballer,_born_1975)	playsFor	Airdrieonians_F.C.
Robert_Malcolm	playsFor	Cowdenbeath_F.C.
Fábio_Santos_da_Silva	hasGender	male
Petar_Zanev	playsFor	FC_Pirin_Blagoevgrad
Leandro_Scartascini	playsFor	A.S.D._Manfredonia_Calcio_1932
Ofir_Haim	playsFor	Maccabi_Herzliya_F.C.
San_Francisco_Bay_Area	isLocatedIn	United_States
Pius_Ndiefi	playsFor	ASOA_Valence
David_Hodgson_(footballer)	playsFor	Liverpool_F.C.
Andy_Mate	hasGender	male
Lenílson_Batista_de_Souza	playsFor	Duque_de_Caxias_Futebol_Clube
Steve_Morrow	playsFor	Watford_F.C.
Issiar_Dia	playsFor	Fenerbahçe_S.K._(football)
Grzegorz_Kmiecik	playsFor	ŁKS_Łódź
Palestinian_territories	hasOfficialLanguage	Arabic_language
Zurab_Khizanishvili	playsFor	Dundee_F.C.
Jean-Paul_Sartre	influences	Alain_Badiou
Marama_Vahirua	playsFor	AS_Nancy
Pierrick_Cros	hasGender	male
Hans-Jörg_Butt	playsFor	VfB_Oldenburg
Daniel_Marques_da_Silva	playsFor	América_Futebol_Clube_(SP)
Charles_Amoah	hasGender	male
Yura_Movsisyan	hasGender	male
Dean_Howell	playsFor	Spalding_United_F.C.
Gerardo_Martino	playsFor	O'Higgins_F.C.
Dušan_Savić_(footballer_born_1985)	playsFor	FC_Volyn_Lutsk
Dino_Seremet	playsFor	NK_Maribor
Equatorial_Guinea	participatedIn	Nigerian_Civil_War
Idriss_Carlos_Kameni	playsFor	Kadji_Sports_Academy
Abdelkarim_Kissi	playsFor	Ethnikos_Achna_FC
Miloslav_Kousal	playsFor	Berliner_FC_Dynamo
Christian_Rodrigo_Zurita	hasGender	male
Leopold_Kielholz	playsFor	FC_St._Gallen
Somalia	dealsWith	Italy
Michael_Rose_(footballer)	playsFor	Norwich_City_F.C.
Ian_Walker_(footballer)	playsFor	Tottenham_Hotspur_F.C.
Goran_Adamović	playsFor	FK_Zemun
Vladimir_Dvalishvili	playsFor	Maccabi_Haifa_F.C.
Chibuzor_Chilaka	playsFor	Bradford_City_A.F.C.
Danny_Brown_(footballer)	playsFor	Crawley_Town_F.C.
John_Sheridan_(footballer)	playsFor	Manchester_City_F.C.
Mihăiță_Pleșan	playsFor	FC_Universitatea_Craiova
Kai_Michalke	playsFor	VfL_Bochum
Michael_Obiku	playsFor	AZ_Alkmaar
Gerry_McCabe	hasGender	male
Edgaras_Česnauskis	hasGender	male
Thuringia	isLocatedIn	Erfurt
Borut_Semler	playsFor	FC_Akzhayik
Martin_Hyský	playsFor	FC_Slovan_Liberec
Andy_O'Brien_(footballer)	hasGender	male
Marvin_Williams_(footballer)	playsFor	Brentford_F.C.
Timo_Hildebrand	playsFor	TSG_1899_Hoffenheim
Josip_Skoko	playsFor	K.R.C._Genk
Bobby_McKay	diedIn	Glasgow
Honduras	exports	wordnet_coffee_bean_107929351
Oleh_Mazurenko	playsFor	FC_Dynamo-2_Kyiv
Renaldo_Kalari	playsFor	Ternana_Calcio
Edet_Otobong	playsFor	Tonnerre_Yaoundé
Gökhan_Emreciksin	hasGender	male
Oceano_da_Cruz	playsFor	Portugal_national_football_team
Marlon_de_Jesús	playsFor	C.F._Monterrey
Krum_Bibishkov	playsFor	PFC_Pirin_Blagoevgrad
Tommy_Coyne	playsFor	Dundee_F.C.
Alen_Stevanović	playsFor	Serbia_national_football_team
Dmitri_Zinovich	playsFor	FC_Lokomotiv-2_Moscow
Dawda_Bah	playsFor	FC_Augsburg
Carlo_Corazzin	hasGender	male
Colin_Scott_(footballer)	playsFor	Clydebank_F.C.
Marlon_de_Jesús	playsFor	Ecuador_national_football_team
Germano_Borovicz_Cardoso_Schweger	playsFor	Londrina_Esporte_Clube
Brown_Ideye	playsFor	Nigeria_national_football_team
Paulo_Costa_(footballer)	playsFor	Anorthosis_Famagusta_FC
István_Nyers	playsFor	Calcio_Lecco_1912
Igor_Stefanović	playsFor	FK_Zemun
Jason_Withe	playsFor	Stockport_County_F.C.
Seydou_Traoré	playsFor	Qadsia_SC
Livio_Prieto	playsFor	Duque_de_Caxias_Futebol_Clube
Danny_Milosevic	playsFor	Leeds_United_A.F.C.
Begençmuhammet_Kulyýew	playsFor	Köpetdag_Aşgabat
Rytis_Leliūga	playsFor	VMFD_Žalgiris_Vilnius
Chaudhary_Charan_Singh_Airport	isLocatedIn	Lucknow
Roger_Jones_(footballer_born_1946)	playsFor	Blackburn_Rovers_F.C.
Eastern_Front_(World_War_II)	happenedIn	Latvia
Karl_Pearson	isCitizenOf	United_Kingdom
Mark_Kerlin	playsFor	Wichita_Wings
Juan_Enrique_García	playsFor	Caracas_FC
Rónald_Gómez	playsFor	L.D._Alajuelense
Guillermo_Amor	hasGender	male
Ivica_Jaraković	playsFor	1._FC_Magdeburg
Daisuke_Sakata	playsFor	Japan_national_under-20_football_team
Danny_Westwood	playsFor	Aveley_F.C.
Carlos_Bueno	playsFor	Boca_Juniors
James_McClean	playsFor	Wigan_Athletic_F.C.
Marco_Engelhardt	playsFor	1._FC_Kaiserslautern
Franck_Rolling	playsFor	Leicester_City_F.C.
Lin_Junsheng	playsFor	Hong_Kong_national_under-23_football_team
Daniel_P._Hanley	hasGender	male
Ilya_Blyznyuk	playsFor	FC_Rostov
Ryan_Cresswell	playsFor	Southend_United_F.C.
Sandro_Goiano	playsFor	Paysandu_Sport_Club
Harry_Osman	playsFor	Bristol_City_F.C.
León_Darío_Muñoz	hasGender	male
Paul_Peschisolido	playsFor	Sheffield_United_F.C.
Mathieu_Béda	playsFor	FC_Zürich
Jens_Martin_Knudsen_(footballer)	playsFor	Faroe_Islands_national_football_team
Germán_Arangio	playsFor	Club_Atlético_Huracán
Julien_Baudet	playsFor	Oldham_Athletic_A.F.C.
Marcelinho_Rodrigues	playsFor	Bursaspor
Abdullahi_Ishaka	playsFor	Shkumbini_Peqin
Glen_Little	playsFor	Aldershot_Town_F.C.
Samuel_Firmino_de_Jesus	playsFor	Joinville_Esporte_Clube
Ventsislav_Bonev	playsFor	FC_Vitosha_Bistritsa
Danijel_Pranjić	playsFor	Croatia_national_under-21_football_team
Gunnar_Nielsen_(footballer)	playsFor	Havnar_Bóltfelag
Mike_Trebilcock	playsFor	Torquay_United_F.C.
Denmark	participatedIn	Second_Crusade
Alejandro_Vázquez_Sotorrío	playsFor	Cultural_y_Deportiva_Leonesa
Grigory_Potemkin	diedIn	Iași
Vagif_Javadov	playsFor	Baku_FC
Richie_Ryan_(footballer)	playsFor	Royal_Antwerp_F.C.
Denílson_de_Oliveira_Araújo	hasGender	male
Izale_McLeod	playsFor	Portsmouth_F.C.
Irinel_Voicu	playsFor	FC_Unirea_Urziceni
Arthur_Bottom	playsFor	Chesterfield_F.C.
Fabio_Grosso	playsFor	Inter_Milan
Gary_Etherington	playsFor	New_York_Cosmos
Daniel_Majstorović	playsFor	AEK_Athens_F.C.
Alan_McLoughlin	playsFor	Portsmouth_F.C.
Micah_Hyde_(footballer)	playsFor	Aveley_F.C.
Sotiris_Ninis	playsFor	Greece_national_under-21_football_team
Víctor_Núñez	playsFor	Deportivo_Saprissa
Rafał_Grzelak	playsFor	Ruch_Chorzów
Andrzej_Juskowiak	playsFor	Poland_national_football_team
Luděk_Mikloško	playsFor	FC_Baník_Ostrava
Michael_Spies	playsFor	Borussia_Mönchengladbach
Collins_John	playsFor	Netherlands_national_football_team
Parral_(footballer)	playsFor	Guarani_Futebol_Clube
Bartosz_Tarachulski	playsFor	Kalloni_F.C.
Grant_Basey	playsFor	Wales_national_under-19_football_team
Hadi_Aghily	playsFor	Sepahan_Isfahan_F.C.
Ionel_Ganea	playsFor	FC_Dinamo_București
Milovan_Milović	playsFor	KS_Dinamo_Tirana
Steve_Pittman	playsFor	Sporting_Kansas_City
Grégory_Malicki	playsFor	Dijon_FCO
Bruno_Ferraz_das_Neves	playsFor	Fluminense_FC
Sašo_Fornezzi	playsFor	SC_Wiener_Neustadt
Yves_Ma-Kalambay	hasGender	male
Emmanuel_Okoduwa	playsFor	FC_Arsenal_Kyiv
Daniel_Martín	playsFor	Cádiz_CF
Krisztián_Csillag	playsFor	BKV_Előre_SC
Norman_Piper	playsFor	Fort_Lauderdale_Strikers_(1977–83)
Somen_Tchoyi	playsFor	West_Bromwich_Albion_F.C.
Scott_Marshall_(footballer)	playsFor	Celtic_F.C.
Luis_Jonne	playsFor	Deportivo_Quito
Steve_von_Bergen	playsFor	FC_Zürich
Túlio_Maravilha	playsFor	Brasiliense_Futebol_Clube
Srđan_Blažić	playsFor	Nea_Salamis_Famagusta_FC
Tomáš_Ujfaluši	playsFor	Czech_Republic_national_football_team
Julio_César_Manzur	playsFor	C.F._Pachuca
Rainer_Wirth	playsFor	Deportes_Iquique
José_Veiga	playsFor	Hereford_United_F.C.
Matt_Doughty	playsFor	Altrincham_F.C.
Scott_Jamieson	playsFor	Perth_Glory_FC
Asaf_Ben-Muha	playsFor	Maccabi_Yavne_F.C.
Aarón_Galindo	playsFor	Deportivo_Toluca_F.C.
Christopher_Guest	isCitizenOf	United_States
Stefan_Kuntz	playsFor	Arminia_Bielefeld
Joseph_Conrad	influences	David_Mitchell_(author)
Erison_da_Silva_Santos	playsFor	PFC_Slavia_Sofia
Leandro_Salino	playsFor	Clube_de_Regatas_do_Flamengo
Dejan_Vukadinović	playsFor	Diósgyőri_VTK
Sam_Adkins_(footballer)	playsFor	Leamington_F.C.
Stefan_Bailey	playsFor	Wealdstone_F.C.
Tomáš_Bruško	playsFor	ŠK_Slovan_Bratislava
Joe_Lawless	playsFor	Omagh_Town_F.C.
Fumagalli	playsFor	Sport_Club_Corinthians_Paulista
Néstor_Rossi	diedIn	Buenos_Aires
Volodymyr_Bondarenko_(footballer)	playsFor	FC_Torpedo_Moscow
Charles_K._Kao	livesIn	United_States
Haris_Bukva	playsFor	SK_Austria_Kärnten
Marlon_King	playsFor	Coventry_City_F.C.
Artem_Kontsevoy	playsFor	FC_BATE_Borisov
Julius_Aghahowa	playsFor	Bendel_Insurance_F.C.
Mickaël_Antoine-Curier	playsFor	Rochdale_A.F.C.
Shep_Messing	playsFor	New_York_Arrows
Victor_Hugo	influences	Charles_Dickens
Belarus	dealsWith	Latvia
George_Ley	playsFor	Dallas_Tornado
Joe_Nagbe	playsFor	Mighty_Barrolle
Atanas_Bornosuzov	hasGender	male
VfR_Aalen	isLocatedIn	Baden-Württemberg
Timur_Kapadze	playsFor	Al_Sharjah_SC
Nenad_Mirosavljević	playsFor	APOEL_FC
Carles_Coto	playsFor	Anorthosis_Famagusta_FC
Ivan_Jazbinšek	diedIn	Zagreb
Paulo_Roberto_da_Silva_Zaltron	playsFor	Avaí_Futebol_Clube
Marc_Laird	playsFor	Brentford_F.C.
Gabriel_Correa	playsFor	Peñarol
George_Kistiakowsky	hasGender	male
Cristian_Longobardi	playsFor	A.C._Rimini_1912
Ashley_Hemmings	playsFor	Walsall_F.C.
Rémy_Riou	playsFor	FC_Nantes
Víctor_(footballer_born_1974)	playsFor	Real_Valladolid
Hernâni_Borges	playsFor	C.D._Aves
Phil_Barber	playsFor	Mansfield_Town_F.C.
Adrian_Knup	playsFor	Karlsruher_SC
Dušan_Savić_(footballer_born_1985)	playsFor	FK_Pobeda
Alberto_Gilardino	playsFor	Genoa_C.F.C.
Valeri_Masalitin	hasGender	male
Walter_Schachner	playsFor	FC_Red_Bull_Salzburg
Gustavo_Zapata	hasGender	male
Dimcho_Belyakov	playsFor	PFC_Belasitsa_Petrich
Serhiy_Motuz	playsFor	FC_Dnipro_Dnipropetrovsk
Mario_Holek	playsFor	FC_Zbrojovka_Brno
Javi_Guerrero	playsFor	Atlético_Madrid
Paolo_Frangipane	playsFor	Huracán_de_Tres_Arroyos
Denni_Avdić	hasGender	male
Tommy_Wright_(footballer,_born_1984)	playsFor	Tamworth_F.C.
Hugo_Sánchez	playsFor	Mexico_national_football_team
Aki_Riihilahti	playsFor	Djurgårdens_IF_Fotboll
Belgium	participatedIn	Great_War_(Harry_Turtledove)
Vladislav_Stoyanov	playsFor	FC_Sheriff_Tiraspol
Ifeoma_Dieke	playsFor	Boston_Breakers
Galust_Petrosyan	hasGender	male
Gabriel_Urdaneta	playsFor	Deportivo_Petare
Mariano_Gonzalvo	playsFor	Spain_national_football_team
Károly_Erős	playsFor	Budapest_Honvéd_FC
Albert_Yagüe_Jiménez	playsFor	Lorca_Deportiva_CF
Ulises_Mendivil	playsFor	C.F._Pachuca
Yassine_El_Ghanassy	playsFor	SC_Heerenveen
Battle_of_Fontenoy	happenedIn	France
Lino_(footballer)	hasGender	male
Giuseppe_Aquaro	playsFor	Panetolikos_F.C.
Clint_Bolton	playsFor	Sydney_Olympic_FC
Hernán_Cristante	playsFor	Club_Universidad_de_Guadalajara
Principality_of_Antioch	participatedIn	Ninth_Crusade
Mario_Regueiro	hasGender	male
Elini_Dimoutsos	playsFor	Greece_national_football_team
Lewis_Grabban	playsFor	Rotherham_United_F.C.
Claudiu_Mircea_Ionescu	playsFor	FC_Politehnica_Iași
Christian_Saba	playsFor	Bayern_Munich_Junior_Team
Ryan_Harley	playsFor	Forest_Green_Rovers_F.C.
Ricardo_Berna	playsFor	Guarani_Futebol_Clube
Massimo_Coda	playsFor	Parma_F.C.
Michel_Garbini_Pereira	playsFor	Aris_F.C._(Thessaloniki)
Neca_(footballer)	playsFor	Vitória_S.C.
Kliton_Bozgo	playsFor	NK_Maribor
Valeri_Chizhov	playsFor	FC_Neftekhimik_Nizhnekamsk
Kevan_Hurst	playsFor	Morecambe_F.C.
Rafał_Grzelak	playsFor	Lech_Poznań
Mark_Švets	playsFor	FC_Smorgon
Dan_Ekner	diedIn	Gothenburg
Dave_Shearer	playsFor	Billingham_Synthonia_F.C.
Roberto_Volpato	playsFor	Associação_Atlética_Ponte_Preta
Djibouti	hasOfficialLanguage	French_language
Jason_Kennedy_(footballer)	playsFor	Boston_United_F.C.
Davide_Somma	playsFor	Lincoln_City_F.C.
Panama	exports	wordnet_sugar_107859284
Gerry_Daly	playsFor	Shrewsbury_Town_F.C.
James_Milner	playsFor	Aston_Villa_F.C.
Jymmy_Dougllas_França	playsFor	FC_Sheriff_Tiraspol
Leonardo_Biagini	playsFor	Sporting_de_Gijón
Denis_Boyarintsev	playsFor	FC_Saturn_Ramenskoye
Hasan_Kabze	playsFor	Turkey_national_youth_football_team
Paulo_Wanchope	playsFor	West_Ham_United_F.C.
Isli_Hidi	playsFor	KF_Bylis_Ballsh
Wilfrid_Sellars	diedIn	Pittsburgh
John_McGlashan_(footballer)	playsFor	Millwall_F.C.
Neil_Murray_(footballer)	playsFor	FC_Sion
Dwayne_Plummer	playsFor	Crawley_Town_F.C.
Vlado_Jeknić	playsFor	FK_Sutjeska_Nikšić
Craig_Armstrong_(footballer)	playsFor	Sheffield_Wednesday_F.C.
Everton_Kempes_dos_Santos_Gonçalves	playsFor	Sertãozinho_Futebol_Clube
Toni_Morrison	hasGender	female
Edin_Ademović	playsFor	FK_BSK_Borča
Gaúcho_(footballer)	playsFor	Fluminense_FC
Mikkel_Beck	playsFor	Lille_OSC
Tony_Cottee	playsFor	West_Ham_United_F.C.
Dominic_Roma	hasGender	male
Clint_Eastwood	playsFor	South_Korea_national_football_team
Erison_Carlos_dos_Santos_Silva	playsFor	Associação_Atlética_Ponte_Preta
Sylvain_N'Diaye	playsFor	Levante_UD
Radamés_Martins_Rodrigues_da_Silva	playsFor	Esporte_Clube_Juventude
Mo_Camara	playsFor	Celtic_F.C.
Jan_Kromkamp	playsFor	Go_Ahead_Eagles
Fidel_Martínez	playsFor	Independiente_del_Valle
Abiodun_Baruwa	playsFor	FC_Sion
Andrea_Pazzagli	playsFor	Udinese_Calcio
Héctor_Silva_(Argentine_footballer)	playsFor	Gimnasia_y_Esgrima_de_Jujuy
Andy_Pettinger	playsFor	Ossett_Town_F.C.
Moldavia	participatedIn	Battle_of_Vienna
Mike_Trebilcock	playsFor	Western_Suburbs
David_Klein_(footballer)	playsFor	Clermont_Foot
Holger_Badstuber	playsFor	FC_Bayern_Munich_II
João_Vitor_da_Silva	playsFor	Esporte_Clube_XV_de_Novembro_(Piracicaba)
Vanderlei_Luxemburgo	playsFor	Botafogo_de_Futebol_e_Regatas
Lee_Kil-hoon	playsFor	Korea_University
Andreas_Reinke	playsFor	FC_St._Pauli
Kali_(footballer)	playsFor	C.D._Santa_Clara
Vladislavs_Gabovs	playsFor	Latvia_national_football_team
Antonio_Giosa	playsFor	Reggina_Calcio
Korea_University	isLocatedIn	South_Korea
Alexis_N'Gambi	playsFor	FK_Partizan
Bangladesh	dealsWith	South_Korea
Kayne_McLaggon	playsFor	Southampton_F.C.
Christian_Person	playsFor	Dynamo_Dresden
Louie_Donowa	playsFor	England_national_under-21_football_team
Brian_Barry-Murphy	playsFor	Preston_North_End_F.C.
Josef_Hamouz	playsFor	FC_Slovan_Liberec
Jaime_Bragança	playsFor	C.S._Marítimo
Les_Thompson_(footballer_born_1988)	playsFor	Thurrock_F.C.
Sorin_Ghionea	playsFor	FC_Steaua_București
Guilherme_de_Cássio_Alves	playsFor	Botafogo_de_Futebol_e_Regatas
Tuna_Luso_Brasileira	isLocatedIn	Belém
Scott_Stamps	playsFor	Hednesford_Town_F.C.
Harold_Meyssen	playsFor	Cercle_Brugge_K.S.V.
Barry_Lyons_(footballer)	playsFor	FC_Sheriff_Tiraspol
Michael_Burns_(footballer)	playsFor	Bolton_Wanderers_F.C.
Johan_Audel	playsFor	Valenciennes_FC
Springfield,_Missouri	isLocatedIn	Missouri
Sébastien_Grax	playsFor	AS_Saint-Étienne
War_of_the_Sixth_Coalition	happenedIn	Prussia
Chris_Clarke_(footballer)	playsFor	Blackpool_F.C.
Luis_Carrero_Blanco	playsFor	LA_Galaxy
Satyajit_Ray	hasGender	male
Luis_Saritama	playsFor	Barcelona_Sporting_Club
André_Gumprecht	playsFor	Dresdner_SC
Cameron_Jerome	playsFor	Birmingham_City_F.C.
Francesco_Parravicini	playsFor	A.C.D._Treviso_2013
Ignacio_Risso	playsFor	Club_Atlético_Lanús
David_Brown_(footballer,_born_1978)	playsFor	Chester_City_F.C.
Jacinto_Espinoza	playsFor	Club_Social_y_Deportivo_Macará
Nuno_Diogo	playsFor	F.C._Penafiel
Marcel_Sabitzer	playsFor	FK_Austria_Wien
Liron_Vilner	hasGender	male
Uwe_Rösler	playsFor	1._FC_Kaiserslautern
Davide_Baiocco	playsFor	S.C._Siracusa
Dinalo_Adigo	hasGender	male
Akkineni_Nagarjuna	livesIn	Hyderabad
Ben_Abbey	playsFor	Slough_Town_F.C.
Aleksandr_Denisov	playsFor	FC_Arsenal_Tula
Alen_Bašić	playsFor	VfB_Stuttgart
Karl-Heinz_Mrosko	playsFor	1._FC_Nürnberg
Delio_Toledo	playsFor	Club_Atlético_3_de_Febrero
Walter_Vílchez	playsFor	Alianza_Lima
Pedro_Jorge_Ramos_Moreira	playsFor	Cape_Verde_national_football_team
Agustín_Aranzábal	hasGender	male
Youssef_El_Akchaoui	playsFor	ADO_Den_Haag
Kemalettin_Şentürk	playsFor	Fenerbahçe_S.K.
War_of_the_Polish_Succession	happenedIn	Poland
Paul_Barnes_(footballer)	playsFor	Huddersfield_Town_F.C.
Hans-Georg_Gadamer	influences	Jürgen_Habermas
Anthony_Franciosa	diedIn	Los_Angeles
Francisco_Alejandro_Bautista_Portillo	playsFor	Sporting_San_Miguelito
Jermain_Defoe	playsFor	England_national_under-18_football_team
Radoslav_Anev	playsFor	FC_Pirin_Blagoevgrad
Tal_Ben_Haim	playsFor	West_Ham_United_F.C.
Federico_Moretti	playsFor	Ascoli_Calcio_1898
Eastern_Front_(World_War_I)	happenedIn	Kingdom_of_Romania
Grant_Basey	playsFor	Charlton_Athletic_F.C.
John_Colquhoun_(footballer)	playsFor	Millwall_F.C.
Terry_Harkin	playsFor	Dundalk_F.C.
Masashi_Oguro	playsFor	Japan_national_football_team
Muhammad_Ilham	playsFor	Persikota_Tangerang
Alberto_Cossentino	playsFor	Gela_Calcio
Kevin_Koetters	playsFor	Detroit_Rockers
Serhiy_Shmatovalenko	playsFor	FC_Krylia_Sovetov_Samara
Tam_Siu_Wai	playsFor	Hong_Kong_national_under-23_football_team
Édison_Chará	playsFor	Deportivo_Cali
David_Cotterill	playsFor	Portsmouth_F.C.
Emmanuel_Adebayor	playsFor	Manchester_City_F.C.
Constantin_Grecu	playsFor	FC_Petrolul_Ploiești
Mickey_Kydes	playsFor	Dallas_Sidekicks_(1984–2004)
Patrice_Kwedi	playsFor	NK_Novalja
Marcelo_Delgado	playsFor	Rosario_Central
Nikola_Žigić	hasGender	male
Stuart_Wardley	playsFor	Leyton_Orient_F.C.
Colin_Nish	playsFor	Hartlepool_United_F.C.
Mariano_Fernández_(footballer)	playsFor	Club_Atlético_Nueva_Chicago
Preki	playsFor	St._Louis_Storm
David_McCulloch	playsFor	Bath_City_F.C.
Abdul_Aziz_Ismail	playsFor	ATM_FA
Leandro_Bonfim	playsFor	Desportivo_Brasil
Ramūnas_Stonkus	playsFor	FC_Schönberg_95
Andrea_Caracciolo	playsFor	F.C._Pro_Vercelli_1892
Sidney_Moraes	playsFor	C.D._Trofense
Federico_Moretti	playsFor	A.S._Varese_1910
Guillem_Bauzà	hasGender	male
Klaus_Stürmer	hasGender	male
Semjon_Milošević	playsFor	KS_Cracovia_(football)
Diogo_Rodrigues_Siston	playsFor	Ionikos_F.C.
Demetrios_Christodoulou	isCitizenOf	United_States
Colin_Harper_(footballer)	playsFor	Port_Vale_F.C.
Gaby_Mudingayi	playsFor	Torino_F.C.
Paddy_Sloan	playsFor	Manchester_United_F.C.
Gary_Deegan	playsFor	Kilkenny_City_A.F.C.
Ricardo_Emídio_Ramalho_Silva	hasGender	male
Sebastián_Carrera	playsFor	Los_Andes_de_Lomas_de_Zamora
Munster_Rugby	isLocatedIn	Munster
Wendel_Raul_Gonçalves_Gomes	playsFor	Ituano_Futebol_Clube
Keigan_Parker	playsFor	St._Johnstone_F.C.
Lee_Boylan	playsFor	Exeter_City_F.C.
Sebastián_Rambert	playsFor	Boca_Juniors
Jakob_Friis-Hansen	playsFor	FC_Girondins_de_Bordeaux
Carlos_Alberto_Torres	playsFor	Fluminense_FC
Emilio_Caprile	playsFor	Calcio_Como
Mario_Cáceres	playsFor	Everton_de_Viña_del_Mar
Graham_Arnold	playsFor	R._Charleroi_S.C.
Teemu_Pukki	playsFor	Sevilla_Atlético
Gia_Chkhaidze	playsFor	FC_Merani_Tbilisi
Hatthaporn_Suwan	hasGender	male
Mario_Garba	playsFor	HNK_Segesta
Miguel_Herrera	playsFor	Toros_Neza
University_of_Copenhagen	isLocatedIn	Copenhagen
Andrzej_Juskowiak	playsFor	FC_Energie_Cottbus
Alexandru_Bourceanu	hasGender	male
Patricio_González	hasGender	male
Richard_Soumah	playsFor	En_Avant_de_Guingamp
Nathan_Tyson	playsFor	Swansea_City_A.F.C.
Zsolt_Limperger	playsFor	Real_Burgos_CF
Ted_McMinn	playsFor	Rangers_F.C.
Eraldo_Anicio_Gomes	playsFor	Jeju_United_FC
Renato_Pilipović	playsFor	GNK_Dinamo_Zagreb
Robbie_Herrera	playsFor	Fulham_F.C.
Jimmy_Glenn	playsFor	Cincinnati_Silverbacks
Stephan_Keller	hasGender	male
Vladan_Milovanović	playsFor	FK_Napredak_Kruševac
Marcelo_Guerrero	playsFor	Defensa_y_Justicia
Jamie_Harris	playsFor	Haverfordwest_County_A.F.C.
Phil_Babb	playsFor	Bradford_City_A.F.C.
Johann_Smith	hasGender	male
Tony_Butler_(footballer)	playsFor	Port_Vale_F.C.
Joe_Palatsides	playsFor	Brunswick_Juventus_FC
Jon_Whitney_(footballer)	playsFor	Winsford_United_F.C.
Airton_Ribeiro_Santos	playsFor	Botafogo_de_Futebol_e_Regatas
Roberto_Bonano	playsFor	FC_Barcelona
Park_Sung-ho	playsFor	Daejeon_Citizen_FC
Charles_Dickens	influences	George_Orwell
Pontus_Engblom	playsFor	FK_Haugesund
Ignacio_Carlos_González	playsFor	C.F._Pachuca
Ryan_Gilligan	playsFor	Watford_F.C.
James_Turley	playsFor	Witton_Albion_F.C.
Luca_Bucci	playsFor	S.S.C._Napoli
Francesco_Romano	hasGender	male
Sardinia	isLocatedIn	Cagliari
Zanzan_Atte-Oudeyi	playsFor	Beerschot_AC
Salvador_Cabañas	playsFor	Chiapas_F.C.
Carl_Pentney	playsFor	Bath_City_F.C.
Diego_Crosa	playsFor	Argentina_national_football_team
Jordan_Simpson	playsFor	Bankstown_City_FC
Ion_Luca_Caragiale	isCitizenOf	Romania
Nils_Petersen	playsFor	FC_Energie_Cottbus
Ivan_Turina	playsFor	Croatia_national_under-20_football_team
Alan_Neilson	playsFor	Southampton_F.C.
Kirk_Hudson	playsFor	Ashford_Town_F.C.
Besheer_El-Tabei	playsFor	Tala'ea_El-Gaish_SC
Vladislav_Ivanov_(footballer)	playsFor	FC_Khimik_Dzerzhinsk
Gary_Ablett_(English_footballer)	hasGender	male
Kingdom_of_Sicily	participatedIn	Hundred_Days
Grant_Brebner	playsFor	Scotland_national_under-21_football_team
Boško_Janković	playsFor	Genoa_C.F.C.
Vadim_Khinchagov	playsFor	FC_Alania_Vladikavkaz
Alexandre_Afonso_da_Silva	playsFor	Marília_Atlético_Clube
David_Aganzo	playsFor	Hércules_CF
Sergio_Omar_Almirón	playsFor	Tigres_UANL
Hrvoje_Čale	playsFor	Trabzonspor
Igor_Petković	playsFor	FC_Dynamo-2_Kyiv
George_Best	playsFor	Hong_Kong_Rangers_FC
Antonio_Bocchetti	playsFor	S.S.C._Napoli
Hugo_Carreira	playsFor	AEP_Paphos_F.C.
Gustave_Flaubert	isCitizenOf	France
Gunter_Van_Handenhoven	playsFor	FC_Metz
Olivier_Renard	playsFor	Belgium_national_under-19_football_team
Rutgers_University	isLocatedIn	Newark,_New_Jersey
Gianni_De_Rosa	playsFor	U.S._Città_di_Palermo
Alberto_Toril	playsFor	Real_Madrid_C.F.
Jandro_(footballer)	playsFor	Celta_de_Vigo
Facundo_Erpen	playsFor	Instituto_Atlético_Central_Córdoba
Bruno_Alicarte	playsFor	Stade_Lavallois
Brent_Fisher	playsFor	FC_Energie_Cottbus
David_Bermudo	playsFor	FC_Barcelona
John_Locke	influences	Immanuel_Kant
Piero_Braglia	hasGender	male
Peter_Pacult	playsFor	FC_Linz
Ahmad_Alenemeh	playsFor	Sepahan_Isfahan_F.C.
Stefanos_Voskaridis	playsFor	Anorthosis_Famagusta_FC
Aitor_López_Rekarte	playsFor	Real_Sociedad_B
Rômulo_Marques_Antoneli	playsFor	Valletta_F.C.
Michel_Platini	hasGender	male
Manuel_Belleri	playsFor	A.C._Lumezzane
Chris_Dickson_(footballer)	playsFor	Ghana_national_football_team
Apostolos_Tsianakas	playsFor	Ethnikos_Asteras_F.C.
Georgi_Georgiev_(footballer_born_1970)	playsFor	Uzbekistan_national_football_team
Diego_Cavalieri	playsFor	A.C._Cesena
Geoffrey_Mujangi_Bia	playsFor	Wolverhampton_Wanderers_F.C.
Sutee_Suksomkit	hasGender	male
Ayila_Yussuf	playsFor	Orduspor
Michael_Aničić	playsFor	Wormatia_Worms
Second_Northern_War	happenedIn	Dutch_Republic
David_Cerutti	playsFor	Club_Universitario
Adrian_Trinidad	playsFor	Persipura_Jayapura
John_Brough_(English_footballer)	playsFor	Cheltenham_Town_F.C.
John_Welsh_(footballer)	playsFor	Hull_City_A.F.C.
David_Lynch	hasGender	male
Michael_Hughes_(footballer)	playsFor	Birmingham_City_F.C.
Megan_Rapinoe	playsFor	Sydney_FC_W-League
Mark_Convery	playsFor	Hvidovre_IF
Gennaro_Delvecchio	playsFor	U.S._Lecce
Ezra_Hendrickson	playsFor	Chivas_USA
Cristian_Mora	playsFor	Ecuador_national_football_team
Kevin_Keelan	playsFor	Kidderminster_Harriers_F.C.
Marcelo_Corrales	playsFor	Deportes_Iquique
Will_Antwi	playsFor	Luton_Town_F.C.
Jamie_Slabber	playsFor	Stevenage_F.C.
Jessica_Landström	playsFor	Linköpings_FC
Erhan_Aydın	playsFor	Polatlı_Bugsaşspor
David_Limberský	hasGender	male
Georgios_Kyriazis	playsFor	Unione_Triestina_2012_S.S.D.
Chicago_Fire_Soccer_Club	isLocatedIn	Illinois
Darren_Kelly	playsFor	Carlisle_United_F.C.
Björn_Ziegenbein	playsFor	TSV_1860_München
Timo_Ochs	playsFor	1._FC_Saarbrücken
Silvano_Raggio_Garibaldi	playsFor	A.C._Pisa_1909
Dirk_van_der_Ven	playsFor	1._FC_Schweinfurt_05
Lars_Bohinen	playsFor	Norway_national_under-21_football_team
Armen_Shahgeldyan	playsFor	Hapoel_Petah_Tikva_F.C.
Yari_Allnutt	playsFor	United_States_men's_national_soccer_team
Jude_Stirling	playsFor	Luton_Town_F.C.
Adrian_Alston	playsFor	Canberra_City_FC
Damián_Giménez	playsFor	Newell's_Old_Boys
Jimmy_Dunne_(footballer_born_1935)	playsFor	Peterborough_United_F.C.
Samir_Boughanem	playsFor	Morocco_national_football_team
Paulo_Vogt	playsFor	FC_Metalurh_Donetsk
Fernando_Santos_(Brazilian_footballer_born_1980)	playsFor	Guarani_Futebol_Clube
Tvrtko_Kale	playsFor	NK_Lokomotiva
Alex_Rhodes_(footballer)	playsFor	Swindon_Town_F.C.
Milan_Obradović	playsFor	FC_Arsenal_Kyiv
Michael_Baird_(footballer)	playsFor	South_Melbourne_FC
Claudio_Rivalta	playsFor	Torino_F.C.
Héctor_Rial	playsFor	RCD_Espanyol
Branimir_Subašić	hasGender	male
Tommy_Mooney	playsFor	Southend_United_F.C.
Mamadou_Diallo	playsFor	New_York_Red_Bulls
Avimiled_Rivas	playsFor	Atlético_Huila
Qusay_Munir	playsFor	Al_Hazm_(football_club)
Sandy_Davie	playsFor	Dallas_Tornado
Iain_Anderson_(footballer)	playsFor	Toulouse_FC
Dutch_Republic	participatedIn	Battle_of_Ramillies
Rob_Scott	playsFor	Rotherham_United_F.C.
Wellington_Monteiro	playsFor	Goiás_Esporte_Clube
Otto_Pfister	playsFor	FC_Viktoria_Köln
Fola_Onibuje	playsFor	Accrington_Stanley_F.C.
David_Preece_(footballer_born_1976)	playsFor	Odense_Boldklub
Abdelkader_Ben_Bouali	diedIn	Algiers
Robert_Mario_Flores	playsFor	Club_Atlético_River_Plate_(Montevideo)
Brett_Holman	playsFor	Aston_Villa_F.C.
Andriy_Demchenko	playsFor	PFC_CSKA_Moscow
Fabiano_Cezar_Viegas	playsFor	Wuhan_Optics_Valley_F.C.
Christian_McClean	playsFor	Northampton_Town_F.C.
Rinaldo_Cruzado	playsFor	Peru_national_football_team
Omar_Rabie_Yassin	hasGender	male
Dževdet_Šainovski	playsFor	Hannover_96
Alan_Sheehan	playsFor	Republic_of_Ireland_national_under-21_football_team
Adriano_Alves	playsFor	Sanat_Mes_Kerman_F.C.
Máté_Tóth	playsFor	III._Kerületi_TUE
Brian_Kidd	playsFor	England_national_football_team
Carlos_Mozer	playsFor	Olympique_de_Marseille
Radivoje_Manić	playsFor	OFK_Mladenovac
Vladimir_Nabokov	influences	Italo_Calvino
Vlatko_Đolonga	playsFor	HNK_Hajduk_Split
Nelinho_Quina	playsFor	K.V.C._Westerlo
Janusz_Dziedzic	playsFor	Olimpia_Grudziądz
Bernt_Evens	playsFor	K.R.C._Genk
Zoran_Jovanovski	playsFor	FK_Sloga_Jugomagnat
Ivo_Trenchev	playsFor	PFC_Spartak_Varna
Diego_Cháves	playsFor	O'Higgins_F.C.
Alan_McDermott	hasGender	male
Nicky_Nicolau	playsFor	Arsenal_F.C.
Efstathios_Tavlaridis	playsFor	Lille_OSC
Rubens_Sambueza	hasGender	male
Clodoaldo_Paulino_de_Lima	playsFor	Independiente_Medellín
Mbala_Mbuta_Biscotte	playsFor	Daring_Club_Motema_Pembe
Pablo_Aimar	playsFor	Argentina_national_under-20_football_team
Marcin_Cabaj	playsFor	Hapoel_Be'er_Sheva_F.C.
Dennis_Miller	hasGender	male
José_Kléberson	playsFor	Beşiktaş_J.K.
Héctor_Giménez_(footballer)	playsFor	Correcaminos_UAT
Daniele_Chiarini	playsFor	U.S._Arezzo
Ângelo_Ricardo_Versari	playsFor	Associação_Desportiva_Atlética_do_Paraná
Javi_Moreno	playsFor	Real_Zaragoza
Ivo_Iličević	playsFor	VfL_Bochum
Johnny_Linaker	playsFor	Nottingham_Forest_F.C.
João_Manuel_Pinto_Tomé	playsFor	FC_Sion
Stephen_Gleeson	playsFor	Hereford_United_F.C.
Nikolajs_Poļakovs	playsFor	FC_Daugava
Ottoman_Empire	participatedIn	Armenian_national_liberation_movement
Pavlo_Kutas	playsFor	FC_Hoverla_Uzhhorod
Paraguay	imports	wordnet_consumer_goods_103093574
Zoran_Varvodić	playsFor	HNK_Hajduk_Split
Dominic_Iorfa	playsFor	Thurrock_F.C.
Saulius_Mikoliūnas	hasGender	male
Allan_Gilliver	playsFor	Stockport_County_F.C.
Stanislav_Vlček	playsFor	FC_Dynamo_Moscow
Huddersfield	isLocatedIn	England
David_Grondin	playsFor	RWDM_Brussels_FC
Valentin_Simion	playsFor	CS_Concordia_Chiajna
Chris_Pike	hasGender	male
Philip_Roth	influences	Jonathan_Lethem
Paul_Heckingbottom	playsFor	Gateshead_F.C.
Paddy_Kenny	playsFor	Sheffield_United_F.C.
Stanford_Cardinal	isLocatedIn	California
Harrie_Gommans	playsFor	K.V.C._Westerlo
Clint_Mathis	playsFor	LA_Galaxy
Ricardo_Roberto_Barreto_da_Rocha	hasGender	male
Steve_McCall	playsFor	England_national_football_B_team
Olivier_Kapo	playsFor	Juventus_F.C.
Zoran_Barisic	playsFor	SK_Rapid_Wien
Vanderlei_Mascarenhas_dos_Santos	playsFor	Club_Bolívar
Mustafa_Özkan	playsFor	Göztepe_S.K.
David_Sánchez_Rodríguez	playsFor	FC_Gloria_Buzău
Mbala_Mbuta_Biscotte	playsFor	Hapoel_Tel_Aviv_F.C.
Dominique_Malonga	playsFor	Torino_F.C.
Paul_Price_(footballer)	playsFor	Swansea_City_A.F.C.
Racing_Club_de_Montevideo	isLocatedIn	Montevideo
Dražen_Žeželj	playsFor	NK_Mura
Nelson_Barahona	playsFor	Centro_Atlético_Fénix
Luigi_Turci	playsFor	U.S._Alessandria_Calcio_1912
John_McGovern_(footballer)	hasGender	male
Latvia	hasCapital	Riga
Jonathan_Bolaños	playsFor	Deportivo_Saprissa
Chris_Cornes	playsFor	Worcester_City_F.C.
Bogdan_Milić	playsFor	FC_Krylia_Sovetov_Samara
Yusuke_Sato	playsFor	Montedio_Yamagata
Ivan_Perišić	playsFor	Croatia_national_under-17_football_team
Al_Thompson	diedIn	Los_Angeles
Marinho_Chagas	playsFor	Fluminense_FC
Denis_Diderot	influences	Jean-Jacques_Rousseau
Christian_Schreier	playsFor	Bayer_04_Leverkusen
Sam_Sloma	playsFor	Chelmsford_City_F.C.
Fabian_Gerber	playsFor	TuS_Celle_FC
Marian_Damaschin	hasGender	male
James_Lindley	playsFor	Grantham_Town_F.C.
Sérgio_Mota	playsFor	Esporte_Clube_Santo_André
Che_Bunce	playsFor	Coventry_City_F.C.
Fraser_Forster	playsFor	Newcastle_United_F.C.
Phil_Doughty	playsFor	Fleetwood_Town_F.C.
Teerasak_Po-on	playsFor	Chonburi_F.C.
Bino_(footballer)	playsFor	Rio_Ave_F.C.
Alan_Kennedy	playsFor	Sunderland_A.F.C.
Craig_Armstrong_(footballer)	playsFor	Gillingham_F.C.
Jørgen_Nielsen	playsFor	Ølstykke_FC
David_Speedie	playsFor	Leicester_City_F.C.
Tihhon_Šišov	playsFor	Khazar_Lankaran_FK
Henri_Munyaneza	playsFor	Sportkring_Sint-Niklaas
Senad_Tiganj	playsFor	SSV_Jahn_Regensburg
Orazio_Russo	playsFor	Gela_Calcio
Nikolai_Pisarev	playsFor	FC_Torpedo_Moscow
Albert_Quixall	playsFor	Oldham_Athletic_A.F.C.
Ansar_Ayupov	playsFor	FC_Rubin_Kazan
Aleksander_Kwiek	playsFor	Wisła_Kraków
Mihail_Aleksandrov	playsFor	PFC_Ludogorets_Razgrad
George_Michael	hasMusicalRole	wordnet_piano_103928116
Andrew_Hannah	playsFor	West_Bromwich_Albion_F.C.
Willi_Stoph	hasGender	male
Mariusz_Mowlik	playsFor	Miedź_Legnica
Bill_McGarry	playsFor	England_national_football_team
Claudio_Ferrarese	playsFor	S.S.C._Napoli
Rudie_Ramli	playsFor	Malaysia_national_under-23_football_team
Abdullah_Fusseini	playsFor	A.S._Casale_Calcio
Nazi_Germany	participatedIn	Italian_Campaign_(World_War_II)
Peter_Doherty_(footballer)	playsFor	Coleraine_F.C.
László_Bodnár	playsFor	FC_Dynamo_Kyiv
Eddy_Lord_Dombraye	playsFor	FC_Hoverla_Uzhhorod
Stefano_Fiore	playsFor	Cosenza_Calcio
Jens_Hegeler	playsFor	Bayer_04_Leverkusen_II
Billy_Dennehy	playsFor	Republic_of_Ireland_national_under-21_football_team
Bryan_Robson	playsFor	West_Bromwich_Albion_F.C.
Florin_Costea	playsFor	FC_Universitatea_Craiova
Ali_Turan	playsFor	Torku_Konyaspor
Lluís_Sastre	playsFor	Spain_national_under-19_football_team
Ivan_Bek	playsFor	Yugoslavia_national_football_team
Herve_Xavier_Zengue	playsFor	Burkina_Faso_national_football_team
Mark_Boyd_(footballer)	playsFor	Newcastle_United_F.C.
Heiner_Backhaus	playsFor	Hannover_96
Krzysztof_Król	playsFor	Piast_Gliwice
Wojciech_Kowalczyk	playsFor	Real_Betis
Dejan_Petković	playsFor	Goiás_Esporte_Clube
David_Suazo	playsFor	S.L._Benfica
Diego_Placente	playsFor	Celta_de_Vigo
Dirk_Schuster	playsFor	Karlsruher_SC
Scott_McDonald	playsFor	A.F.C._Bournemouth
James_Debbah	playsFor	Paris_Saint-Germain_F.C.
Paolo_Sammarco	playsFor	A.C._Chievo_Verona
Boban_Grnčarov	playsFor	APOEL_FC
Alberto_Orlando	hasGender	male
Steve_Guinan	playsFor	Carolina_Dynamo
Hugo_Nunes_Coelho	playsFor	AEP_Paphos_F.C.
Javier_Saavedra	playsFor	Monarcas_Morelia
Alex_Emenike	hasGender	male
Bosun_Ayeni	playsFor	Brønshøj_BK
Fausto_Salsano	playsFor	U.C._Sampdoria
Souleymane_Camara	playsFor	En_Avant_de_Guingamp
James_Pinnock	playsFor	Maidstone_United_F.C.
Michael_Anderson_Pereira_da_Silva	playsFor	Sociedade_Esportiva_Palmeiras
Evilásio_Leite_da_Costa	playsFor	Futebol_Clube_Santa_Cruz
Branislav_Obžera	playsFor	FC_Baník_Horná_Nitra
Ahmad_Alenemeh	playsFor	Esteghlal_Ahvaz_F.C.
Milan_Martinović	playsFor	Shenyang_Dongjin_F.C.
Federico_Laurito	playsFor	F.B.C._Unione_Venezia
Stanton_Lewis_(footballer_born_1987)	playsFor	Kaizer_Chiefs_F.C.
Éder_Luís	playsFor	São_Paulo_FC
José_Luis_Cabrera_Cava	playsFor	UD_Almería
Leandro_Rosa_Souza	playsFor	Santa_Cruz_Futebol_Clube
Germán_Carty	playsFor	Cienciano
Jörg_Heinrich	playsFor	ACF_Fiorentina
Michele_Marconi	hasGender	male
Paul_Robinson_(footballer,_born_November_1978)	playsFor	Newcastle_United_F.C.
Vũ_Như_Thành	playsFor	Vissai_Ninh_Binh_F.C.
Veli_Lampi	playsFor	Helsingin_Jalkapalloklubi
Darren_Roberts_(footballer)	playsFor	Worksop_Town_F.C.
Torsten_Kracht	hasGender	male
Andrei_Sidorenkov	playsFor	FC_Flora_Tallinn
Darryl_Knights	playsFor	Ipswich_Town_F.C.
Radek_Černý	playsFor	Czech_Republic_national_football_team
Emilio_Nsue	playsFor	CD_Castellón
Wellington_Sánchez	playsFor	LA_Galaxy
Hugo_Pérez_(soccer)	playsFor	San_Diego_Sockers_(1978–96)
Yves_Vanderhaeghe	playsFor	K.S.V._Roeselare
Rafael_Márquez_Lugo	playsFor	C.D._Guadalajara
Victorio_Cocco	playsFor	Club_Atlético_Atlanta
Antonio_de_Nigris	playsFor	Villarreal_CF
Jordan_Hadfield	playsFor	Radcliffe_Borough_F.C.
Geri_Çipi	playsFor	Eintracht_Frankfurt
Giacomo_Modica	playsFor	U.S._Città_di_Palermo
Aleix_Vidal	playsFor	RCD_Mallorca_B
Len_Phillips	playsFor	Poole_Town_F.C.
Bernard_Genghini	playsFor	AS_Saint-Étienne
Daniel_Morales_(footballer)	hasGender	male
Sito_(footballer)	playsFor	Racing_de_Ferrol
Aruna_Dindane	playsFor	RC_Lens
Tam_McManus	hasGender	male
Narcisse_Yaméogo	playsFor	Portimonense_S.C.
Noel_Whelan_(footballer)	playsFor	Dunfermline_Athletic_F.C.
United_States	participatedIn	Western_Front_(World_War_I)
Carsten_Hemmingsen	playsFor	Denmark_national_football_team
Vasil_Khamutowski	playsFor	FC_Carl_Zeiss_Jena
Moise_Kandé	playsFor	US_Orléans
Nicola_Legrottaglie	playsFor	A.C._Chievo_Verona
Pavol_Pronaj	playsFor	SK_Dynamo_České_Budějovice
Andrei_Sidorenkov	playsFor	SønderjyskE
Andrzej_Niedzielan	playsFor	Ruch_Chorzów
Ivone_De_Franceschi	playsFor	A.C._Chievo_Verona
Thomas_Reis	playsFor	Eintracht_Frankfurt
Jeremy_Bentham	influences	John_Stuart_Mill
Jason_Brown_(footballer)	playsFor	Cambridge_United_F.C.
Abdessalam_Benjelloun	playsFor	Morocco_national_football_team
Vince_Grella	playsFor	Chicago_Fire_Premier
Martin_Christensen	playsFor	A.C._Rimini_1912
Daniel_Sereinig	playsFor	Rot-Weiss_Essen
Tomislav_Stanić	hasGender	male
Fernando_Correa	playsFor	Real_Valladolid
Graham_Doyle	playsFor	Newry_City_F.C.
Igor_Simutenkov	playsFor	CD_Tenerife
Viktoras_Olšanskis	hasGender	male
Michael_Collins_(soccer)	playsFor	Sacramento_Knights
José_Gonçalves	playsFor	FC_St._Gallen
Andy_McLaren	playsFor	Partick_Thistle_F.C.
Robert_Garrett_(footballer)	playsFor	Linfield_F.C.
Matthías_Vilhjálmsson	playsFor	Iceland_national_under-17_football_team
Jim_Gorsek	playsFor	Portland_Pride
Roberto_Polo	playsFor	Deportivo_Azogues
Zoran_Dimitrijević	diedIn	Nantes
Jani_Bäckman	playsFor	FC_Honka
Papakouli_Diop	playsFor	Stade_Rennais_F.C.
Dušan_Savić_(footballer_born_1985)	hasGender	male
Javier_Farinós	playsFor	Levante_UD
André_Luís_Garcia	playsFor	Grêmio_Barueri_Futebol
Joubert_Araújo_Martins	playsFor	São_Paulo_FC
Tadas_Labukas	playsFor	Arka_Gdynia
Milan_Máčala	hasGender	male
Tim_Jerat	playsFor	Arminia_Bielefeld
Colin_Todd	playsFor	Derby_County_F.C.
Roy_Wegerle	playsFor	Luton_Town_F.C.
Alberto_Ortega	playsFor	Club_Sportivo_Cerrito
Dean_Holdsworth	playsFor	Brentford_F.C.
José_Bello_Amigo	playsFor	Polideportivo_Ejido
Pedro_Vera	hasGender	male
João_Paiva	playsFor	Sporting_Clube_de_Portugal
Province_of_Naples	isLocatedIn	Naples
Tomasz_Bzdęga	playsFor	Warta_Poznań
Edson_Rolando_Silva_Sousa	playsFor	FC_Solothurn
Ivan_Hodúr	playsFor	Zagłębie_Lubin
Chris_Lightfoot_(footballer)	playsFor	Cefn_Druids_A.F.C.
Toufik_Zerara	hasGender	male
Raúl_Fabiani	playsFor	Villarreal_CF_B
D._H._Lawrence	influences	Octavio_Paz
Bursaspor	isLocatedIn	Bursa
Diego_Tristán	playsFor	Deportivo_de_La_Coruña
Justo_Villar	playsFor	Club_Sol_de_América
Mario_Lička	playsFor	Czech_Republic_national_football_team
Ted_Hughes	influences	Sylvia_Plath
Artem_Yashkin	playsFor	FC_Shinnik_Yaroslavl
Danny_Vuković	playsFor	Parramatta_Power_SC
Aleksandre_Rekhviashvili	playsFor	FC_Dinamo_Tbilisi
Matthieu_Bochu	playsFor	Stade_Brestois_29
Dylan_Macallister	playsFor	Rockdale_City_Suns_FC
Jonathas_de_Jesus	playsFor	Cruzeiro_Esporte_Clube
Jorge_Daniel_Martínez	playsFor	Club_Atlético_Independiente
Barry_Bridges	playsFor	Birmingham_City_F.C.
Neil_Fisher	hasGender	male
Zé_Elias	playsFor	Bologna_F.C._1909
Battle_of_Oudenarde	happenedIn	Electorate_of_Brunswick-Lüneburg
Clive_Walker_(footballer_born_1945)	playsFor	Northampton_Town_F.C.
Peter_Dzúrik	diedIn	Bratislava
Hannah-Beth_Jackson	hasGender	female
Otto_Rehhagel	playsFor	Rot-Weiss_Essen
Ben_Hinchliffe	playsFor	Worcester_City_F.C.
Demba_Traoré	playsFor	Fortuna_Sittard
Caetano_Calil	playsFor	Roma_Esporte_Apucarana
Patrick_Suffo	playsFor	Dubai_CSC
Jhersson_Córdoba	playsFor	Colombia_national_football_team
Mateus_Paraná	playsFor	Fluminense_FC
Virginia	hasCapital	Richmond
Krisztián_Németh	playsFor	Olympiacos_Volou_1937_F.C.
Ralf_Fährmann	playsFor	VfB_Fortuna_Chemnitz
Andrei_Sidorenkov	playsFor	FC_Gomel
Walter_Scott	hasGender	male
Rui_Barros	playsFor	F.C._Porto
Antonio_Barragán	playsFor	Valencia_CF
Jonas_Thern	playsFor	A.S._Roma
Giuseppe_Abruzzese	hasGender	male
Nowy_Sącz	isLocatedIn	Lesser_Poland_Voivodeship
Danilo_Turcios	playsFor	Defensor_Sporting
John_Bramhall_(footballer)	playsFor	Bury_F.C.
Rodney_Bush	playsFor	San_Diego_Sockers_(1978–96)
Clifford_Mulenga	playsFor	Bidvest_Wits_F.C.
Steve_Guppy	playsFor	Rochester_Rhinos
Gary_Mills_(footballer,_born_1961)	playsFor	Notts_County_F.C.
Eric_Davis_(footballer)	playsFor	Barrow_A.F.C.
David_Partridge	hasGender	male
Jamie_Young	playsFor	England_national_under-19_football_team
Carlos_Gamarra	playsFor	AEK_Athens_F.C.
Juan_Carlos_Panameño	hasGender	male
Allyson_Araújo_Santos	playsFor	Clube_Náutico_Capibaribe
Roberto_Gamarra_(footballer_born_1981)	hasGender	male
Mauricio_Pochettino	hasGender	male
Roland_Benschneider	playsFor	Tennis_Borussia_Berlin
Alessandro_Evangelisti	playsFor	San_Marino_Calcio
Steven_Watt_(footballer)	playsFor	Aberdeen_F.C.
Márcio_José_Lisboa_Fortes_Filho	playsFor	Figueirense_Futebol_Clube
Tony_Cunningham_(footballer)	playsFor	Doncaster_Rovers_F.C.
Cristian_Nasuti	playsFor	Aris_F.C._(Thessaloniki)
Mustapha_Kamal_N'Daw	playsFor	Doxa_Katokopias_F.C.
Mutlu_Dervişoğlu	playsFor	Yimpaş_Yozgatspor
Brian_Horne	hasGender	male
Márkó_Futács	hasGender	male
Idrissa_Coulibaly	playsFor	JS_Centre_Salif_Keita
Imperial_College_London	isLocatedIn	London
Gareth_Davies_(footballer_born_1983)	playsFor	Buxton_F.C.
Marcelo_Mabilia	playsFor	Esporte_Clube_Juventude
Ivaylo_Petkov	playsFor	MKE_Ankaragücü
Casablanca	isLocatedIn	Morocco
Alfie_Hale	playsFor	Aston_Villa_F.C.
Luciano_Figueroa	playsFor	Club_Sport_Emelec
Yuri_Gazzaev	playsFor	Aris_F.C._(Thessaloniki)
Rasmus_Würtz	hasGender	male
Cláudio_Roberto_Siqueira_Fernandes	playsFor	Associação_Atlética_Internacional_(Limeira)
Luciano_Amaral	playsFor	Apollon_Limassol
Anderson_Luís_de_Abreu_Oliveira	playsFor	Brazil_national_football_team
Oscar_Wilde	hasGender	male
Abdelmajid_Oulmers	playsFor	Panthrakikos_F.C.
Joshua_Logan	diedIn	New_York_City
Fábio_César_Montezine	playsFor	Al-Arabi_SC_(Qatar)
Bjarni_Guðjónsson	playsFor	Knattspyrnufélag_Reykjavíkur
Eduardo_Rergis_Borja	playsFor	Club_Atlas
Sotiris_Leontiou	playsFor	Proodeftiki_F.C.
Toni_Koskela	playsFor	FC_Hämeenlinna
Alan_Irvine_(footballer,_born_1962)	playsFor	Dundee_United_F.C.
Choi_Yong-soo	playsFor	Júbilo_Iwata
Marcel_Silva_Andrade	playsFor	Paulista_Futebol_Clube
Trevor_Senior	playsFor	Farnborough_F.C.
Eduardo_Ratinho	playsFor	Esporte_Clube_Santo_André
Steve_Mokone	playsFor	Sunshine_George_Cross_FC
Luis_Patricio_Núñez	playsFor	Unión_San_Felipe
Kovelamudi_Raghavendra_Rao	playsFor	Burnley_F.C.
Giovanni_Vecchina	hasGender	male
Aivar_Anniste	hasGender	male
Bernie_Slaven	playsFor	Greenock_Morton_F.C.
Paolo_Zanetti	playsFor	Sorrento_Calcio
Bryan_Hughes	playsFor	Wrexham_F.C.
John_Best_(soccer)	playsFor	Philadelphia_Spartans
Sultan_Al-Touqi	playsFor	Qadsia_SC
Saudi_detainees_at_Guantanamo_Bay	playsFor	Albacete_Balompié
Peter_Thomson_(footballer_born_1977)	playsFor	Morecambe_F.C.
Dmitri_Kharine	playsFor	Soviet_Union_national_football_team
Gustavo_Dalto	playsFor	Peñarol
Cao_(Portuguese_footballer)	playsFor	S.C._Campomaiorense
Paulo_Bento	playsFor	S.L._Benfica
Henry_Damián_Giménez	playsFor	Club_Nacional_de_Football
Zurab_Ionanidze	playsFor	FC_Lokomotiv_Nizhny_Novgorod
Ignacio_Canuto	playsFor	LDU_Quito
Rocky_Siberie	playsFor	NK_Maribor
Andy_Ferrell	hasGender	male
Rob_McKinnon	playsFor	Carlisle_United_F.C.
Pavlo_Yanchuk	playsFor	FC_Obolon_Kyiv
Antonio_Núñez	playsFor	SD_Huesca
Steve_O'Shaughnessy_(footballer)	playsFor	Leeds_United_A.F.C.
Domagoj_Abramović	playsFor	Thrasyvoulos_F.C.
Gabriel_Boștină	playsFor	FC_Steaua_București
Stanislav_Genchev	playsFor	AEL_Limassol
Sri_Lanka	isLocatedIn	Asia
Andreas_Sørensen	playsFor	Lyngby_Boldklub
Barış_Özbek	playsFor	Galatasaray_S.K._(football)
Henryk_Jabłoński	isPoliticianOf	Poland
Emmanuel_Omoyinmi	playsFor	Oxford_United_F.C.
Mario_Evaristo	playsFor	Boca_Juniors
Christian_Smith_(footballer)	playsFor	Chester_F.C.
Alberto_Malusci	playsFor	A.S.D._SanGiovanniValdarno
Oleksandr_Hladkyy	playsFor	Ukraine_national_under-21_football_team
Iñaki_Muñoz	playsFor	CA_Osasuna
Zahari_Sirakov	playsFor	Bulgaria_national_under-21_football_team
Ragtime_(film)	isLocatedIn	United_States
Elías_Montes	playsFor	C.D._Municipal_Limeño
Abuda_(footballer_born_1986)	playsFor	F.C._Gifu
Steven_Gray_(footballer)	playsFor	Dandenong_Thunder_SC
Rashin_Wurie	playsFor	K._Boom_F.C.
Juan_Rodrigo_Rojas	playsFor	Club_Olimpia
Nelson_Rivas	playsFor	Deportes_Tolima
Stephan_Kling	playsFor	1._FC_Saarbrücken
John_Keeley	playsFor	Oldham_Athletic_A.F.C.
Marco_Zamboni	playsFor	S.S.C._Napoli
Mark_Peters	hasGender	male
Marcel_Rath	playsFor	Rot_Weiss_Ahlen
Fabio_Quagliarella	playsFor	Udinese_Calcio
Mark_Beesley	playsFor	Chester_City_F.C.
Manuel_Francisco_Barreto	playsFor	Peru_national_under-20_football_team
Fernando_Fernández_Escribano	playsFor	Real_Madrid_C
Chris_Lawler	playsFor	Raufoss_IL
Danny_Murphy_(footballer,_born_1977)	playsFor	Liverpool_F.C.
Vasil_Gigiadze	playsFor	SC_Tavriya_Simferopol
Li_Weifeng	playsFor	Jingtie_Locomotive_F.C.
Siavash_Akbarpour	playsFor	Fajr_Sepasi_F.C.
Andrius_Velička	playsFor	VMFD_Žalgiris_Vilnius
Fernando_Nélson	playsFor	Portugal_national_under-21_football_team
Vampeta	playsFor	Brazil_national_football_team
Raman_Kirenkin	hasGender	male
Joe_O'Cearuill	playsFor	Enfield_Town_F.C.
Michael_Panopoulos	playsFor	Heidelberg_United_FC
Electronic_Arts	isLocatedIn	United_States
Jamie_McCombe	playsFor	Halifax_Town_A.F.C.
Leighton_James	hasGender	male
Heckscher–Ohlin_model	playsFor	FC_Erzgebirge_Aue
Désiré_Koranyi	playsFor	ESA_Brive
Juan_Carlos_Rojo	playsFor	Real_Betis
Peter_Beardsley	playsFor	Fulham_F.C.
Richie_Partridge	playsFor	Chester_City_F.C.
Jordi_Pablo_Ripollés	playsFor	Spain_national_under-16_football_team
Johnny_Torres	hasGender	male
Joe_Hamill	playsFor	Formartine_United_F.C.
Paul_Rodgers_(footballer)	hasGender	male
Antonio_Rukavina	playsFor	TSV_1860_München
David_Caiado	playsFor	Zagłębie_Lubin
Florian_Heller	playsFor	FC_Erzgebirge_Aue
David_Speedie	playsFor	Crook_Town_A.F.C.
Val_Teixeira	playsFor	S.L._Benfica
Steve_Thompson_(footballer,_born_1964)	playsFor	Halifax_Town_A.F.C.
Vyacheslav_Geraschenko	playsFor	FC_Chernomorets_Novorossiysk
Phil_Starbuck	playsFor	Oldham_Athletic_A.F.C.
Mladen_Bartulović	playsFor	FC_Karpaty_Lviv
Kurt_Nogan	playsFor	Luton_Town_F.C.
Horacio_Casarín	playsFor	Club_Necaxa
Renan_Marques	playsFor	América_Futebol_Clube_(RN)
Ivan_Bek	playsFor	FK_Mačva_Šabac
Dave_Kitson	playsFor	Arlesey_Town_F.C.
Igor_Novaković	playsFor	HNK_Rijeka
Tibor_Montvai	playsFor	Nyíregyháza_Spartacus_FC
Bojan_Krkić	playsFor	AFC_Ajax
Cameron_Jerome	playsFor	Crystal_Palace_F.C.
Vanderlei_Mascarenhas_dos_Santos	playsFor	Sociedade_Esportiva_e_Recreativa_Caxias_do_Sul
Julio_Marchant	playsFor	Unión_de_Santa_Fe
Miguel_de_Souza	playsFor	Rushden_&_Diamonds_F.C.
Jackie_Mudie	playsFor	Toronto_City
Stuart_Elliott_(footballer,_born_1977)	playsFor	Newcastle_United_F.C.
Ruud_van_Nistelrooy	playsFor	SC_Heerenveen
Ihor_Bazhan	hasGender	male
Ismail_Isa	playsFor	OFC_Sliven_2000
Tomasz_Frankowski	playsFor	Jagiellonia_Białystok
Dave_Reeves	playsFor	Bolton_Wanderers_F.C.
Diego_Costa_Silva	playsFor	Clube_Atlético_Paranaense
Mauro_Cetto	playsFor	FC_Nantes
Felix_Luz	playsFor	FC_Augsburg
Ferran_Corominas	playsFor	CA_Osasuna
Linus_Hallenius	playsFor	Hammarby_Fotboll
Grassroots_Campaigns,_Inc.	isLocatedIn	Albuquerque,_New_Mexico
Paulo_Silas	playsFor	Central_Español
Paulo_Futre	playsFor	S.L._Benfica
Allen_McKnight	playsFor	Walsall_F.C.
Marshall_McLuhan	influences	Jean_Baudrillard
Ricardo_Moniz	hasGender	male
Dominic_Foley	playsFor	St_James'_Gate_F.C.
Diogo_Douglas_Santos_Andrade_Barbosa	playsFor	Atlético_Monte_Azul
William_Mocquet	hasGender	male
Julio_Irrazábal	playsFor	Club_Sol_de_América
José_de_la_Cuesta	playsFor	Atlético_Nacional
Konstantin_Nahk	playsFor	JK_Viljandi_Tulevik
Jim_Crawford_(footballer)	playsFor	Dundee_United_F.C.
Ryan_Mason	playsFor	England_national_under-20_football_team
Craig_Noone	playsFor	Plymouth_Argyle_F.C.
Ryan_Miller_(soccer)	playsFor	D.C._United
Kyriacos_Chailis	playsFor	PAEEK
Rimantas_Žvingilas	playsFor	FC_Shakhter_Karagandy
Gellért_Ivancsics	playsFor	FC_Sopron
Paulo_Santos_(Portuguese_footballer)	playsFor	S.C._Braga
Brayan_Angulo	playsFor	Leixões_S.C.
Ralph_Hasenhüttl	playsFor	1._FC_Köln
Tonči_Gabrić	playsFor	Croatia_national_football_team
João_Manuel_Pinto_Tomé	playsFor	Ciudad_de_Murcia
David_Fairclough	playsFor	England_national_under-21_football_team
Matt_Redmile	playsFor	Scarborough_F.C.
Ryan_Jarvis	playsFor	Walsall_F.C.
Nicky_Smith	playsFor	Braintree_Town_F.C.
Hogan_Ephraim	playsFor	Colchester_United_F.C.
Colin_Doyle_(footballer)	playsFor	Chester_City_F.C.
Vyacheslav_Dayev	playsFor	FC_Iskra_Smolensk
Stjepan_Tomas	playsFor	NK_Istra
Davit_Mujiri	playsFor	SK_Sturm_Graz
Wassim_El_Banna	playsFor	Aarhus_Fremad
Paul_Wanless	hasGender	male
Andrew_McNeil	playsFor	Scotland_national_under-21_football_team
Andrus_Mitt	playsFor	FC_Levadia_Tallinn
Karsten_Hutwelker	playsFor	1._FC_Saarbrücken
Sergio_Órteman	playsFor	Racing_de_Santander
Gustavo_Manduca	playsFor	G.D._Chaves
Daniel_Ola	playsFor	A.C._Cesena
Roman_Shirokov	playsFor	PFC_CSKA_Moscow
Bruno_Quadros	playsFor	Cruzeiro_Esporte_Clube
Kampala	isLocatedIn	Africa
Marcus_Browning	playsFor	Weymouth_F.C.
Derek_Kevan	hasGender	male
Frank_Stapleton	playsFor	Derby_County_F.C.
William_Viali	playsFor	U.S._Fiorenzuola_1922
Pavel_Nyakhaychyk	playsFor	FC_Tom_Tomsk
Víctor_Núñez	playsFor	C.S._Cartaginés
Tom_Carson	playsFor	Partick_Thistle_F.C.
Maicon_dos_Santos	playsFor	Clube_Atlético_Metropolitano
Martín_Andrizzi	hasGender	male
Björn_Brunnemann	playsFor	FC_Energie_Cottbus
Michael_Agazzi	playsFor	A.C._Milan
Bo_Storm	playsFor	FC_Nordsjælland
Davide_Brivio	playsFor	U.S._Lecce
Amílton_Jesus_dos_Santos	playsFor	Clube_de_Regatas_Brasil
Wesley_Lopes_Beltrame	playsFor	Brazil_national_football_team
Rafael_da_Silva_Francisco	playsFor	São_Paulo_FC
Reuben_Hazell	playsFor	Tranmere_Rovers_F.C.
Loick_Pires	playsFor	Leyton_Orient_F.C.
Patrik_Ježek	playsFor	FK_Austria_Wien
Auguste_Comte	hasGender	male
Adrian_Leijer	playsFor	Norwich_City_F.C.
Manor_Hassan	playsFor	Maccabi_Haifa_F.C.
Andrea_Lazzari	playsFor	Italy_national_under-21_football_team
Gaetano_Vasari	playsFor	A.C._Cesena
Lloyd_Owusu	hasGender	male
Jimmy_Hogan	playsFor	Swindon_Town_F.C.
Lamine_Diatta	playsFor	Étoile_du_Sahel
Fernando_Pessoa	influences	Octavio_Paz
Tom_Evans_(footballer,_born_1976)	playsFor	York_City_F.C.
Rob_McKinnon	playsFor	Motherwell_F.C.
Joe_McBride_(footballer_born_1938)	playsFor	Hibernian_F.C.
Bogdan_Stelea	playsFor	FC_Dinamo_București
Bosco_Frontán	playsFor	FBC_Melgar
Mark_Prudhoe	playsFor	Walsall_F.C.
Marko_Muslin	playsFor	FK_Hajduk_Beograd
Ivan_Božić	playsFor	HNK_Rijeka
Luís_Carlos_Correia_Pinto	playsFor	F.C._Paços_de_Ferreira
Afriyie_Acquah	playsFor	Parma_F.C.
Serhiy_Kuznetsov_(footballer_born_1982)	playsFor	FC_Gomel
Federico_Vairo	playsFor	Club_Atlético_River_Plate
Preston_Sturges	diedIn	New_York_City
Eddie_Odhiambo	playsFor	Newport_County_A.F.C.
Ciaran_Quinn	playsFor	St_Patrick's_Athletic_F.C.
Marco_Stier	playsFor	FC_Bayern_Munich_II
José_Manuel_Ochotorena	playsFor	Spain_national_football_team
Romero_Mendonça_Sobrinho	playsFor	Goiás_Esporte_Clube
Jusuf_Dajić	playsFor	NK_Kamen_Ingrad
Lahti	isLocatedIn	Southern_Finland
Dmitriy_Kramarenko	playsFor	FC_Dynamo_Moscow
Frederick_the_Great	playsFor	São_Paulo_FC
Marko_Ćetković	playsFor	FK_Mogren
Diego_Aguirre	playsFor	Club_Atlético_Independiente
Patrice_Evra	playsFor	France_national_football_team
Dylan_Hughes	playsFor	RKC_Waalwijk
Frédéric_Née	hasGender	male
Fabiano_Vieira_Soares	playsFor	Bangu_Atlético_Clube
Ljubiša_Ranković	playsFor	FK_Rad
Dean_Leacock	playsFor	Fulham_F.C.
Ferdinand_de_Saussure	influences	Jacques_Lacan
Vasilis_Avramidis	playsFor	Atromitos_F.C.
Kim_Hyun-soo_(born_March_1973)	playsFor	Jeonnam_Dragons
Redi_Jupi	playsFor	KS_Dinamo_Tirana
David_Cork_(footballer_born_1962)	playsFor	West_Bromwich_Albion_F.C.
Ezio_Brevi	playsFor	A.C._Siena
Kingdom_of_Sardinia	participatedIn	War_of_the_Fifth_Coalition
Nairobi	isLocatedIn	Kenya
Gary_van_Egmond	playsFor	Marconi_Stallions_FC
Damien_Allen	playsFor	Royal_Antwerp_F.C.
Neil_Wood	playsFor	Royal_Antwerp_F.C.
Trevor_Aylott	playsFor	Birmingham_City_F.C.
Andriy_Polunin	hasGender	male
Ángel_Labruna	playsFor	Rangers_de_Talca
Cristian_Hidalgo	playsFor	Deportivo_de_La_Coruña
Richard_Daddy_Owubokiri	playsFor	S.L._Benfica
Anton_Chekhov	influences	Lev_Shestov
Mu_Kanazaki	playsFor	Japan_national_under-20_football_team
Balázs_Rabóczki	playsFor	F.C._Copenhagen
Julianne_Moore	playsFor	Harrogate_Town_F.C.
Jeremain_Lens	hasGender	male
Rodrigo_Lacerda_Ramos	playsFor	Clube_Atlético_Mineiro
Serhiy_Kuznetsov_(footballer_born_1950)	playsFor	FC_SKVO_Rostov-on-Don
Vital_Shapyatowski	playsFor	FC_Zvezda-BGU_Minsk
Hennie_Meijer	playsFor	De_Graafschap
Dimitrios_Eleftheropoulos	playsFor	Greece_national_football_team
Filipe_Teixeira	hasGender	male
Fábio_Bilica	hasGender	male
Nuno_Assis	playsFor	Sporting_Clube_de_Portugal
Luís_Gabriel_Sacilotto	playsFor	U.S._Latina_Calcio
Fabrício_Carvalho	playsFor	Clube_Atlético_Bragantino
Bobby_Weale	playsFor	Boston_United_F.C.
Derek_Holmes	playsFor	Arbroath_F.C.
Gustave_Flaubert	influences	William_Faulkner
Kai_Oswald	playsFor	FC_Carl_Zeiss_Jena
Robbie_Ryan	playsFor	Huddersfield_Town_F.C.
Stjepan_Deverić	playsFor	SK_Sturm_Graz
Abiodun_Obafemi	playsFor	Stationery_Stores_F.C.
Carl_Cort	playsFor	Tampa_Bay_Rowdies
Francesco_Sanetti	hasGender	male
Dorge_Kouemaha	playsFor	Aris_F.C._(Thessaloniki)
Caleb_Norkus	playsFor	Charleston_Battery
G._K._Chesterton	influences	Robert_E._Howard
André_Breton	influences	Julio_Cortázar
China_(footballer_born_1980)	playsFor	VfL_Bochum
Sotaro_Yasunaga	playsFor	Shimizu_S-Pulse
Ruud_Brood	playsFor	NAC_Breda
Shariff_Abdul_Samat	playsFor	Singapore_national_football_team
Anton_Arkhipov	playsFor	FC_Rotor_Volgograd
Scotland	dealsWith	United_States
Sim_Jae-won	playsFor	Busan_IPark
David_Galbraith	hasGender	male
Adnan_Güngör	playsFor	Torku_Konyaspor
Alan_Birchenall	playsFor	England_national_under-21_football_team
Kingdom_of_Romania	isLocatedIn	Europe
Didier_Six	playsFor	Olympique_de_Marseille
Víctor_Aquino	hasGender	male
Charles_Dickens	influences	Henry_James
Cédric_Roussel	playsFor	R.A.A._Louviéroise
Fábio_Gonçalves_dos_Santos	playsFor	Associação_Portuguesa_de_Desportos
Paulo_Francisco_da_Silva_Paz	playsFor	Joinville_Esporte_Clube
Kandia_Traoré	playsFor	Étoile_du_Sahel
Miroslav_Grumić	playsFor	Diósgyőri_VTK
Adolfino_Cañete	playsFor	Unión_Magdalena
Giorgi_Demetradze	playsFor	FC_Arsenal_Kyiv
Youssef_Chippo	playsFor	Morocco_national_football_team
Jaime_Bragança	playsFor	PSFC_Chernomorets_Burgas
Jamie_Young	playsFor	Aldershot_Town_F.C.
Kenny_Sansom	playsFor	England_national_under-21_football_team
Toni_Kroos	playsFor	F.C._Hansa_Rostock
Keisuke_Kurihara	playsFor	Shonan_Bellmare
Bill_Pickering	playsFor	Accrington_Stanley_F.C.
Ostoja_Stjepanović	playsFor	Wisła_Kraków
Costas_Elia	playsFor	Cyprus_national_football_team
Devran_Ayhan	playsFor	Kocaelispor
Craig_Nelthorpe	playsFor	Eastwood_Town_F.C.
Norman_Sylla	playsFor	Acharnaikos_F.C.
László_Kubala	playsFor	Hungary_national_football_team
Gabriel_Roth	playsFor	Córdoba_CF
Ndala_Ibrahim	playsFor	Nigeria_national_under-17_football_team
Wim_Suurbier	playsFor	Tampa_Bay_Rowdies_(1975–93)
Wayne_Dyer_(footballer)	playsFor	Walsall_F.C.
Bruno_Agnello	playsFor	Associação_Atlética_Portuguesa_(Santos)
Víctor_Merino	playsFor	San_Salvador_F.C.
João_Pedro_Henriques_Neto	playsFor	ASIL_Lysi
Harrison_Otálvaro	playsFor	Club_Atlético_Huracán
Simon_Lynch	playsFor	East_Stirlingshire_F.C.
Dominik_Jakubek	playsFor	California_Victory
Liam_Feeney	playsFor	Bolton_Wanderers_F.C.
Greg_Dalby	playsFor	R._Charleroi_S.C.
Chris_Smith_(footballer,_born_1981)	hasGender	male
Sidny_Feitosa_dos_Santos	playsFor	Sport_Club_do_Recife
Habib_Bamogo	playsFor	FC_Nantes
Norway	isLocatedIn	Europe
Milan_Jovanić	playsFor	FK_Spartak_Zlatibor_Voda
Ivan_Pecha	playsFor	Ravan_Baku_FK
Valeri_Kopiy	playsFor	FC_Zenit_Saint_Petersburg
Ronald_Borchers	playsFor	FSV_Frankfurt
Djibouti	dealsWith	Saudi_Arabia
Thomas_Hobbes	influences	Baruch_Spinoza
Christian_Lell	playsFor	Germany_national_under-21_football_team
Matthew_Gardiner_(footballer)	playsFor	Worcester_City_F.C.
Ross_Davidson_(footballer_born_1989)	playsFor	New_Mills_A.F.C.
Martin_Dugas	playsFor	Milwaukee_Wave
Gordon_Burness	playsFor	Pawtucket_Rangers
Darren_Tinson	playsFor	Shrewsbury_Town_F.C.
Chris_Turner_(footballer_born_1990)	playsFor	Stocksbridge_Park_Steels_F.C.
Mauricio_Solís	playsFor	Irapuato_FC
Peter_Artner	playsFor	SKN_St._Pölten
Moisés_Hurtado	playsFor	Girona_FC
Jay_DeMerit	playsFor	Chicago_Fire_Premier
Robert_Malcolm	playsFor	Queens_Park_Rangers_F.C.
Callum_Hart	playsFor	Bath_City_F.C.
Zafer_Özgültekin	playsFor	Çaykur_Rizespor
Simone_de_Beauvoir	diedIn	Paris
John_Lewis_(footballer_born_1955)	playsFor	Bohemian_F.C.
Johann_Wolfgang_von_Goethe	influences	Henry_David_Thoreau
Arturo_Norambuena	playsFor	Chile_national_football_team
Oséas	playsFor	Sociedade_Esportiva_Palmeiras
Matt_O'Halloran	playsFor	Corby_Town_F.C.
Marc_Williams	playsFor	Northwich_Victoria_F.C.
SV_Schermbeck	isLocatedIn	North_Rhine-Westphalia
Nemanja_Milisavljević	playsFor	FC_Rapid_București
Stefan_Brasas	playsFor	VfL_Bochum_II
Juan_Hohberg	playsFor	Rosario_Central
Geoffrey_Sserunkuma	playsFor	Bidvest_Wits_F.C.
Luis_García_(footballer,_born_1969)	playsFor	C.F._Atlante
Ihor_Hordya	playsFor	FC_Dnipro_Dnipropetrovsk
Roberto_Júlio_de_Figueiredo	playsFor	F.C._Tokyo
Oleksiy_Antyukhin	playsFor	FC_Vorskla_Poltava
Flamur_Kastrati	hasGender	male
Volkan_Kahraman	playsFor	LASK_Linz
Santiago_Raymonda	playsFor	Central_Córdoba_de_Rosario
José_Luís_Santos_da_Visitação	playsFor	Clube_Atlético_Mineiro
Bernardo_Corradi	playsFor	Reggina_Calcio
Arminas_Narbekovas	playsFor	FC_Lokomotiv_Moscow
Leandro_Barrios_Rita_dos_Martires	playsFor	Sanat_Mes_Kerman_F.C.
Eduardo_da_Silva_Nascimento_Neto	playsFor	S.C._Braga
Dermot_McCaffrey	playsFor	Dungannon_Swifts_F.C.
Roland_Vargas-Aguilera	playsFor	Montreal_Impact
Leonid_Musin	playsFor	FC_Gazovik_Orenburg
Nicolás_Diez	playsFor	Argentinos_Juniors
Fernando_Couto	playsFor	Portugal_national_under-21_football_team
Bruno_Silva	playsFor	FC_Rostov
O._N._V._Kurup	isCitizenOf	India
Oleksiy_Khramtsov	playsFor	FC_Spartak_Ivano-Frankivsk
Ronny_Thielemann	playsFor	FC_Energie_Cottbus
Roger_Gibbins	playsFor	Cambridge_United_F.C.
Jocimar_Nascimento	playsFor	Deportes_Savio
Goran_Šukalo	playsFor	FC_Koper
Túlio_Maravilha	playsFor	Itumbiara_Esporte_Clube
Đorđije_Ćetković	playsFor	FK_Železnik
Sara_Larsson	playsFor	Linköpings_FC
Mamady_Sidibé	playsFor	PFC_CSKA_Sofia
Ricardo_Domingos_Barbosa_Pereira	playsFor	Vitória_S.C.
Mick_Channon	playsFor	Miramar_Rangers
Matej_Krajčík	playsFor	FK_Senica
Ian_Ferguson_(footballer_born_1968)	playsFor	Bo'ness_United_F.C.
Chris_Baird	playsFor	Burnley_F.C.
Bruno_Uvini	playsFor	Tottenham_Hotspur_F.C.
Rhine	isLocatedIn	North_Rhine-Westphalia
Francisco_Gabriel_Guerrero	playsFor	Club_Atlético_Independiente
Oleh_Karamushka	playsFor	FC_Dnipro-2_Dnipropetrovsk
Bryan_Bergougnoux	playsFor	France_national_under-21_football_team
Chris_Withe	playsFor	Chester_City_F.C.
Ian_Callaghan	playsFor	England_national_football_team
Arílson	playsFor	Grêmio_Foot-Ball_Porto_Alegrense
Giorgio_Corona	playsFor	U.S._Campobasso_1919
Vjatšeslav_Zahovaiko	playsFor	JK_Viljandi_Tulevik
József_Somogyi	playsFor	FC_Sopron
Gavin_Strachan	playsFor	Scotland_national_under-21_football_team
Victor_Ferreyra	hasGender	male
Cristian_Oros	playsFor	FC_Brașov
Danny_Potter	playsFor	Chelmsford_City_F.C.
Tim_Ryan_(footballer)	playsFor	Doncaster_Rovers_F.C.
Emerson_Umaña	hasGender	male
Yannick_Zambernardi	hasGender	male
Ludovic_Giuly	hasGender	male
Vasili_Kulkov	playsFor	Millwall_F.C.
Ryan_Jarvis	playsFor	Leyton_Orient_F.C.
Bruno_Menezes	playsFor	Agremiação_Sportiva_Arapiraquense
Ellery_Cairo	playsFor	Coventry_City_F.C.
Gonzalo_de_los_Santos	playsFor	Uruguay_national_football_team
Spase_Dilevski	playsFor	PSV_Eindhoven
Chris_Holroyd	hasGender	male
Oswald_Spengler	influences	Henry_Miller
Kliton_Bozgo	playsFor	FC_Admira_Wacker_Mödling
Welton_Felipe	playsFor	Atlético_Clube_Goianiense
Serghei_Namașco	playsFor	FC_Sheriff_Tiraspol
Giorgio_Corona	playsFor	S.S._Juve_Stabia
Washington_Luiz_Mascarenhas_Silva	playsFor	Sociedade_Esportiva_Palmeiras
Gary_Alexander_(footballer)	playsFor	Millwall_F.C.
Adil_Ramzi	playsFor	Córdoba_CF
Zsolt_Limperger	playsFor	Ferencvárosi_TC
Esteban_Fuertes	playsFor	Club_Atlético_River_Plate
Shaun_Maher	playsFor	Drogheda_United_F.C.
Laurence_Sterne	influences	Virginia_Woolf
Sean_Dunphy_(footballer)	playsFor	Doncaster_Rovers_F.C.
Andrew_Barisić	playsFor	Canberra_FC
Brian_Rowland	hasGender	male
Mark_Kerr_(footballer)	playsFor	Falkirk_F.C.
Joe_Craig_(footballer)	playsFor	Scotland_national_football_team
Luís_Carlos_Fernandes	playsFor	Gwangju_FC
Darren_Randolph	playsFor	Welling_United_F.C.
Amdy_Faye	playsFor	Étoile_Fréjus_Saint-Raphaël
Baldo_di_Gregorio	playsFor	Gostaresh_Foulad_F.C.
Jesús_Mendoza	playsFor	Mexico_national_football_team
Abdullah_Fusseini	playsFor	A.S._Melfi
Antonio_Calle	playsFor	Xerez_CD
José_Batista	playsFor	Peñarol
Franz_Beckenbauer	playsFor	Germany_national_youth_football_team
Anders_Lindegaard	playsFor	Aalesunds_FK
Paulo_Marcel_Pereira_Merabet	playsFor	Clube_de_Regatas_do_Flamengo
Matías_Pérez_García	playsFor	C.A._Cerro
José_Ortigoza	playsFor	Ventforet_Kofu
Carlos_de_los_Cobos	playsFor	Mexico_national_football_team
Leslie_Jones_(footballer)	playsFor	Swansea_City_A.F.C.
Robert_Altman	directed	Aria_(film)
Bahador_Abdi	playsFor	Iran_national_football_team
Germán_Arangio	playsFor	Emirates_Club
Sani_Kaita	playsFor	Iraklis_Thessaloniki_F.C.
Moussa_Saïb	playsFor	AJ_Auxerre
Mark_Barnard_(footballer)	playsFor	Doncaster_Rovers_F.C.
Juan_Carlos_Chávez	playsFor	Puebla_F.C.
Milorad_Bukvić	playsFor	FK_Vojvodina
Mo_Harkin	playsFor	Wycombe_Wanderers_F.C.
Mauritania	participatedIn	War_on_Terror
Edgar_Davids	playsFor	FC_Barcelona
Jean-Claude_Bras	playsFor	Red_Star_F.C.
Michael_Tørnes	playsFor	Brønshøj_BK
Akvsenti_Gilauri	playsFor	Esteghlal_F.C.
William_Araujo	playsFor	Club_Deportivo_ESPOLI
Rôni	playsFor	FC_Rubin_Kazan
Archie_Turner	playsFor	Derby_County_F.C.
Thomas_Hinum	playsFor	SC_Schwanenstadt
Luis_Santamaría	playsFor	C.D._Motagua
George_Lawrence_(footballer)	playsFor	Rushden_&_Diamonds_F.C.
Michael_Rankine	playsFor	A.F.C._Bournemouth
George_Handley_(footballer)	playsFor	Hallam_F.C.
Benito_Carbone	playsFor	Sydney_FC
Vladimir_Božović	playsFor	OFK_Beograd
Alberto_Cossentino	playsFor	U.S._Città_di_Palermo
George_Orwell	influences	Albert_Camus
Sandy_Robertson_(footballer_born_1971)	playsFor	Cowdenbeath_F.C.
Enrique_Fernández_Viola	playsFor	Club_Atlético_Independiente
Artem_Starhorodskyi	playsFor	FC_Naftovyk-Ukrnafta_Okhtyrka
Dževdet_Šainovski	playsFor	FK_Vardar
Gürhan_Gürsoy	playsFor	Sivasspor
Fernando_Cáceres	playsFor	Real_Zaragoza
Massimo_Lombardo	playsFor	FC_Lugano
Gareth_Farrelly	playsFor	Bradford_City_A.F.C.
Claude_Makélélé	playsFor	Olympique_de_Marseille
David_Dowson	playsFor	Darlington_1883
Mirko_Selak	playsFor	HNK_Hajduk_Split
Carlos_Eduardo_Lopes	playsFor	América_Futebol_Clube_(SP)
Hungary	dealsWith	Austria-Hungary
João_Soares_de_Almeida_Neto	playsFor	PFC_Litex_Lovech
Nick_McKoy	playsFor	A.F.C._Hornchurch
George_Mourad	playsFor	Västra_Frölunda_IF
Santa_Clara_University	isLocatedIn	United_States
Steve_Shak	playsFor	Charlotte_Eagles
Aljoša_Asanović	playsFor	Derby_County_F.C.
Omar_Bravo	playsFor	C.D._Guadalajara
Chris_Crowe	playsFor	Nottingham_Forest_F.C.
Allan_Michaelsen	playsFor	FC_Svendborg
Thomas_Gill_(footballer)	playsFor	IK_Start
Marquinhos_Paraná	playsFor	Ventforet_Kofu
Juan_Manuel_Ortiz	playsFor	Hércules_CF
Luciano_Valente_de_Deus	playsFor	Paraná_Clube
Halil_Zeybek	playsFor	Fenerbahçe_S.K.
Ancona_Falconara_Airport	isLocatedIn	Ancona
Billy_McKinlay	playsFor	Dundee_United_F.C.
Paul_Fewings	playsFor	Bishop's_Stortford_F.C.
Mario_Yepes	playsFor	Paris_Saint-Germain_F.C.
Tommy_Langley	playsFor	Slough_Town_F.C.
Emmanuel_Okoduwa	playsFor	FC_Metalurh_Donetsk
Padraig_Dully	playsFor	Cliftonville_F.C.
Mark_Ward_(footballer,_born_1962)	playsFor	Valur_Football_Club
Fabio_Gallo	playsFor	U.S._Alessandria_Calcio_1912
Reginaldo_Araújo	playsFor	Esporte_Clube_Noroeste
Eugen_Bopp	playsFor	FC_Carl_Zeiss_Jena
James_Saunders_(footballer)	playsFor	Chelsea_F.C.
Fabrício_Silva_Dornellas	playsFor	CR_Vasco_da_Gama
Amir_Karić	playsFor	Anorthosis_Famagusta_FC
Tomáš_Galásek	playsFor	1._FC_Nürnberg
Tony_Kurbos	playsFor	USL_Dunkerque
Przemysław_Kaźmierczak	playsFor	Piotrcovia_Piotrków_Trybunalski
Richard_Tracey_(footballer)	hasGender	male
Azerbaijan	exports	wordnet_cotton_114870078
Moustapha_Dabo	playsFor	Urania_Genève_Sport
Felice_Piccolo	playsFor	CFR_Cluj
Stockholm_urban_area	isLocatedIn	Uppland
Elison_Fagundes_dos_Santos	playsFor	Oriente_Petrolero
Krzysztof_Adamczyk	playsFor	Arka_Gdynia
Nenad_Stojanović	playsFor	K.R.C._Genk
Tozé_Marreco	playsFor	C.D._Tondela
Future_Interstate_Highways	isLocatedIn	Jackson,_Mississippi
Manuel_Pamić	playsFor	Croatia_national_football_team
Thomas_Linke	playsFor	FC_Bayern_Munich
Gill_Swerts	playsFor	K.S.K._Beveren
Mark_van_Bommel	playsFor	FC_Barcelona
Radosław_Majdan	playsFor	Pogoń_Szczecin
Friedrich_Hayek	influences	Milton_Friedman
Glen_Downey	playsFor	Spennymoor_United_F.C.
Cléber_Santana	playsFor	Clube_Atlético_Paranaense
Dirk_Schuster	playsFor	East_Germany_national_football_team
Viktor_Zemchenkov	playsFor	FC_Luch-Energiya_Vladivostok
Dimba	playsFor	Esporte_Clube_Bahia
Bill_Paterson_(footballer_born_1898)	playsFor	Coventry_City_F.C.
Nicolas_Dikoumé	playsFor	Doxa_Katokopias_F.C.
Oğuz_Dağlaroğlu	playsFor	Turkey_national_youth_football_team
Natale_Gonnella	playsFor	Atalanta_B.C.
Pape_Thiaw	playsFor	SR_Delémont
Benoît_Cauet	playsFor	Torino_F.C.
Vicente_Rodríguez	playsFor	Spain_national_under-18_football_team
Paul_Hayes	playsFor	Scunthorpe_United_F.C.
George_Shaw_(footballer_born_1899)	playsFor	Floriana_F.C.
Darijan_Matič	playsFor	FC_Kryvbas_Kryvyi_Rih
Nassim_Mendil	playsFor	K.A.S._Eupen
Andrew_Myler	playsFor	Athlone_Town_A.F.C.
Salman_Khan	livesIn	Mumbai
Zetti	playsFor	Fluminense_FC
Jaime_Valdés	playsFor	Club_Deportivo_Palestino
Aleksandar_Bajevski	playsFor	Górnik_Łęczna
Ferrán_Tacón_Jiménez	playsFor	CD_Logroñés
Zoltan_Crișan	playsFor	FC_Olt_Scorniceşti
Ray_Fränkel	playsFor	Feyenoord
Gary_McDonald_(footballer_born_1982)	playsFor	Aberdeen_F.C.
Kanga_Akalé	playsFor	Lekhwiya_SC
Jim_Hamilton_(footballer)	playsFor	Scotland_national_under-21_football_team
Taifour_Diané	playsFor	1._FC_Saarbrücken
Aldo_Mores	playsFor	Persija_Jakarta
Murat_Tleshev	playsFor	FC_Shakhter_Karagandy
Dumitru_Popovici	playsFor	FC_Sheriff_Tiraspol
Ian_Hamilton_(footballer_born_1967)	playsFor	Lincoln_City_F.C.
Gilles_Mbang_Ondo	playsFor	Sandnes_Ulf
Billy_Gilbert_(footballer)	playsFor	Whyteleafe_F.C.
Jung_In-whan	playsFor	South_Korea_national_under-23_football_team
Hugo_Colace_(footballer)	playsFor	Clube_de_Regatas_do_Flamengo
Jordan_Remacle	playsFor	Belgium_national_under-17_football_team
Carlos_Bianchi	playsFor	Paris_Saint-Germain_F.C.
Yassir_Raad	playsFor	Al-Zawra'a_SC
Víctor_Bernárdez	playsFor	C.D.S._Vida
Clarke_Carlisle	hasGender	male
Lee_Eul-yong	playsFor	Sangju_Sangmu_FC
Massimo_Coda	playsFor	U.S._Cremonese
Herbert_Banks	playsFor	St._Mirren_F.C.
J._R._Reid	playsFor	Club_Nacional
